proteinID_y	domain_id	dom_start_y	dom_end_y	dom_agg_score_y	dom_length_y	proteinID_x	dom_start_x	dom_end_x	dom_agg_score_x	dom_length_x
Q3UHI4	PF13897	185	324	6.569521428571428	139	G5B678	122	260	6.642791366906475	138
A2CG49	PF00018	1625	1675	1.1154705882352942	50	G5AQ71	1066	1116	0.5985686274509802	50
A2CG49	PF00041	2542	2618	0.7093376623376624	76	G5AQ71	1985	2061	0.7084285714285714	76
A2CG49	PF00069	2655	2909	9.742592156862742	254	G5AQ71	2098	2352	9.74152549019608	254
A2CG49	PF00169	1464	1551	7.752306818181816	87	G5AQ71	905	992	7.7500113636363634	87
A2CG49	PF00435	292	386	0.1855368421052632	94	G5AQ71	544	637	3.6104787234042575	93
A2CG49	PF00435	569	621	0.0	52	G5AQ71	1	53	0.0	52
A2CG49	PF00435	872	970	0.29647474747474745	98	G5AQ71	304	411	0.1903611111111112	107
A2CG49	PF00435	1104	1196	3.6533333333333338	92	G5AQ71	545	637	3.2956989247311848	92
A2CG49	PF00621	1257	1426	2.823029411764705	169	G5AQ71	698	867	2.8200941176470584	169
A2CG49	PF00621	1903	2072	5.133699999999997	169	G5AQ71	1346	1515	5.169270588235293	169
A2CG49	PF07679	2442	2536	1.0503368421052632	94	G5AQ71	1885	1979	1.112852631578947	94
A2CG49	PF16609	1678	1861	0.20444565217391306	183	G5AQ71	1119	1304	0.20023118279569893	185
Q9QYK9	PF00069	23	269	5.810991902834009	246	G5BQT4	8	273	5.422849624060151	265
Q8C120	PF00018	192	237	0.14532608695652174	45	G5CB95	121	166	0.14554347826086958	45
Q8C120	PF00018	255	302	10.27239583333333	47	G5CB95	184	231	10.103812499999998	47
Q8C120	PF14604	464	514	7.142176470588236	50	G5CB95	415	465	5.338980392156863	50
Q8C120	PF14604	825	875	0.4018627450980392	50	G5CB95	769	819	0.4205882352941177	50
Q7TPN9	PF15386	487	543	1.7897192982456138	56	G5BYK8	468	524	1.78159649122807	56
Q9DAM3	PF00011	56	131	0.0	75	G5B0K6	53	126	0.0	73
P54728	PF09280	275	330	0.06749999999999999	55	G5BVD4	273	328	0.06758928571428571	55
P54728	PF00240	2	75	8.399635135135133	73	G5BVD4	3	73	8.963788732394367	70
P54728	PF00627	189	224	6.266638888888888	35	G5BVD4	187	222	6.28175	35
P54728	PF00627	373	407	12.268057142857144	34	G5BVD4	364	398	12.375571428571426	34
Q9DAK4	PF00061	5	118	0.4637280701754386	113	G5BAK5	6	118	1.5092920353982302	112
Q60676	PF00149	235	427	5.399227979274614	192	G5AUZ1	236	428	5.478626943005186	192
Q60676	PF00515	28	60	0.08206060606060607	32	G5AUZ1	29	61	0.10254545454545454	32
Q60676	PF08321	135	227	5.940494623655916	92	G5AUZ1	136	228	5.898731182795701	92
O54829	PF00610	39	109	6.201394366197183	70	G5BGU2	14	84	6.201535211267608	70
O54829	PF00615	334	446	2.963008849557522	112	G5BGU2	309	421	2.934601769911505	112
O54829	PF00631	254	314	0.024295081967213108	60	G5BGU2	229	289	0.024295081967213108	60
O54829	PF18148	112	213	3.1807941176470584	101	G5BGU2	87	188	3.18093137254902	101
Q8BH43	PF02205	432	457	1.1046153846153846	25	G5AUT8	425	450	1.1086538461538462	25
Q8BGQ7	PF01411	8	595	6.111297619047615	587	G5B5W3	9	596	5.913869047619049	587
Q8BGQ7	PF02272	813	956	1.1849583333333338	143	G5B5W3	814	972	1.0114968553459125	158
Q8BGQ7	PF07973	693	752	8.673783333333335	59	G5B5W3	694	753	8.942733333333337	59
P06728	PF01442	60	224	0.8389333333333329	164	G5BQH3	61	225	0.004193939393939394	164
P06728	PF01442	191	340	0.059233333333333325	149	G5BQH3	192	341	0.0069	149
Q3UA37	PF12012	600	758	7.336465408805032	158	G5BZV2	584	742	7.394314465408807	158
Q9D832	PF00226	3	64	0.8111935483870968	61	G5AXK5	4	65	3.483467741935484	61
Q9D832	PF01556	160	318	3.5533836477987424	158	G5AXK5	161	319	3.5391006289308184	158
Q60766	PF05049	136	398	8.802676806083648	262	G5BCB9	1	267	7.6056142322097395	266
Q8R0A0	PF02270	175	239	1.241969230769231	64	G5C909	198	262	1.225353846153847	64
Q8R0A0	PF17683	22	101	1.6632125000000002	79	G5C909	43	121	1.6751772151898734	78
Q7TT18	PF16788	601	683	4.915542168674701	82	G5BBH3	560	641	7.4411951219512185	81
Q9WUM4	PF00400	77	107	3.2940967741935485	30	G5AWZ4	142	172	15.9841935483871	30
Q9WUM4	PF00400	121	158	13.219315789473686	37	G5AWZ4	136	173	14.631947368421054	37
Q9WUM4	PF00400	172	201	2.1141333333333336	29	G5AWZ4	187	216	1.9398000000000004	29
Q9WUM4	PF08953	2	65	10.018859375	63	G5AWZ4	58	120	10.181238095238095	62
Q9WUM4	PF16300	342	384	0.20888372093023255	42	G5AWZ4	357	399	1.2918837209302323	42
Q8BWB1	PF17820	34	82	1.7638775510204083	48	G5C7H3	38	86	9.932204081632653	48
P41158	PF00178	6	84	7.807911392405062	78	G5BX45	35	113	6.662240506329115	78
D3Z4I3	PF00076	58	69	2.26575	11	G5AXT2	1	12	0.0	11
Q5FWH6	PF00621	430	605	3.4971306818181804	175	G5B5F9	424	599	1.2837500000000002	175
P09920	PF16647	57	204	4.104283783783783	147	G5BRY2	53	200	1.0691554054054049	147
P62313	PF01423	9	73	3.4974307692307693	64	G5C7D8	10	74	3.5750769230769235	64
Q3UL36	PF15346	127	225	0.0	98	G5BRJ5	242	338	0.0	96
Q9ES34	PF00612	29	48	3.74715	19	G5BDR6	30	49	0.7027500000000001	19
Q9ES34	PF00632	739	1069	3.6142205438066464	330	G5BDR6	738	1068	3.8015636363636363	330
Q9CQS9	PF15003	7	189	3.2394426229508206	182	G5BM33	8	190	4.301639344262297	182
Q9JK81	PF03690	45	364	3.2878124999999985	319	G5BIG1	23	341	2.527545454545455	318
P58044	PF00293	49	196	7.656797297297298	147	G5BUS6	109	256	8.110270270270266	147
Q8K479	PF00386	104	231	11.4366875	127	G5BHP5	105	232	10.282648437500006	127
Q8K479	PF01391	35	88	0.0	53	G5BHP5	36	89	0.0	53
Q9R0X5	PF00415	54	100	0.09608510638297872	46	G5BMQ8	30	76	5.016489361702127	46
Q9R0X5	PF00415	105	154	4.18314	49	G5BMQ8	81	130	0.6168600000000001	49
Q9R0X5	PF00415	157	204	2.13925	47	G5BMQ8	167	214	11.642645833333333	47
Q9R0X5	PF00415	207	257	3.6169411764705877	50	G5BMQ8	217	267	4.694470588235293	50
Q9R0X5	PF00415	262	308	11.585659574468085	46	G5BMQ8	272	318	7.729872340425532	46
Q9R0X5	PF00415	313	361	7.494591836734692	48	G5BMQ8	323	371	14.524489795918367	48
Q8C1B1	PF08683	1321	1360	0.0	39	G5B3B0	891	929	0.0	38
Q8C1B1	PF11971	225	276	4.395865384615385	51	G5B3B0	262	313	4.367846153846155	51
Q8C1B1	PF17095	725	777	5.926509433962264	52	G5B3B0	642	694	5.92411320754717	52
Q68FH4	PF00288	133	195	15.773904761904767	62	G5CA44	128	190	15.353492063492062	62
Q68FH4	PF08544	354	405	0.015865384615384618	51	G5CA44	479	533	0.0	54
Q68FH4	PF10509	24	72	1.0103061224489798	48	G5CA44	19	67	1.0185714285714285	48
Q9R0N0	PF00288	127	192	12.26640909090909	65	G5BNA5	210	275	8.708651515151516	65
Q9R0N0	PF08544	291	371	0.35441975308641976	80	G5BNA5	374	454	0.3512345679012345	80
Q9R0N0	PF10509	18	66	8.922183673469387	48	G5BNA5	93	149	8.945438596491229	56
Q9D2L1	PF00884	31	367	8.185142433234423	336	G5BU33	32	370	7.339982300884957	338
Q99PU7	PF01088	4	213	9.091861904761904	209	G5BUL9	5	214	9.101966666666673	209
Q99PU7	PF18031	641	686	10.300608695652171	45	G5BUL9	643	688	10.318	45
Q6P5E6	PF00790	33	161	10.18870542635659	128	G5BV74	13	141	10.228821705426355	128
Q6P5E6	PF02883	476	594	4.6126386554621845	118	G5BV74	470	588	5.682781512605041	118
Q6P5E6	PF03127	240	317	1.994179487179487	77	G5BV74	221	298	3.3937435897435897	77
Q6P5E6	PF18308	189	225	0.0	36	G5BV74	170	206	0.0	36
Q8BRT1	PF12348	93	310	1.632316513761468	217	G5BIU3	98	315	1.4407293577981657	217
Q9CPW3	PF08561	65	95	3.392677419354839	30	G5BBD7	69	99	0.28445161290322585	30
O54824	PF00595	213	295	3.548867469879518	82	G5BEZ3	320	402	3.1591686746987957	82
O54824	PF00595	352	417	4.170469696969698	65	G5BEZ3	460	525	3.821924242424243	65
O54824	PF00595	1107	1179	2.091780821917808	72	G5BEZ3	1202	1274	2.0404520547945206	72
O54824	PF00595	1226	1305	5.0576625	79	G5BEZ3	1321	1402	2.7335609756097554	81
Q07968	PF00084	49	87	5.4923589743589725	38	G5BM72	1	39	5.100641025641027	38
Q07968	PF00084	91	146	0.010535714285714287	55	G5BM72	43	98	0.4815714285714287	55
Q07968	PF00084	153	208	6.212214285714286	55	G5BM72	105	160	0.3991785714285713	55
Q07968	PF00084	213	267	2.2777272727272724	54	G5BM72	165	219	2.284327272727273	54
Q07968	PF00084	274	327	1.0154814814814814	53	G5BM72	226	279	0.0	53
Q07968	PF00084	336	389	0.011388888888888893	53	G5BM72	288	341	0.0	53
Q07968	PF00084	396	450	0.18141818181818176	54	G5BM72	348	402	0.0	54
Q07968	PF00084	524	578	0.07172727272727272	54	G5BM72	476	530	0.10499999999999997	54
A2RT67	PF02141	187	371	10.575227027027024	184	G5C8Y9	175	359	11.56082162162163	184
Q791V5	PF00153	127	191	15.812723076923074	64	G5BPB4	128	192	14.118046153846151	64
Q9JIW4	PF10391	237	285	3.625755102040817	48	G5ASQ9	237	285	3.604857142857143	48
Q9JIW4	PF14716	155	217	0.0	62	G5ASQ9	155	217	0.4985079365079366	62
Q9JIW4	PF14791	431	494	1.4642343749999998	63	G5ASQ9	429	492	1.1057812500000004	63
Q9JIW4	PF14792	291	360	0.7790571428571428	69	G5ASQ9	291	360	1.2589571428571429	69
D3YYM0	PF00096	96	118	0.0	22	G5BK11	99	121	0.0	22
D3YYM0	PF00096	124	147	0.0	23	G5BK11	127	150	0.0	23
D3YYM0	PF00096	163	185	0.0	22	G5BK11	166	188	0.0	22
P29352	PF00102	53	287	10.13637021276596	234	G5ATD5	54	288	7.489693617021277	234
P38532	PF00447	17	117	3.57778217821782	100	G5C5T3	18	118	3.5781782178217814	100
P38532	PF06546	249	524	0.14885144927536229	275	G5C5T3	250	526	0.26024637681159424	276
P27782	PF08347	75	210	0.01953676470588236	135	G5AQL1	2	137	0.008088235294117648	135
P27782	PF00505	296	363	4.668088235294113	67	G5AQL1	223	290	4.62586764705882	67
Q8C152	PF07984	56	371	3.819772151898734	315	G5BBX6	8	356	3.428246418338106	348
Q0VBD2	PF09329	397	442	0.27017391304347826	45	G5BE20	377	422	0.0	45
Q0VBD2	PF09332	539	882	0.01842732558139535	343	G5BE20	520	867	0.25015517241379315	347
Q68FL6	PF00043	118	178	4.372622950819672	60	G5BED3	119	179	4.5416065573770465	60
Q68FL6	PF00458	846	893	0.02829166666666667	47	G5BED3	845	892	0.0280625	47
Q68FL6	PF09334	267	658	4.157234693877548	391	G5BED3	266	657	3.811829081632653	391
Q68FL6	PF18485	0	73	9.657013513513515	73	G5BED3	1	74	8.784364864864862	73
O35343	PF00514	103	143	1.5172682926829266	40	G5AQ81	81	121	1.4654878048780493	40
O35343	PF00514	145	183	1.8796410256410256	38	G5AQ81	123	161	1.979615384615385	38
O35343	PF00514	188	228	28.44136585365853	40	G5AQ81	166	206	28.39846341463416	40
O35343	PF00514	232	269	17.622815789473684	37	G5AQ81	210	247	17.571868421052628	37
O35343	PF00514	273	311	0.1615128205128205	38	G5AQ81	251	289	0.16046153846153846	38
O35343	PF00514	314	354	11.814829268292685	40	G5AQ81	292	332	11.809414634146345	40
O35343	PF00514	356	395	1.7871250000000003	39	G5AQ81	334	373	1.8238250000000007	39
O35343	PF00514	401	437	18.89081081081081	36	G5AQ81	379	415	18.84456756756757	36
O35343	PF01749	23	92	0.07954285714285718	69	G5AQ81	1	70	0.08228571428571428	69
O35343	PF16186	447	497	0.1779411764705882	50	G5AQ81	425	475	0.17670588235294118	50
Q9D9P8	PF15838	44	106	16.075555555555557	62	G5C2L1	57	121	15.0138	64
P97302	PF00651	23	126	3.6287500000000006	103	G5B1C9	24	127	2.6518076923076914	103
P97302	PF03131	533	609	0.044259740259740256	76	G5B1C9	533	609	0.05087012987012987	76
Q8BGW6	PF00069	22	280	3.6494787644787623	258	G5BTG9	6	264	3.6024401544401523	258
Q3UHG7	PF09804	79	344	7.647191729323305	265	G5B578	80	345	7.262680451127816	265
Q60780	PF00611	163	234	0.0055000000000000005	71	G5B5H7	164	235	0.0027500000000000003	71
Q60780	PF16623	53	145	0.13899999999999998	92	G5B5H7	54	146	0.13899999999999998	92
Q60780	PF00397	23	52	0.0	29	G5B5H7	24	53	0.0	29
Q9CR98	PF05811	28	130	0.012524271844660194	102	G5C6V1	9	111	0.006747572815533981	102
Q2TB02	PF00023	98	128	6.57674193548387	30	G5BXP3	210	240	6.5774193548387085	30
Q2TB02	PF12796	199	291	3.357602150537636	92	G5BXP3	311	403	2.260150537634409	92
Q80YW5	PF00622	333	441	3.8559633027522926	108	G5B1Z5	222	330	5.646321100917432	108
Q80YW5	PF13765	279	328	0.8795799999999999	49	G5B1Z5	168	217	0.07683999999999999	49
Q99KC8	PF08487	54	128	0.41818666666666665	74	G5C585	1	75	0.5159866666666665	74
Q99KC8	PF13768	298	442	8.932006896551727	144	G5C585	278	422	7.443013793103443	144
Q9WTP6	PF00406	19	140	0.027286885245901643	121	G5B5K5	20	141	0.0263360655737705	121
Q9WTP6	PF05191	141	176	0.0	35	G5B5K5	142	177	0.0	35
Q9EQY0	PF00069	574	831	3.7950077519379835	257	G5BDI0	554	811	4.387686046511628	257
Q9EQY0	PF06479	837	960	1.6765080645161288	123	G5BDI0	817	940	0.06314516129032259	123
Q9JLK4	PF00036	77	105	0.10258620689655172	28	G5BS98	78	106	0.10517241379310344	28
Q9JLK4	PF13499	151	214	0.0	63	G5BS98	152	215	0.0	63
Q04750	PF01028	433	664	3.243413793103448	231	G5C9N0	416	647	3.243038793103448	231
Q04750	PF02919	216	430	4.197246511627907	214	G5C9N0	199	413	4.161218604651163	214
Q04750	PF14370	696	766	2.2144507042253525	70	G5C9N0	679	749	2.2437857142857145	70
Q9CY64	PF01408	17	121	3.694542857142859	104	G5AV43	96	201	5.131632075471697	105
Q9CY64	PF09166	131	241	6.723108108108107	110	G5AV43	211	347	0.5139197080291971	136
Q9WTV6	PF00443	51	362	10.964519230769227	311	G5BWP3	54	334	13.389939501779356	280
P51162	PF14651	0	127	0.0388125	127	G5BEM7	1	128	0.02767716535433071	127
Q8C7R7	PF02257	126	196	2.3339154929577464	70	G5AMZ5	1	71	2.323042253521125	70
Q8R4V4	PF00246	198	497	2.649386666666667	299	G5B308	171	470	2.2904899999999984	299
Q8R4V4	PF01392	47	154	5.29671296296296	107	G5B308	20	127	5.616768518518519	107
Q8R4V4	PF13620	509	572	0.239765625	63	G5B308	482	545	0.25171875	63
Q9DC48	PF00400	278	315	0.8105526315789474	37	G5ARK0	279	316	1.0030526315789474	37
Q9DC48	PF00400	322	359	0.7442368421052631	37	G5ARK0	323	360	0.7442631578947367	37
Q9DC48	PF00400	408	444	18.730945945945944	36	G5ARK0	409	445	18.730945945945944	36
Q9DC48	PF00400	497	535	0.38299999999999995	38	G5ARK0	498	536	0.38299999999999995	38
Q9DC48	PF00400	545	578	15.541882352941187	33	G5ARK0	546	579	16.01284848484849	33
P48299	PF00322	92	120	1.9480344827586205	28	G5AL01	85	113	1.910931034482759	28
P08032	PF00018	980	1025	13.575739130434785	45	G5BSW1	1013	1058	12.79363043478261	45
P08032	PF00435	51	151	0.8085742574257425	100	G5BSW1	44	184	0.3119574468085106	140
P08032	PF00435	156	258	4.738728155339805	102	G5BSW1	189	291	3.035242718446601	102
P08032	PF00435	262	364	0.0	102	G5BSW1	295	397	0.0829611650485437	102
P08032	PF00435	369	470	0.1958333333333334	101	G5BSW1	402	503	0.380186274509804	101
P08032	PF00435	474	575	0.09328431372549016	101	G5BSW1	507	608	0.0494607843137255	101
P08032	PF00435	580	680	0.032970297029702965	100	G5BSW1	613	713	0.8434356435643564	100
P08032	PF00435	685	786	0.0012549019607843138	101	G5BSW1	718	819	0.09534313725490197	101
P08032	PF00435	792	893	0.1312549019607843	101	G5BSW1	825	925	0.17633663366336633	100
P08032	PF00435	898	956	0.07781355932203389	58	G5BSW1	931	988	0.07913793103448276	57
P08032	PF00435	1084	1176	0.3577096774193549	92	G5BSW1	1117	1209	0.02032258064516129	92
P08032	PF00435	1182	1284	0.12059223300970875	102	G5BSW1	1215	1317	5.169446601941746	102
P08032	PF00435	1286	1389	4.398682692307693	103	G5BSW1	1319	1422	3.4295384615384625	103
P08032	PF00435	1393	1487	0.02421052631578948	94	G5BSW1	1426	1519	0.024468085106382983	93
P08032	PF00435	1498	1602	0.0	104	G5BSW1	1531	1646	0.3524051724137932	115
P08032	PF00435	1605	1708	0.022509615384615385	103	G5BSW1	1649	1740	0.32099999999999995	91
P08032	PF00435	1711	1814	3.3940480769230765	103	G5BSW1	1744	1847	1.8057403846153843	103
P08032	PF00435	1817	1920	0.021634615384615388	103	G5BSW1	1850	1953	0.02115384615384615	103
P08032	PF00435	1924	2028	7.207752380952384	104	G5BSW1	1957	2061	0.2822857142857143	104
P08032	PF00435	2039	2141	2.5095631067961155	102	G5BSW1	2072	2174	4.1288155339805845	102
P08032	PF00435	2153	2253	0.7106732673267326	100	G5BSW1	2186	2280	0.7549052631578949	94
P08032	PF08726	2345	2413	0.2528695652173913	68	G5BSW1	2372	2440	0.19424637681159407	68
P55200	PF00628	1491	1530	0.350625	39	G5BHL8	1436	1475	0.35137500000000005	39
P55200	PF00628	1567	1627	0.3338688524590164	60	G5BHL8	1512	1569	0.3356379310344828	57
P55200	PF00856	3836	3940	3.7523333333333326	104	G5BHL8	3770	3874	3.7545809523809517	104
P55200	PF02008	1144	1190	0.0	46	G5BHL8	1181	1227	0.0	46
P55200	PF05964	2025	2072	0.8316041666666666	47	G5BHL8	1967	2014	0.8333749999999999	47
P55200	PF05965	3665	3744	7.1210375	79	G5BHL8	3609	3688	7.1282	79
P55200	PF13771	1901	1979	0.11153164556962022	78	G5BHL8	1843	1921	0.11173417721518987	78
Q810B6	PF00023	324	363	5.377350000000002	39	G5B925	237	276	6.491424999999998	39
Q810B6	PF00023	543	574	12.5131875	31	G5B925	456	487	12.501562500000002	31
Q810B6	PF01363	1107	1162	0.3005714285714285	55	G5B925	1021	1076	0.3297142857142857	55
Q810B6	PF12796	441	519	3.3804430379746835	78	G5B925	354	432	3.2535443037974687	78
Q810B6	PF12796	728	832	7.763038095238095	104	G5B925	642	746	7.7575619047619035	104
Q810B6	PF12796	874	966	7.5250537634408605	92	G5B925	788	880	7.381892473118278	92
Q810B6	PF13637	267	304	11.104973684210528	37	G5B925	180	217	14.27934210526316	37
Q810B6	PF13857	611	661	8.17594117647059	50	G5B925	524	575	8.068269230769229	51
O35973	PF08447	372	456	8.104705882352942	84	G5B5F2	373	457	8.10507058823529	84
O35973	PF12114	1081	1209	2.332286821705425	128	G5B5F2	1084	1212	2.3895038759689906	128
Q8R059	PF16363	4	330	0.7906330275229354	326	G5BHY1	6	332	0.5758348623853212	326
Q9ERH4	PF16006	231	420	0.5581947368421052	189	G5BM12	244	455	0.1749716981132076	211
Q99J79	PF00400	233	270	0.8291315789473686	37	G5BPC2	174	211	0.8190000000000001	37
Q99J79	PF00400	286	314	0.0	28	G5BPC2	227	255	0.0	28
E9PV82	PF15242	0	298	0.5841638795986621	298	G5BCJ1	1	297	0.5891414141414141	296
Q9JL70	PF03511	1270	1304	19.272828571428573	34	G5APH5	1326	1359	5.048294117647059	33
Q9JL70	PF15865	166	517	8.128630681818175	351	G5APH5	218	569	12.683647727272731	351
Q6P8X1	PF00787	57	168	2.8127410714285714	111	G5B109	59	170	2.8129642857142856	111
Q6P8X1	PF09325	186	390	1.1884634146341453	204	G5B109	188	392	1.1886878048780478	204
P30306	PF00581	429	524	8.67903125	95	G5B4U8	434	529	7.6970833333333335	95
P30306	PF06617	110	378	0.3255390334572491	268	G5B4U8	112	383	0.5480036764705882	271
Q8CGR7	PF01048	60	308	3.7054618473895578	248	G5BZZ5	56	304	4.1786867469879505	248
Q3URF8	PF02214	4	92	0.9628426966292136	88	G5AW64	5	93	0.9533932584269662	88
Q5XFZ0	PF15719	26	212	5.258903743315509	186	G5C760	27	213	3.8306470588235295	186
Q6NXM2	PF00415	40	82	9.898023255813953	42	G5B9Z2	41	83	9.903651162790695	42
Q6NXM2	PF00415	92	142	7.327235294117651	50	G5B9Z2	93	143	7.432176470588236	50
Q6NXM2	PF00415	145	195	0.8836078431372549	50	G5B9Z2	146	196	1.666980392156863	50
Q6NXM2	PF00415	199	237	0.18443589743589744	38	G5B9Z2	200	237	0.1804736842105264	37
Q6NXM2	PF00415	250	298	2.8671224489795906	48	G5B9Z2	93	142	7.577300000000001	49
Q6NXM2	PF00651	360	463	3.650163461538462	103	G5B9Z2	297	400	3.652913461538463	103
Q9CZW5	PF00515	116	148	0.0	32	G5BUU3	115	147	0.0	32
Q9CZW5	PF13174	446	475	0.0949	29	G5BUU3	445	474	0.06026666666666668	29
Q9CZW5	PF13181	404	435	0.7579374999999999	31	G5BUU3	403	434	0.028875	31
Q9CZW5	PF13181	478	511	0.3293235294117647	33	G5BUU3	477	510	0.39414705882352935	33
Q9CZW5	PF13181	550	578	0.0	28	G5BUU3	549	577	0.0	28
Q9JLC8	PF05168	4449	4570	3.9943934426229495	121	G5AMY9	4444	4565	4.555360655737705	121
Q60585	PF00096	171	193	0.0	22	G5AMD1	97	119	0.0	22
Q60585	PF00096	199	221	0.0	22	G5AMD1	125	147	0.0	22
Q60585	PF00096	255	277	0.0	22	G5AMD1	265	287	0.0	22
Q60585	PF00096	283	303	0.0	20	G5AMD1	209	229	0.0	20
Q60585	PF00096	339	361	0.0	22	G5AMD1	265	287	0.0	22
Q60585	PF00096	367	389	0.0	22	G5AMD1	293	315	0.0	22
Q60585	PF00096	395	417	0.0	22	G5AMD1	321	343	0.0	22
Q60585	PF00096	423	445	0.0	22	G5AMD1	349	371	0.0	22
Q60585	PF00096	451	473	0.0	22	G5AMD1	377	399	0.0	22
Q60585	PF00096	479	501	0.0	22	G5AMD1	405	427	0.0	22
Q60585	PF00096	507	529	0.0	22	G5AMD1	433	455	0.0	22
P10168	PF01415	75	152	0.15562820512820508	77	G5AW53	8	83	0.051486842105263136	75
Q8BHW2	PF10188	37	188	6.806164473684211	151	G5C6G3	153	304	12.99165131578947	151
Q9QZV9	PF02136	16	134	9.947689075630253	118	G5CBC9	17	135	9.725386554621846	118
G5E8I7	PF00443	51	344	7.067343537414966	293	G5B7F3	48	331	10.111732394366198	283
O88696	PF00574	63	241	9.720385474860336	178	G5C4F9	64	242	9.809441340782119	178
O08717	PF00019	246	348	4.1026893203883485	102	G5BED6	249	351	3.2955728155339807	102
A4Q9E5	PF03133	425	693	4.4943977695167305	268	G5BX86	416	684	4.615382899628255	268
Q8C0C7	PF01409	209	482	1.6230255474452555	273	G5BYW2	210	483	1.6281715328467152	273
Q8C0C7	PF18552	2	60	0.6577796610169492	58	G5BYW2	3	61	0.6401016949152543	58
Q8C0C7	PF18553	74	131	0.105551724137931	57	G5BYW2	75	132	0.006120689655172413	57
Q8C0C7	PF18554	133	165	2.7174242424242427	32	G5BYW2	134	166	0.363	32
Q91ZS8	PF00035	78	139	3.832	61	G5BMG1	79	140	1.0046451612903224	61
Q91ZS8	PF00035	243	293	15.779117647058824	50	G5BMG1	244	294	17.11366666666667	50
Q91ZS8	PF02137	369	700	4.867271084337351	331	G5BMG1	370	734	5.8294767123287645	364
P62069	PF00443	34	361	6.749868902439022	327	G5AU60	23	350	6.706384146341463	327
Q9DBY0	PF00250	458	534	4.096428571428572	76	G5BNI0	473	549	4.09216883116883	76
Q9DBY0	PF16159	307	375	0.014855072463768116	68	G5BNI0	310	378	0.014855072463768116	68
Q6PG04	PF13846	97	210	0.02433333333333333	113	G5ANX0	93	207	0.0	114
Q6PG04	PF13926	272	424	0.9615882352941176	152	G5ANX0	267	418	0.5377631578947368	151
P70372	PF00076	21	91	5.113957746478875	70	G5B4M8	25	95	4.9056338028169035	70
P70372	PF00076	107	173	0.20017910447761192	66	G5B4M8	111	177	0.17553731343283582	66
P70372	PF00076	245	313	7.941826086956523	68	G5B4M8	249	317	6.574869565217389	68
Q8R448	PF15182	20	88	3.1468985507246376	68	G5BGX0	21	88	3.258611940298508	67
O54826	PF13831	53	71	0.5628421052631578	18	G5BTK1	1	19	0.30657894736842106	18
O54826	PF13832	80	196	3.493324786324787	116	G5BTK1	28	144	3.4845299145299147	116
P97358	PF11781	8	36	0.15120689655172412	28	G5B583	3	31	0.0	28
Q80WC3	PF01426	2726	2865	3.3097785714285712	139	G5BI75	2342	2481	3.3169500000000007	139
Q8C267	PF00856	380	687	3.7185487012987015	307	G5B9Z0	372	678	4.209032573289901	306
Q8C267	PF01429	166	231	0.4221060606060605	65	G5B9Z0	157	222	0.3813939393939394	65
Q8C267	PF05033	249	361	0.0	112	G5B9Z0	240	353	0.2509122807017544	113
Q8C0T9	PF00211	42	206	21.351884848484847	164	G5AQ52	42	215	16.13360919540229	173
Q8C0T9	PF00211	340	416	15.568285714285715	76	G5AQ52	348	424	10.644129870129868	76
Q6UGQ3	PF09252	23	83	17.82360655737705	60	G5BXL2	24	83	20.824183333333334	59
Q8VHH5	PF00071	127	283	9.102898089171976	156	G5AMT4	70	226	9.114643312101913	156
Q8VHH5	PF01412	663	773	1.6670270270270275	110	G5AMT4	597	707	0.32481981981981983	110
Q8VHH5	PF12796	795	877	18.576771084337352	82	G5AMT4	729	811	18.584337349397586	82
Q9Z0Z7	PF00096	362	385	0.0	23	G5C9E2	283	306	0.0	23
Q9Z0Z7	PF00096	391	415	0.0	24	G5C9E2	312	336	0.0	24
Q9Z0Z7	PF00096	421	443	0.0	22	G5C9E2	342	364	0.0	22
Q9D2H2	PF00406	333	441	0.046467889908256885	108	G5B499	442	550	1.3461834862385322	108
Q9D2H2	PF05186	569	610	3.8168333333333315	41	G5B499	681	722	0.15295238095238095	41
B2RV46	PF14909	0	90	0.7583956043956044	90	G5B4Y0	55	131	0.03324675324675325	76
P82343	PF07221	97	360	5.679473484848487	263	G5BQU3	1	241	4.630245833333335	240
Q3UKJ7	PF00400	206	241	0.4558611111111112	35	G5B039	207	242	0.5223611111111112	35
Q3UKJ7	PF00400	266	291	4.924384615384615	25	G5B039	267	292	4.119307692307692	25
Q3UKJ7	PF00400	295	332	0.12299999999999997	37	G5B039	296	333	0.12281578947368416	37
Q3UKJ7	PF00400	338	376	0.37192307692307697	38	G5B039	339	377	0.3717948717948718	38
Q3UKJ7	PF00400	473	511	2.6648717948717957	38	G5B039	525	563	6.532512820512822	38
Q3UKJ7	PF17814	6	35	1.219566666666667	29	G5B039	7	36	1.2186	29
Q8K1Z0	PF08511	204	279	1.1205263157894736	75	G5AUE6	186	261	1.1996842105263157	75
Q9D2Y5	PF00787	102	178	0.4982987012987013	76	G5C250	106	181	0.2860789473684211	75
Q80YS9	PF00069	63	265	7.656379310344832	202	G5B8H4	169	369	8.582641791044777	200
Q922X9	PF06325	64	95	3.1887500000000006	31	G5C692	65	95	3.294354838709677	30
O35344	PF00514	103	143	0.3588536585365854	40	G5B9Z4	104	144	0.3589512195121952	40
O35344	PF00514	146	183	1.9569736842105263	37	G5B9Z4	147	184	2.0716315789473683	37
O35344	PF00514	188	228	32.00092682926829	40	G5B9Z4	189	229	32.00226829268293	40
O35344	PF00514	232	269	22.75926315789475	37	G5B9Z4	233	270	22.684078947368413	37
O35344	PF00514	273	311	0.16176923076923086	38	G5B9Z4	274	312	0.16176923076923086	38
O35344	PF00514	314	354	11.817487804878052	40	G5B9Z4	315	355	11.823243902439025	40
O35344	PF00514	356	395	1.226225	39	G5B9Z4	357	396	1.274425	39
O35344	PF00514	404	437	13.81011764705882	33	G5B9Z4	403	436	15.479264705882352	33
O35344	PF01749	10	92	0.2903253012048193	82	G5B9Z4	11	93	0.2904096385542169	82
O35344	PF16186	448	497	0.6457999999999999	49	G5B9Z4	447	496	0.6459800000000001	49
P18894	PF01266	1	326	3.768773006134973	325	G5AWZ2	2	329	6.043719512195122	327
Q9CZ30	PF01926	125	135	0.0	10	G5AQ83	1	11	0.0	10
Q9CZ30	PF06071	304	387	1.9522976190476191	83	G5AQ83	180	263	1.898154761904762	83
Q8BHN7	PF17720	0	324	2.1637046153846167	324	G5BAQ0	1	323	1.831653250773993	322
Q9WUA2	PF03483	117	278	9.648530864197527	161	G5BGY3	118	279	9.6539012345679	161
Q9WUA2	PF03484	308	373	0.11131818181818183	65	G5BGY3	309	374	0.12198484848484845	65
Q9WUA2	PF17759	376	584	0.609842105263158	208	G5BGY3	377	585	0.8292392344497599	208
Q9WUA2	PF18262	0	89	0.8332888888888886	89	G5BGY3	1	90	0.6216333333333331	89
Q9D7S0	PF00021	22	104	1.4533493975903615	82	G5C3K7	23	108	4.4717674418604645	85
Q9D7S0	PF00021	120	182	7.003904761904763	62	G5C3K7	126	187	0.6202903225806449	61
Q99N95	PF00297	113	339	1.181713656387665	226	G5AM73	113	339	0.9640396475770926	226
Q8C0R9	PF13855	252	308	0.2998421052631579	56	G5C9K2	264	320	0.11682456140350875	56
Q8C0R9	PF13855	366	422	0.0	56	G5C9K2	378	433	5.155982142857143	55
Q8C0R9	PF13855	481	538	0.06568965517241379	57	G5C9K2	493	549	1.9818421052631576	56
Q8C0R9	PF13855	550	605	5.185607142857147	55	G5C9K2	562	617	6.491874999999997	55
Q922E4	PF01467	32	149	2.907457627118644	117	G5BJ82	1	118	2.920042372881357	117
Q922E4	PF01467	235	326	5.917934782608692	91	G5BJ82	187	278	5.108282608695653	91
Q8C4V4	PF00646	40	78	6.101179487179487	38	G5ASI0	42	80	13.481051282051284	38
Q9DCZ1	PF00478	9	338	2.5454121212121223	329	G5BT40	10	339	2.8825121212121214	329
Q6ZQ58	PF05383	381	436	14.758232142857144	55	G5AY08	307	362	15.585839285714286	55
Q4FK66	PF03371	10	173	1.6559512195121957	163	G5AUI5	11	174	1.6477804878048787	163
Q4FK66	PF12871	178	258	0.0	80	G5AUI5	179	264	5.47793023255814	85
P35235	PF00017	5	80	0.5085526315789475	75	G5AKV7	2	77	0.5164736842105263	75
P35235	PF00017	111	196	3.9639534883720926	85	G5AKV7	108	193	3.9661046511627913	85
P35235	PF00102	272	518	3.944105263157895	246	G5AKV7	269	511	4.312193415637862	242
Q9EPK5	PF00397	125	154	0.02183333333333333	29	G5BH55	105	134	0.02183333333333333	29
Q6IFX4	PF00038	90	397	0.2301688311688312	307	G5AX63	96	402	1.2205928338762209	306
O70552	PF07742	0	111	16.015116071428572	111	G5CB09	1	111	10.63445945945946	110
Q3U4I7	PF01593	45	404	2.3458111111111117	359	G5C4V3	46	405	2.7759694444444456	359
Q9D8N2	PF08616	158	262	2.1631428571428573	104	G5BVV4	76	180	2.4379809523809532	104
Q8CGK7	PF00503	22	369	6.53105172413793	347	G5C072	80	427	6.526364942528735	347
Q8VDP3	PF01494	84	120	24.70589189189189	36	G5BGE1	85	121	23.172081081081082	36
Q8VDP3	PF00307	510	610	4.786237623762377	100	G5BGE1	512	612	7.489049504950494	100
Q8VDP3	PF12130	917	1045	0.33668217054263544	128	G5BGE1	929	1057	0.6198992248062015	128
P51660	PF00106	10	194	6.047227027027023	184	G5AX60	11	151	7.066496453900711	140
P51660	PF01575	482	598	0.3557692307692308	116	G5AX60	416	532	0.3852478632478633	116
P51660	PF02036	629	729	2.930584158415842	100	G5AX60	563	663	0.5868514851485147	100
B1AZ99	PF02338	69	163	5.741894736842108	94	G5BZK8	68	162	5.74982105263158	94
Q80X82	PF11935	122	344	5.758995515695061	222	G5AUY2	143	365	5.703538116591928	222
Q80X82	PF12295	886	1042	5.607267515923568	156	G5AUY2	946	1103	5.350645569620254	157
Q8K4H1	PF07859	89	278	12.819863157894726	189	G5AVE7	72	269	12.46692424242424	197
Q3UH66	PF00069	199	452	2.4093307086614173	253	G5BIP5	133	386	2.318433070866141	253
Q3UH66	PF12202	473	536	0.30509374999999994	63	G5BIP5	407	470	0.36178125	63
Q8BHD7	PF00076	449	509	0.19640983606557386	60	G5BWR8	466	526	0.19665573770491804	60
Q8BHD7	PF11835	146	226	2.1484320987654346	80	G5BWR8	163	243	2.151061728395062	80
Q8BHD7	PF13893	301	424	9.20024193548387	123	G5BWR8	318	441	9.20482258064516	123
Q9CQ79	PF00085	78	161	3.598404761904761	83	G5BMS5	79	162	2.717523809523809	83
P29758	PF00202	50	435	4.20082901554404	385	G5BZ32	51	436	6.7189948186528525	385
Q9CQ06	PF00467	58	88	4.657903225806452	30	G5AR78	59	89	7.368387096774193	30
Q9CQ06	PF17136	92	153	0.011693548387096776	61	G5AR78	93	158	0.0	65
Q8CG16	PF00084	307	369	11.482952380952385	62	G5CAS6	322	384	10.214174603174603	62
Q8CG16	PF00084	374	445	0.036361111111111115	71	G5CAS6	389	460	0.05830555555555556	71
Q8CG16	PF00089	462	698	8.133864978902952	236	G5CAS6	477	711	2.6687276595744693	234
Q8CG16	PF00431	22	124	5.8137961165048555	102	G5CAS6	86	188	0.8223786407766992	102
Q8CG16	PF00431	191	300	0.6230909090909091	109	G5CAS6	206	315	0.6536363636363637	109
Q6NZN0	PF01480	10	75	5.804909090909088	65	G5B9T0	11	76	5.806878787878786	65
Q3U3N0	PF00249	299	342	9.421704545454542	43	G5B3S1	299	342	9.540772727272726	43
Q3U3N0	PF01448	195	243	0.0	48	G5B3S1	195	243	0.0	48
Q9WVJ5	PF00030	58	139	2.6513048780487813	81	G5BGM7	63	144	3.4392317073170737	81
Q9WVJ5	PF00030	147	228	7.3734878048780494	81	G5BGM7	152	233	5.087841463414633	81
Q7TMB8	PF05994	388	1221	5.3121702637889685	833	G5AZH3	365	1183	4.803035409035408	818
Q7TMB8	PF07159	69	272	10.666818627450985	203	G5AZH3	46	249	10.789862745098032	203
Q8VC48	PF04757	25	266	6.048342975206612	241	G5B751	26	266	9.065307053941906	240
Q8C3M9	PF17718	12	180	1.1900532544378704	168	G5C173	1	164	3.246701219512195	163
E9Q8D0	PF00226	32	65	0.2898235294117647	33	G5BQ91	1	34	0.29011764705882354	33
E9Q8D0	PF12171	313	338	0.0	25	G5BQ91	282	307	0.0	25
Q91ZT8	PF07525	250	288	0.0	38	G5C240	224	262	0.0	38
Q91ZT8	PF12796	35	124	0.7314222222222223	89	G5C240	9	98	0.3661888888888889	89
Q91ZT8	PF12796	133	223	0.1101098901098901	90	G5C240	107	197	0.6422417582417582	90
Q3UW68	PF00648	30	326	4.318740740740743	296	G5B8M1	35	329	2.8253525423728787	294
Q3UW68	PF01067	366	468	17.07067961165048	102	G5B8M1	369	468	8.506149999999998	99
A2AJI0	PF05672	592	734	0.0	142	G5C6F7	472	617	0.0	145
Q01822	PF00046	232	285	0.0	53	G5BU21	149	202	0.0	53
O70333	PF10235	12	98	0.0	86	G5C9S8	13	99	0.005781609195402298	86
Q61010	PF00097	417	477	10.464147540983607	60	G5AKW1	406	466	13.502852459016392	60
Q61010	PF02825	25	93	2.9653623188405813	68	G5AKW1	26	94	2.497985507246377	68
Q61010	PF02825	107	170	12.11425	63	G5AKW1	108	171	12.12165625	63
Q61010	PF18102	485	619	3.6175851851851855	134	G5AKW1	474	608	3.6400296296296313	134
O54819	PF00014	48	99	1.0946538461538462	51	G5BZH3	60	111	7.230846153846153	51
O54819	PF00014	119	171	0.2762452830188679	52	G5BZH3	130	182	0.0	52
O54819	PF00014	224	275	0.0	51	G5BZH3	61	111	7.014490196078433	50
Q91ZP3	PF04571	0	106	5.117869158878512	106	G5BR64	14	120	5.126401869158877	106
Q91ZP3	PF08235	659	872	3.029210280373836	213	G5BR64	667	879	2.5596462264150954	212
Q91ZP3	PF16876	497	571	1.65504	74	G5BR64	471	534	1.8305	63
Q9CWX2	PF08547	125	298	2.575844827586208	173	G5BM13	180	353	4.842195402298851	173
Q62383	PF00575	1226	1281	0.040946428571428564	55	G5BVI0	1239	1294	0.04085714285714285	55
Q62383	PF14632	50	125	0.0	75	G5BVI0	51	125	0.0	74
Q62383	PF14633	1299	1513	1.2926139534883712	214	G5BVI0	1312	1526	1.2875767441860457	214
Q62383	PF14635	934	1037	1.2599230769230778	103	G5BVI0	947	1050	1.2589134615384625	103
Q62383	PF14639	774	930	6.063662420382168	156	G5BVI0	775	943	5.679798816568048	168
Q62383	PF14641	305	421	1.992794871794872	116	G5BVI0	306	422	1.9916324786324788	116
Q62383	PF17674	1050	1137	0.0	87	G5BVI0	1063	1150	0.0	87
P55041	PF00071	75	237	11.177809815950921	162	G5C4C6	76	238	11.175429447852759	162
Q9EPQ2	PF00168	763	871	4.03854128440367	108	G5BFV4	717	825	3.088752293577981	108
Q9EPQ2	PF11618	582	720	2.7348417266187046	138	G5BFV4	536	674	9.12351798561151	138
Q9EPQ2	PF18111	1158	1323	4.149843373493975	165	G5BFV4	1065	1230	2.276759036144579	165
P26369	PF00076	150	223	1.9432162162162157	73	G5BVY1	224	297	1.9277432432432424	73
P26369	PF00076	260	329	0.5133571428571431	69	G5BVY1	334	403	0.5066571428571427	69
P26369	PF00076	399	458	2.4687666666666668	59	G5BVY1	469	528	2.547716666666667	59
Q9ESS0	PF00581	166	278	3.5009734513274338	112	G5ANM2	166	278	3.5017079646017706	112
Q9ESS0	PF00782	329	460	8.042325757575757	131	G5ANM2	328	459	8.221984848484851	131
Q9CZE3	PF00071	24	189	8.902415662650611	165	G5APK3	11	176	8.24525903614458	165
Q3U1V6	PF00056	183	315	10.714285714285717	132	G5AKA0	261	393	13.255030075187975	132
Q3U1V6	PF02866	319	443	4.332624000000001	124	G5AKA0	397	520	2.829282258064514	123
Q3U1V6	PF05743	20	140	3.0499338842975203	120	G5AKA0	98	218	4.582082644628098	120
Q921N8	PF15991	4	291	0.045503472222222216	287	G5B5B2	5	292	0.048576388888888884	287
Q9DBC7	PF00027	155	235	2.2654444444444444	80	G5BLR9	156	236	2.1943209876543213	80
Q9DBC7	PF00027	273	358	7.737534883720928	85	G5BLR9	274	359	7.650837209302321	85
Q9DBC7	PF02197	24	61	0.8342105263157893	37	G5BLR9	25	62	0.8799210526315789	37
Q8C5P7	PF15683	34	164	0.0920610687022901	130	G5AYM4	3	131	0.21428125	128
Q6NZK8	PF00782	165	234	34.27321428571429	69	G5BIP1	214	283	33.78244285714284	69
A2AG06	PF15189	756	921	5.781343373493978	165	G5BJ02	549	714	4.166343373493974	165
Q5BL07	PF00004	595	723	5.716108527131783	128	G5C9J8	587	715	4.773558139534883	128
Q5BL07	PF00004	877	1005	8.64767441860465	128	G5C9J8	869	997	8.539558139534881	128
Q5BL07	PF09262	103	178	11.261315789473686	75	G5C9J8	104	179	11.413855263157895	75
Q5BL07	PF09263	16	97	7.112475609756098	81	G5C9J8	17	98	5.952939024390246	81
Q5BL07	PF17862	1029	1060	0.13525	31	G5C9J8	1021	1051	0.11948387096774192	30
Q9Z2U1	PF00227	30	219	3.306184210526316	189	G5BQW4	31	220	3.306184210526316	189
Q9Z2U1	PF10584	7	29	0.0	22	G5BQW4	8	30	0.0	22
Q9WV74	PF07525	296	334	0.02269230769230769	38	G5BHH9	282	320	0.0	38
Q9WV74	PF12796	41	138	6.8655510204081605	97	G5BHH9	27	124	6.013142857142854	97
Q9DBX2	PF02114	35	298	3.4188030303030312	263	G5B6X7	36	299	3.3845492424242427	263
Q9D9P2	PF13877	97	187	4.933824175824177	90	G5BJ07	99	188	6.282755555555558	89
Q9D9P2	PF15867	6	73	0.32382352941176473	67	G5BJ07	7	74	0.531029411764706	67
P05480	PF00017	155	237	1.9182409638554216	82	G5B823	351	433	5.57289156626506	82
P05480	PF00018	88	122	8.969342857142856	34	G5B823	80	113	6.626	33
P05480	PF07714	275	522	5.296689516129033	247	G5B823	471	718	5.2731491935483845	247
Q5SPL2	PF00628	58	103	0.0	45	G5BVJ1	59	104	0.0	45
Q5SPL2	PF00628	273	315	0.01116279069767442	42	G5BVJ1	274	316	0.008372093023255813	42
Q5SPL2	PF16737	202	240	3.976282051282052	38	G5BVJ1	203	241	3.981564102564104	38
Q99MS3	PF04117	106	164	19.197101694915254	58	G5C0W0	69	127	17.189677966101698	58
O35625	PF00615	87	208	1.4888770491803278	121	G5BXX4	88	209	1.4874836065573769	121
O35625	PF00778	782	859	8.895333333333333	77	G5BXX4	783	860	8.77861538461538	77
O35625	PF08833	463	494	0.0	31	G5BXX4	465	496	0.0	31
O35625	PF16646	9	79	0.0	70	G5BXX4	10	80	0.0	70
Q9EQ06	PF00106	37	227	5.981696335078532	190	G5BSU9	38	228	5.4173141361256585	190
Q6W3F0	PF08336	32	157	5.521896825396826	125	G5AS93	63	188	4.932007936507937	125
Q6W3F0	PF13640	423	525	13.176631067961164	102	G5AS93	454	556	14.946194174757276	102
Q60I26	PF02204	834	934	7.799188118811878	100	G5ANP8	695	795	8.8499801980198	100
Q60I26	PF02493	369	377	0.0	8	G5ANP8	292	300	0.0	8
Q60I26	PF02493	381	395	0.9367333333333332	14	G5ANP8	304	317	4.596214285714286	13
Q60I26	PF02493	431	448	0.2452777777777778	17	G5ANP8	354	371	0.2558333333333333	17
Q60I26	PF02493	458	475	0.0	17	G5ANP8	381	398	0.0	17
Q60I26	PF02493	482	496	3.6948	14	G5ANP8	405	419	12.794	14
Q60I26	PF02493	505	524	0.2098	19	G5ANP8	428	447	0.0034	19
Q99K51	PF00307	123	236	12.518622807017545	113	G5AMW4	124	237	12.715429824561404	113
Q99K51	PF00307	267	377	3.7498828828828823	110	G5AMW4	269	379	3.7501171171171164	110
Q99K51	PF00307	398	504	12.280485981308413	106	G5AMW4	400	506	11.861037383177573	106
Q99K51	PF00307	520	625	10.253575471698113	105	G5AMW4	522	627	10.234679245283015	105
Q99K51	PF13499	14	81	6.834279411764705	67	G5AMW4	15	82	6.116235294117647	67
Q8BGM7	PF00571	281	331	21.075607843137256	50	G5AKL5	274	324	17.356627450980394	50
Q8BGM7	PF00571	356	402	9.577531914893619	46	G5AKL5	349	395	11.126340425531916	46
Q8BGM7	PF00571	426	477	5.423615384615385	51	G5AKL5	419	470	5.782057692307693	51
Q9EPX2	PF00014	749	800	7.920269230769231	51	G5C1P6	814	865	0.07846153846153846	51
Q9EPX2	PF00047	909	980	0.3589027777777778	71	G5C1P6	975	1045	0.9373802816901406	70
Q9EPX2	PF00090	32	79	0.0	47	G5C1P6	32	79	0.0	47
Q9EPX2	PF05986	185	298	0.7123859649122809	113	G5C1P6	185	298	0.3762982456140351	113
Q9EPX2	PF07679	1134	1218	5.246835294117645	84	G5C1P6	1196	1280	0.02723529411764706	84
Q9EPX2	PF08686	1234	1266	1.6369696969696974	32	G5C1P6	1296	1328	0.05348484848484848	32
Q9EPX2	PF13927	1048	1115	0.9411323529411764	67	G5C1P6	1110	1177	7.221176470588236	67
Q9EPX2	PF16626	808	891	0.0	83	G5C1P6	874	956	0.0	82
Q9EPX2	PF19030	308	360	8.770415094339622	52	G5C1P6	310	362	2.3274905660377363	52
Q9EPX2	PF19030	366	424	0.4546779661016949	58	G5C1P6	443	501	0.3993728813559322	58
Q9EPX2	PF19030	427	480	0.6217962962962963	53	G5C1P6	504	557	0.0	53
Q9EPX2	PF19030	488	538	0.8314901960784313	50	G5C1P6	564	614	1.0890392156862745	50
P59281	PF00620	932	1074	5.423979020979022	142	G5C5R2	941	1083	5.4224265734265735	142
P59281	PF00784	758	900	2.863405594405595	142	G5C5R2	767	909	2.865895104895104	142
Q9JK24	PF17958	182	257	14.462776315789476	75	G5B115	183	258	14.456921052631586	75
Q9JJ78	PF00069	98	314	3.206133640552995	216	G5BY84	20	240	3.1376968325791834	220
Q8VE73	PF00888	951	1498	3.0747810218978113	547	G5BNL3	957	1486	3.9334320754716963	529
Q8VE73	PF03256	832	948	8.019452991452992	116	G5BNL3	838	954	6.492076923076923	116
Q8VE73	PF11515	351	421	7.567760563380285	70	G5BNL3	359	429	5.196873239436617	70
Q5SSZ5	PF00017	1166	1260	1.7739052631578949	94	G5BIM7	1169	1262	1.700106382978723	93
Q5SSZ5	PF08416	1304	1438	7.4054370370370375	134	G5BIM7	1306	1440	7.718496296296299	134
Q5SSZ5	PF10409	173	298	5.227317460317464	125	G5BIM7	174	299	6.564158730158731	125
Q91YQ7	PF10607	155	297	1.717181818181819	142	G5BCC4	156	298	1.7749720279720285	142
P35969	PF00047	236	323	0.1383409090909091	87	G5ATU5	221	308	10.874238636363637	87
P35969	PF07679	351	405	7.498490909090909	54	G5ATU5	341	395	6.711145454545455	54
P35969	PF07679	661	748	1.3004545454545455	87	G5ATU5	651	738	1.2410227272727272	87
P35969	PF07714	827	1153	3.2858899082568813	326	G5ATU5	817	1144	4.141402439024391	327
P35969	PF13927	569	640	14.788875000000004	71	G5ATU5	559	630	14.227138888888895	71
P35969	PF17988	753	787	42.2634	34	G5ATU5	743	777	42.2634	34
P09022	PF00046	228	281	0.01490740740740741	53	G5BD49	231	284	0.01490740740740741	53
Q8JZS0	PF00595	108	186	0.014177215189873419	78	G5BH14	82	160	0.014278481012658224	78
Q8JZS0	PF02828	28	81	0.2866296296296296	53	G5BH14	2	55	0.3772222222222222	53
Q9JI13	PF04000	226	305	9.40825	79	G5BN00	225	304	7.75385	79
Q9JI13	PF09368	395	467	0.02056164383561644	72	G5BN00	396	468	0.02026027397260274	72
O55208	PF00010	71	109	0.5895641025641025	38	G5B4Y7	1	39	0.22307692307692306	38
Q5DTZ0	PF11977	739	889	3.5449006622516546	150	G5BDS3	706	856	3.1441390728476826	150
Q5DTZ0	PF17919	1072	1170	3.7861818181818174	98	G5BDS3	1044	1142	13.946909090909092	98
Q5DTZ0	PF17921	1478	1532	4.220436363636365	54	G5BDS3	1450	1504	4.194945454545453	54
P56942	PF05824	82	164	0.07228915662650602	82	G5AME1	83	165	0.01128048780487805	82
P62274	PF00253	8	53	0.018130434782608697	45	G5BW63	9	54	0.0	45
Q60675	PF02210	2963	3088	2.4108968253968257	125	G5C767	1904	2029	1.493039682539682	125
Q60675	PF00054	2169	2308	10.09328571428572	139	G5C767	1114	1253	10.055314285714283	139
Q60675	PF00054	2363	2502	3.6746357142857144	139	G5C767	1308	1443	3.8131323529411785	135
Q60675	PF00054	2549	2689	10.059425531914892	140	G5C767	1490	1630	8.414418439716313	140
Q60675	PF00054	2788	2915	8.1440078125	127	G5C767	1729	1856	7.693476562499999	127
Q60675	PF00052	578	709	10.812507575757575	131	G5C767	176	309	4.307738805970149	133
Q60675	PF00052	1229	1373	6.818951724137932	144	G5C767	176	320	3.980944827586207	144
Q60675	PF00053	282	322	0.04975609756097561	40	G5C767	362	398	1.2699999999999998	36
Q60675	PF00053	339	394	0.0	55	G5C767	362	398	1.2699999999999998	36
Q60675	PF00053	409	461	0.0	52	G5C767	2	45	0.0	43
Q60675	PF00053	479	510	0.084375	31	G5C767	74	105	0.0	31
Q60675	PF00053	719	739	0.0	20	G5C767	322	342	0.0	20
Q60675	PF00053	752	799	0.0	47	G5C767	362	408	1.4145957446808508	46
Q60675	PF00053	802	857	0.090875	55	G5C767	411	466	0.0	55
Q60675	PF00053	869	901	0.0	32	G5C767	476	506	0.045290322580645165	30
Q60675	PF00053	925	954	0.05833333333333333	29	G5C767	69	97	0.0	28
Q60675	PF00053	962	1002	0.0	40	G5C767	2	42	0.0	40
Q60675	PF00053	1009	1047	0.0	38	G5C767	2	42	0.0	40
Q60675	PF00053	1055	1103	0.0	48	G5C767	2	50	0.0	48
Q60675	PF00053	1374	1400	0.0	26	G5C767	321	346	0.0	25
Q60675	PF00053	1415	1461	1.4062765957446812	46	G5C767	362	408	1.4145957446808508	46
Q60675	PF00053	1464	1519	0.0	55	G5C767	411	466	0.0	55
Q60675	PF00053	1522	1562	0.023414634146341463	40	G5C767	469	509	0.04304878048780488	40
Q60675	PF06008	1589	1847	0.3788841698841698	258	G5C767	536	794	0.3370849420849421	258
Q60675	PF06009	2032	2166	0.2378592592592593	134	G5C767	979	1111	0.4875563909774437	132
Q80U12	PF00566	791	958	22.560077380952393	167	G5BCU0	837	1004	25.181702380952377	167
Q80U12	PF02759	42	187	5.246835616438358	145	G5BCU0	43	188	4.431527397260274	145
Q80U12	PF12068	256	391	3.8123970588235294	135	G5BCU0	257	392	3.760161764705882	135
Q9JHF7	PF02798	5	71	11.031029850746267	66	G5BXP7	6	72	11.127029850746267	66
Q9JHF7	PF14497	92	191	9.760809999999998	99	G5BXP7	93	191	5.561202020202019	98
Q01149	PF01391	32	79	0.0	47	G5ANK8	532	578	0.0	46
Q01149	PF01391	96	153	0.0	57	G5ANK8	86	143	0.0	57
Q01149	PF01391	474	532	0.0	58	G5ANK8	466	524	0.0	58
Q01149	PF01391	525	580	0.0	55	G5ANK8	517	572	0.0	55
Q01149	PF01391	917	957	0.0	40	G5ANK8	909	949	0.0	40
Q01149	PF01391	1050	1102	0.0	52	G5ANK8	1042	1093	0.0	51
Q01149	PF01410	1137	1370	2.5272735042735044	233	G5ANK8	1129	1362	2.532730769230769	233
P63005	PF00400	103	135	13.616333333333335	32	G5BCT6	66	98	13.623515151515155	32
P63005	PF00400	142	177	0.035	35	G5BCT6	105	140	0.042	35
P63005	PF00400	182	218	0.2345405405405405	36	G5BCT6	145	181	0.23470270270270266	36
P63005	PF00400	224	260	4.148243243243243	36	G5BCT6	187	223	6.266486486486487	36
P63005	PF00400	266	323	0.03296551724137932	57	G5BCT6	229	294	0.5624242424242426	65
P63005	PF00400	334	365	1.94659375	31	G5BCT6	263	294	1.1592187500000002	31
P63005	PF00400	370	406	0.8725945945945947	36	G5BCT6	299	335	0.8985675675675677	36
Q3UVR3	PF00069	64	240	5.9559152542372855	176	G5BM36	1	177	5.953740112994351	176
P01587	PF01109	17	135	0.024714285714285716	118	G5BJ26	18	138	0.9276198347107438	120
Q9JHF9	PF02221	32	152	12.985553719008267	120	G5B5T2	33	153	3.759347107438016	120
P29351	PF00017	3	78	0.2401315789473684	75	G5CAS1	4	79	0.2374342105263158	75
P29351	PF00017	109	193	7.584658823529412	84	G5CAS1	110	194	7.715552941176472	84
P29351	PF00102	269	512	6.4282008196721305	243	G5CAS1	270	528	6.156938223938223	258
Q9EQM6	PF00035	514	575	2.7405967741935493	61	G5CA26	515	576	2.7385	61
Q9EQM6	PF00035	619	683	0.4141692307692309	64	G5CA26	620	684	0.4137076923076924	64
Q8BFZ8	PF14976	4	148	2.8084275862068973	144	G5BX56	5	149	3.51545138888889	144
Q99P69	PF03800	4	67	10.744125	63	G5AQ25	5	67	11.070412698412698	62
Q8VHL1	PF00856	277	335	0.17767796610169492	58	G5BXF4	265	323	0.18671186440677967	58
Q8VHL1	PF02493	18	33	2.12725	15	G5BXF4	6	21	2.1339375000000005	15
Q8VHL1	PF02493	35	57	0.24756521739130435	22	G5BXF4	23	45	0.2551304347826087	22
Q8VHL1	PF02493	59	80	0.008772727272727272	21	G5BXF4	47	68	0.3806363636363636	21
Q8VHL1	PF02493	105	126	0.6400000000000001	21	G5BXF4	93	114	15.35	21
P97807	PF00206	54	385	0.6752168674698796	331	G5BL29	56	387	0.4852771084337347	331
P97807	PF10415	451	503	4.274867924528301	52	G5BL29	453	505	3.3572830188679235	52
Q9Z0S2	PF00046	266	322	2.49861403508772	56	G5B6W9	363	419	2.4997894736842112	56
Q9Z0S2	PF00412	52	109	9.7593275862069	57	G5B6W9	165	222	9.757362068965524	57
Q9Z0S2	PF00412	114	169	0.7481785714285717	55	G5B6W9	227	282	0.7487678571428573	55
Q8CG47	PF02463	80	609	1.588116981132075	529	G5AQ82	83	611	1.7830850661625692	528
Q8CG47	PF06470	610	724	8.651113043478261	114	G5AQ82	612	726	14.59159130434783	114
Q9CRA0	PF01129	34	255	7.380617117117118	221	G5BV49	53	273	5.752642533936652	220
P61329	PF00167	73	197	6.500376	124	G5BYJ1	8	132	6.520952000000001	124
Q9QZK7	PF02174	158	254	10.182381443298967	96	G5BQ13	160	256	5.990113402061857	96
Q9Z2D0	PF06602	107	445	4.5020855457227125	338	G5AMG1	108	446	4.62685250737463	338
O35710	PF03372	143	395	2.942098814229249	252	G5BTU0	170	453	4.632869718309862	283
Q9D8S3	PF01412	11	115	8.125419047619049	104	G5BPS5	12	116	9.702009523809524	104
Q8CHT0	PF00171	80	544	3.2663913978494614	464	G5BZM2	82	546	3.3724666666666665	464
Q9JHI7	PF01138	31	162	6.828765151515151	131	G5BBT0	32	163	6.9200833333333325	131
Q9JHI7	PF03725	188	253	20.8465303030303	65	G5BBT0	189	254	20.876075757575762	65
P16294	PF00008	96	126	0.0	30	G5BE76	97	127	0.0	30
P16294	PF00089	236	463	3.556017543859648	227	G5BE76	228	455	3.0192631578947378	227
P16294	PF00594	51	91	0.0	40	G5BE76	52	92	0.0	40
P16294	PF14670	133	169	0.06364864864864864	36	G5BE76	134	170	0.06708108108108109	36
Q8CHG3	PF01465	1608	1650	0.022604651162790697	42	G5CB89	1661	1703	17.474162790697676	42
Q8CHG3	PF16704	1542	1606	0.0	64	G5CB89	1595	1659	0.009584615384615384	64
Q3TVC7	PF13324	66	314	4.694783132530124	248	G5BM41	2	250	3.2542369477911635	248
Q9DCV6	PF08238	250	276	11.412074074074075	26	G5AQR3	254	280	2.3280370370370367	26
Q9DCV6	PF08238	277	312	11.847555555555555	35	G5AQR3	281	316	9.95263888888889	35
Q9DCV6	PF08238	313	349	0.3239189189189189	36	G5AQR3	317	353	0.0	36
Q9DCV6	PF08238	364	384	9.166952380952381	20	G5AQR3	368	388	9.151857142857144	20
Q9DCV6	PF08238	387	420	0.20835294117647055	33	G5AQR3	391	424	0.13661764705882354	33
Q8R4Y8	PF14726	15	111	1.927103092783505	96	G5BQP8	6	102	1.7806391752577306	96
Q61624	PF00096	170	192	0.07078260869565219	22	G5AQ77	171	193	0.08847826086956523	22
Q61624	PF00096	198	220	0.0	22	G5AQ77	199	221	0.0	22
Q61624	PF00096	226	248	0.0	22	G5AQ77	227	249	0.0	22
P28705	PF00104	264	442	7.191659217877096	178	G5AQ29	265	443	7.2019162011173155	178
P28705	PF00105	137	205	1.2665217391304346	68	G5AQ29	138	206	1.2382898550724637	68
P28705	PF11825	24	133	0.07767272727272727	109	G5AQ29	25	134	0.06870909090909091	109
P60229	PF01399	290	393	8.67850961538461	103	G5BSL6	242	345	9.469528846153848	103
P60229	PF09440	49	137	0.0888988764044944	88	G5BSL6	1	89	0.08816853932584269	88
P97478	PF03232	48	215	3.039970238095238	167	G5AY26	27	194	3.556024096385541	167
Q9JKS5	PF04774	210	312	0.0	102	G5BK36	125	228	0.04788461538461539	103
Q9JKS5	PF16174	113	159	0.0	46	G5BK36	26	72	0.0	46
Q9CPT3	PF13419	8	205	2.269217171717172	197	G5BJU8	9	206	2.123191919191918	197
Q3THK7	PF00117	29	135	4.3579252336448615	106	G5B263	101	211	5.147441441441441	110
Q3THK7	PF00958	598	691	2.5014680851063833	93	G5B263	595	688	2.5014574468085105	93
Q3THK7	PF02540	240	299	6.332399999999999	59	G5B263	180	239	1.6409166666666672	59
Q811D2	PF12001	1395	1502	0.019120370370370367	107	G5AY77	1124	1231	0.04041666666666667	107
Q811D2	PF12796	50	82	1.3086666666666666	32	G5AY77	39	70	0.6740625	31
Q811D2	PF14915	885	934	0.0	49	G5AY77	523	572	0.0	49
Q811D2	PF14915	935	1166	0.07944827586206897	231	G5AY77	592	823	0.0630991379310345	231
Q3UMQ8	PF04410	172	321	2.1107666666666667	149	G5BHV1	168	317	2.0874466666666662	149
Q05186	PF13202	83	98	0.026812500000000003	15	G5C8K3	5	20	0.0905625	15
Q05186	PF13202	204	221	0.0	17	G5C8K3	126	143	0.0	17
Q05186	PF13202	250	263	0.0	13	G5C8K3	172	185	0.0	13
P97427	PF01979	63	452	5.690238461538455	389	G5B318	52	441	7.045912820512815	389
Q3U3Q1	PF00069	16	269	3.517248031496062	253	G5AL65	17	270	3.478232283464568	253
Q3U3Q1	PF04212	280	344	0.8728000000000001	64	G5AL65	281	345	4.338292307692308	64
Q3U3Q1	PF04212	375	441	8.507119402985076	66	G5AL65	376	447	6.652652777777778	71
Q8CGK3	PF00004	507	644	6.531108695652175	137	G5C0Q5	453	590	5.0866159420289865	137
Q8CGK3	PF02190	111	356	1.3432642276422773	245	G5C0Q5	10	254	1.3486571428571437	244
Q8CGK3	PF05362	725	935	6.8163507109004735	210	G5C0Q5	671	881	7.772284360189572	210
Q3U319	PF13920	945	987	9.889000000000003	42	G5BYK3	945	987	9.885627906976742	42
Q571I9	PF00171	47	485	2.9620182232346237	438	G5B8N9	48	475	4.58472196261682	427
Q571I9	PF00171	546	767	11.765040540540538	221	G5B8N9	536	759	11.775995535714278	223
Q80XK6	PF09333	1977	2070	2.375531914893617	93	G5B497	1978	2071	2.3702234042553187	93
Q80XK6	PF12624	12	106	0.03577894736842105	94	G5B497	13	107	0.060926315789473676	94
Q9D7Z3	PF08157	166	228	0.18512698412698414	62	G5BN46	130	197	4.519338235294117	67
Q3TLH4	PF07001	0	161	0.07919135802469138	161	G5BGT1	1	163	0.07914110429447851	162
O35536	PF00014	34	85	0.0	51	G5ANK4	22	73	0.021365384615384616	51
O35536	PF00014	94	146	2.2011320754716976	52	G5ANK4	82	133	0.0	51
O35536	PF00014	154	205	0.07278846153846154	51	G5ANK4	141	192	0.2326923076923077	51
Q8VEH3	PF00025	11	178	9.015297619047619	167	G5B388	12	179	8.829589285714283	167
Q9Z0R4	PF00018	911	955	4.554555555555557	44	G5AM27	905	949	4.529000000000002	44
Q9Z0R4	PF00018	1000	1044	11.594644444444445	44	G5AM27	994	1038	10.215355555555554	44
Q9Z0R4	PF00018	1155	1198	1.4820227272727269	43	G5AM27	1149	1192	1.4225	43
Q9Z0R4	PF00621	1234	1413	3.8690944444444457	179	G5AM27	1228	1407	3.8695444444444447	179
Q9Z0R4	PF00168	1588	1684	9.933835051546392	96	G5AM27	1582	1678	9.937876288659794	96
Q9Z0R4	PF07653	1071	1126	1.8326607142857143	55	G5AM27	1065	1120	1.4768035714285717	55
Q9Z0R4	PF12763	20	99	5.1310375	79	G5AM27	12	91	4.2119624999999985	79
Q9Z0R4	PF12763	222	306	0.7622235294117647	84	G5AM27	214	298	0.7636352941176471	84
Q9Z0R4	PF14604	744	794	0.0	50	G5AM27	738	788	0.0	50
Q9Z0R4	PF16617	795	909	0.0	114	G5AM27	789	903	0.03739130434782609	114
Q9Z0R4	PF16652	1432	1584	5.774117647058825	152	G5AM27	1426	1578	5.778405228758168	152
Q8BW11	PF00089	29	233	10.800380487804878	204	G5AJV9	30	234	7.87599024390244	204
O88712	PF00389	37	132	3.408708333333332	95	G5BCJ5	137	232	3.390125000000001	95
O88712	PF02826	133	280	5.510283783783783	147	G5BCJ5	233	379	5.325074829931973	146
P51432	PF00168	727	821	1.7898210526315788	94	G5B6Q5	705	799	1.7144947368421053	94
P51432	PF00387	590	704	4.124930434782609	114	G5B6Q5	568	682	4.114713043478261	114
P51432	PF00388	318	468	1.9089668874172183	150	G5B6Q5	300	450	1.903013245033113	150
P51432	PF08703	1028	1199	0.09084302325581392	171	G5B6Q5	999	1170	0.049784883720930234	171
P51432	PF09279	216	307	0.05340217391304347	91	G5B6Q5	198	289	0.04369565217391305	91
P51432	PF17787	32	145	9.82878947368421	113	G5B6Q5	14	127	9.794263157894736	113
P41136	PF00010	36	75	0.032499999999999994	39	G5C0Y4	37	76	0.018725	39
P59041	PF00226	42	103	8.037435483870969	61	G5BG79	90	151	4.424838709677419	61
Q80VP2	PF15244	31	409	0.3196437994722956	378	G5BRE3	120	504	0.9912727272727274	384
Q8BZT7	PF05826	148	242	6.457168421052631	94	G5BBU4	147	241	8.369673684210525	94
Q8BZT7	PF05826	355	403	0.0	48	G5BBU4	330	377	0.0	47
Q5NCR9	PF09745	57	175	0.3004453781512605	118	G5BVP7	58	176	0.2923781512605042	118
P56376	PF00708	10	96	1.4538390804597705	86	G5C1L0	11	97	0.7073103448275865	86
O88995	PF13637	67	109	2.0996279069767443	42	G5C3E0	67	109	2.0757209302325585	42
P58059	PF01165	10	63	0.06481481481481481	53	G5BH36	11	64	0.05185185185185185	53
Q9QZL6	PF00443	211	555	2.5462086956521737	344	G5BWI4	212	555	2.6351104651162793	343
Q9D384	PF00076	52	121	5.715228571428571	69	G5AWS8	53	122	4.308857142857144	69
Q8BW22	PF05030	22	72	14.455509803921569	50	G5BDX1	72	122	14.476803921568624	50
P51960	PF00249	138	181	0.0	43	G5AQP0	132	175	0.0	43
P51960	PF07988	242	284	0.15244186046511626	42	G5AQP0	208	252	0.041688888888888886	44
P51960	PF09316	484	643	0.0	159	G5AQP0	450	609	0.0	159
P51960	PF13921	42	97	0.21091071428571426	55	G5AQP0	36	91	0.22269642857142855	55
Q9R061	PF10609	16	265	4.960483999999999	249	G5BY65	29	278	4.773608	249
Q9ER69	PF17098	68	221	4.684201298701301	153	G5BC69	69	222	5.141461038961041	153
O09000	PF00989	116	171	14.545571428571437	55	G5BVU0	117	171	13.921418181818185	54
O09000	PF07469	1264	1319	0.0	55	G5BVU0	1183	1237	0.0	54
O09000	PF08815	1051	1098	0.0	47	G5BVU0	957	1004	0.0	47
O09000	PF08832	608	696	0.06037078651685392	88	G5BVU0	583	671	0.060438202247191014	88
O09000	PF14598	272	371	0.0438	99	G5BVU0	242	341	0.12228	99
O09000	PF16279	714	801	0.029318181818181827	87	G5BVU0	689	776	0.029318181818181827	87
O09000	PF16665	451	562	0.05376785714285713	111	G5BVU0	426	537	0.05385714285714286	111
Q80UP5	PF11904	155	466	0.2947756410256408	311	G5B650	160	473	0.36124522292993655	313
Q80UP5	PF13637	40	89	2.2612	49	G5B650	41	94	3.212333333333333	53
Q9Z266	PF14712	23	108	1.4864767441860465	85	G5BER4	24	109	1.4864767441860465	85
Q8CGV9	PF13912	275	299	0.0	24	G5BL38	263	287	0.0	24
Q8CDM1	PF00004	118	251	11.077559701492543	133	G5AY87	431	564	9.350813432835816	133
Q8CDM1	PF00439	651	715	6.815261538461536	64	G5AY87	907	971	6.826292307692305	64
Q8CDM1	PF17862	278	322	0.1442888888888889	44	G5AY87	591	635	0.14855555555555552	44
Q99JT1	PF02637	405	553	5.985060402684564	148	G5BMJ2	473	620	6.6897432432432415	147
Q99JT1	PF02934	65	350	1.9418496503496503	285	G5BMJ2	133	417	1.4151789473684218	284
Q9CQV6	PF02991	14	119	10.523735849056603	105	G5BF21	2	107	10.625688679245284	105
Q9JMJ2	PF00400	194	224	0.2736451612903226	30	G5CAF9	187	217	0.2740322580645161	30
Q80XE1	PF10165	65	482	5.093736842105269	417	G5C457	66	483	5.425705741626794	417
P56546	PF00389	43	138	2.0825104166666666	95	G5B146	44	139	2.3958020833333333	95
P56546	PF02826	139	322	5.187815217391304	183	G5B146	140	323	5.589461956521739	183
Q9WUI1	PF00069	35	307	5.066102564102566	272	G5B2H9	1	274	5.151459854014597	273
Q8BIQ8	PF00096	30	52	0.1982608695652174	22	G5BZS2	27	49	0.17504347826086955	22
Q8BIQ8	PF00096	58	80	0.0	22	G5BZS2	55	77	0.0	22
Q8BIQ8	PF00096	163	185	0.0	22	G5BZS2	160	182	0.0	22
Q8BIQ8	PF00096	191	213	0.0	22	G5BZS2	188	210	0.0	22
Q8BIQ8	PF00096	485	506	0.0	21	G5BZS2	482	503	0.0	21
Q8BIQ8	PF00096	512	534	0.0	22	G5BZS2	509	531	0.0	22
Q8BIQ8	PF00096	667	689	0.0	22	G5BZS2	654	676	0.0	22
Q8CJ00	PF00018	374	419	1.9303478260869569	45	G5BFZ6	400	445	0.4296086956521739	45
Q8CJ00	PF00564	292	362	0.6075774647887322	70	G5BFZ6	318	388	0.2901830985915493	70
Q9JKV2	PF00069	3	283	3.1967402135231318	280	G5C1F6	4	285	3.2218191489361687	281
Q9QXE2	PF10391	334	380	0.07851063829787235	46	G5CAF7	334	380	0.0647872340425532	46
Q9QXE2	PF14716	250	315	0.09363636363636364	65	G5CAF7	250	315	0.9116212121212122	65
Q9QXE2	PF14791	499	571	7.108506849315069	72	G5CAF7	499	571	14.546890410958898	72
Q9QXE2	PF14792	383	492	2.1817545454545457	109	G5CAF7	383	492	1.5375181818181822	109
O88485	PF00400	461	499	4.186205128205128	38	G5AJS5	479	517	4.230538461538462	38
O88485	PF11540	125	155	0.5095161290322581	30	G5AJS5	143	173	0.5083870967741935	30
Q8JZY4	PF16953	338	574	2.9882278481012654	236	G5B116	341	577	4.207012658227848	236
Q8VC97	PF00795	72	349	4.096467625899276	277	G5B628	73	350	3.858665467625896	277
Q9DBI2	PF00118	17	94	9.522474358974355	77	G5C9H4	10	87	13.246269230769233	77
Q8R1S4	PF08397	16	240	4.416786666666668	224	G5AY96	156	378	4.3051928251121065	222
Q8R1S4	PF02205	729	753	0.19	24	G5AY96	876	900	0.1888	24
Q91W36	PF00443	158	507	6.844645714285716	349	G5AVX0	207	525	7.931884012539184	318
Q91W36	PF02148	42	105	0.471625	63	G5AVX0	91	154	0.0	63
P36363	PF00167	64	188	6.975887999999997	124	G5CA45	65	189	7.4367119999999955	124
Q9D0D3	PF17797	62	131	6.704142857142857	69	G5C5F2	63	132	4.638514285714284	69
Q9D0D3	PF19088	301	400	17.10245	99	G5C5F2	302	401	15.828390000000002	99
P46471	PF00004	211	343	4.5476616541353385	132	G5BI50	212	344	4.459451127819549	132
P46471	PF17862	366	410	0.5518444444444444	44	G5BI50	367	411	0.5622	44
Q91YI0	PF00206	10	304	4.002457627118644	294	G5BIR7	8	302	4.7247830508474555	294
Q91YI0	PF14698	367	386	23.2638	19	G5BIR7	364	382	25.955722222222217	18
Q3TMV7	PF07992	20	216	4.2340507614213205	196	G5BEF6	15	211	4.017903553299491	196
Q3TMV7	PF07992	283	380	0.3906428571428569	97	G5BEF6	279	376	0.6998775510204079	97
Q3TMV7	PF18267	408	475	2.8861029411764707	67	G5BEF6	403	470	2.8188970588235294	67
Q99104	PF01843	1684	1785	8.45872549019608	101	G5C9D1	1700	1801	8.480352941176468	101
Q99104	PF00612	766	785	0.0	19	G5C9D1	758	777	0.0	19
Q99104	PF00612	790	808	0.19105263157894736	18	G5C9D1	782	800	0.2023684210526316	18
Q99104	PF00612	814	830	0.0	16	G5C9D1	806	821	0.0	15
Q99104	PF00612	838	857	9.6587	19	G5C9D1	830	848	8.476	18
Q99104	PF00612	865	882	0.08055555555555555	17	G5C9D1	857	874	0.12694444444444444	17
Q99104	PF00612	887	905	12.838526315789476	18	G5C9D1	879	897	14.521842105263154	18
Q99104	PF00063	71	750	3.2052249999999987	679	G5C9D1	63	742	3.2012514705882342	679
Q6P1I6	PF01369	308	459	1.7326710526315785	151	G5BCQ4	313	464	1.7380526315789468	151
Q6P1I6	PF15410	510	621	6.791973214285713	111	G5BCQ4	515	625	6.8137657657657655	110
Q61646	PF00089	102	339	2.5607647058823533	237	G5B5U6	101	338	6.049403361344536	237
Q8R2V3	PF00096	497	519	0.0	22	G5C207	540	562	0.0	22
Q8R2V3	PF00096	633	655	0.0	22	G5C207	681	703	0.0	22
Q8R2V3	PF00096	661	683	0.0482608695652174	22	G5C207	709	730	0.037954545454545456	21
Q8R2V3	PF00096	718	739	11.242272727272727	21	G5C207	763	784	5.7358636363636375	21
Q8R2V3	PF00096	745	767	0.0	22	G5C207	790	812	0.0	22
Q8R2V3	PF00096	823	845	0.0	22	G5C207	868	890	0.0	22
Q8R2V3	PF00096	960	982	0.0	22	G5C207	1006	1028	0.0	22
Q8R2V3	PF01352	219	257	7.166076923076923	38	G5C207	237	275	0.07923076923076923	38
Q8R2V3	PF02023	47	133	0.9208620689655174	86	G5C207	53	139	1.3242758620689652	86
Q3TCH7	PF00888	62	659	6.192933110367889	597	G5AVV9	51	653	5.99205970149254	602
Q3TCH7	PF10557	690	749	0.0342	59	G5AVV9	684	743	0.0342	59
Q9JHD2	PF00439	729	810	0.07918292682926828	81	G5B0K7	644	725	0.01152439024390244	81
Q9JHD2	PF00583	535	619	16.94262352941177	84	G5B0K7	450	534	16.822623529411768	84
Q9JHD2	PF06466	128	330	7.0310394088670005	202	G5B0K7	1	243	5.892748971193414	242
Q8CIE6	PF00400	44	78	0.03985714285714285	34	G5BWK3	45	79	0.04	34
Q8CIE6	PF00400	83	120	5.238236842105264	37	G5BWK3	84	121	5.2505000000000015	37
Q8CIE6	PF00400	125	162	2.691342105263158	37	G5BWK3	126	163	2.642394736842106	37
Q8CIE6	PF04053	341	765	5.541929411764707	424	G5BWK3	396	820	5.651218823529412	424
Q8CIE6	PF06957	814	1223	1.7761292682926824	409	G5BWK3	869	1278	1.6660048899755504	409
Q8CIE6	PF12894	211	290	0.4084	79	G5BWK3	212	291	0.3996875	79
Q9ESK3	PF00648	13	316	2.0501019736842103	303	G5C3Q6	14	318	2.2182688524590155	304
Q9ESK3	PF01067	343	479	3.6848321167883213	136	G5C3Q6	345	481	3.7117299270072968	136
Q9ESK3	PF01067	514	635	3.1012950819672125	121	G5C3Q6	517	654	4.312913043478261	137
Q9QUK0	PF00069	121	288	5.876333333333335	167	G5B1B4	57	222	3.728710843373493	165
Q99KE3	PF02174	136	229	2.7613936170212767	93	G5AUE8	137	230	2.7765638297872357	93
Q9D7N3	PF00380	267	389	0.9037642276422764	122	G5AZF3	274	396	0.5521967213114753	122
Q9WVG9	PF05712	164	508	1.754327536231884	344	G5BRL3	255	599	1.7284202898550722	344
Q9WVG9	PF11717	33	71	7.398948717948718	38	G5BRL3	128	166	1.7506923076923069	38
O08586	PF00782	100	158	9.69335593220339	58	G5B5S3	101	159	9.698389830508477	58
O08586	PF10409	187	348	8.061555555555557	161	G5B5S3	188	349	8.06874074074074	161
Q5SRT8	PF00134	35	141	17.00152336448598	106	G5BEM6	37	192	8.752205128205128	155
Q5SRT8	PF02984	143	247	7.3038190476190445	104	G5BEM6	194	297	6.647663461538462	103
Q61097	PF07714	563	825	8.066254752851712	262	G5BFG2	648	910	7.942403041825094	262
Q61097	PF13543	129	165	0.0	36	G5BFG2	154	190	0.0	36
Q9DB29	PF13472	19	206	4.757813829787233	187	G5BEK3	20	208	4.213571428571428	188
P43267	PF00505	46	114	3.275913043478261	68	G5B5D1	49	117	2.8755362318840585	68
Q3UPF5	PF00644	828	908	0.8049382716049384	80	G5B553	734	813	4.868699999999999	79
Q3UPF5	PF02825	696	770	2.0018	74	G5B553	592	666	4.960093333333334	74
Q3UPF5	PF18606	5	65	8.486311475409831	60	G5B553	6	66	2.1501311475409834	60
Q3UPF5	PF18633	142	169	0.0	27	G5B553	144	171	0.0	27
Q9CY62	PF13639	86	128	0.029767441860465118	42	G5BU83	75	117	0.028488372093023257	42
P16879	PF00017	459	528	4.421714285714288	69	G5CAB6	456	525	7.466942857142858	69
P16879	PF00611	11	84	0.10047297297297296	73	G5CAB6	12	85	0.10027027027027027	73
P16879	PF07714	561	813	5.606201581027667	252	G5CAB6	558	810	6.329671936758893	252
Q99MV7	PF00567	443	514	2.815708333333332	71	G5B1A6	417	487	2.981605633802817	70
Q99MV7	PF00567	701	818	2.014296610169492	117	G5B1A6	674	841	24.010994047619047	167
Q99MV7	PF00567	937	1052	6.567724137931028	115	G5B1A6	962	1077	8.058767241379314	115
Q99MV7	PF00567	1200	1311	1.5236785714285712	111	G5B1A6	1228	1339	2.5251160714285708	111
Q99MV7	PF00567	1479	1566	7.883409090909091	87	G5B1A6	1506	1593	5.408954545454545	87
O35963	PF00071	34	198	8.145860606060607	164	G5BXF5	35	199	8.164915151515151	164
Q2EMV9	PF00644	1643	1815	5.5621502890173415	172	G5AV98	1628	1800	7.125497109826587	172
Q2EMV9	PF01661	830	943	0.3637807017543859	113	G5AV98	819	924	0.3497169811320756	105
Q2EMV9	PF01661	1049	1158	0.8127454545454545	109	G5AV98	1040	1147	0.18545370370370368	107
Q2EMV9	PF01661	1255	1356	0.8591078431372546	101	G5AV98	1245	1346	0.3784411764705882	101
Q922Q9	PF00704	80	383	2.9884539473684235	303	G5C8F8	84	398	3.2578063492063487	314
Q6PDY2	PF07847	44	253	3.408652380952382	209	G5C603	57	268	2.5097783018867923	211
Q61136	PF00069	691	1002	1.900820512820515	311	G5C8W9	552	863	1.9099743589743583	311
Q8BM85	PF00069	41	272	8.714831896551722	231	G5AQM7	42	273	9.208784482758617	231
Q8BM85	PF00566	470	621	10.159875000000003	151	G5AQM7	471	621	10.30168	150
Q8C966	PF00628	308	352	0.03922222222222222	44	G5BKH7	305	349	0.013777777777777778	44
Q9JMG7	PF00855	28	89	5.744403225806451	61	G5BF03	1	62	5.753064516129032	61
Q7TSG2	PF03031	183	320	3.112304347826085	137	G5AP10	182	319	2.53996376811594	137
Q7TSG2	PF09309	705	959	0.07417647058823529	254	G5AP10	714	963	0.07658634538152609	249
Q8BHW9	PF04326	223	322	3.3689999999999998	99	G5AQJ7	109	207	4.340373737373735	98
O55112	PF05110	431	499	0.0	68	G5BQ58	8	76	0.0	68
O55112	PF18875	758	772	1.6634666666666666	14	G5BQ58	347	361	1.3962666666666663	14
O55112	PF18876	1095	1270	0.4260568181818183	175	G5BQ58	753	928	0.4213011363636364	175
Q68SA9	PF00090	526	576	0.0	50	G5AUL4	673	723	0.5142941176470589	50
Q68SA9	PF01421	225	436	5.902103773584906	211	G5AUL4	185	425	5.428867219917014	240
Q68SA9	PF01562	66	173	1.3605277777777778	107	G5AUL4	20	127	2.3183148148148147	107
Q68SA9	PF05986	683	793	4.61836936936937	110	G5AUL4	828	939	4.717455357142859	111
Q68SA9	PF17771	448	512	0.4591999999999999	64	G5AUL4	437	501	1.0752307692307692	64
Q68SA9	PF19030	807	861	0.05618181818181818	54	G5AUL4	955	1009	5.428345454545455	54
Q68SA9	PF19030	865	919	0.21754545454545454	54	G5AUL4	1013	1066	0.2106666666666666	53
Q68SA9	PF19030	928	976	0.6389795918367346	48	G5AUL4	1076	1124	0.31734693877551023	48
Q68SA9	PF19030	1385	1433	0.0629591836734694	48	G5AUL4	1428	1484	0.10049122807017544	56
Q68SA9	PF19030	1436	1491	0.0	55	G5AUL4	1487	1542	0.11005357142857143	55
Q68SA9	PF19030	1494	1540	0.05470212765957448	46	G5AUL4	1545	1591	0.13251063829787232	46
Q68SA9	PF19030	1543	1598	0.11892857142857145	55	G5AUL4	1594	1649	0.0	55
Q9JHU2	PF03285	76	491	0.8958557692307694	415	G5C717	62	477	0.8876394230769231	415
Q9CWV1	PF00493	383	603	5.346696832579188	220	G5BY79	384	622	9.809803347280331	238
Q9CWV1	PF17207	199	330	3.774295454545455	131	G5BY79	200	331	4.0574318181818185	131
Q9CWV1	PF17855	657	740	0.009000000000000001	83	G5BY79	676	759	0.03625	83
Q8BXG3	PF10498	43	400	3.5957821229050286	357	G5CA38	34	391	3.5782262569832386	357
Q3UMW7	PF00069	48	305	6.072732558139533	257	G5BZT6	49	306	6.8371821705426346	257
P39061	PF06482	1462	1737	2.7102282608695645	275	G5ATA4	1157	1431	2.0963199999999995	274
P39061	PF01391	841	877	0.0	36	G5ATA4	518	566	0.0	48
P39061	PF01391	952	1001	0.0	49	G5ATA4	763	817	0.0	54
P39061	PF01391	988	1034	0.0	46	G5ATA4	689	734	0.0	45
P39061	PF01391	1071	1116	0.0	45	G5ATA4	763	805	0.0	42
P39061	PF01391	1215	1263	0.0	48	G5ATA4	906	954	0.0	48
P39061	PF13385	539	676	10.298630434782599	137	G5ATA4	218	355	6.994144927536235	137
A6PWD2	PF00498	17	84	0.06404411764705882	67	G5BRS4	18	85	0.08954411764705887	67
B2RX14	PF00098	1310	1326	0.0	16	G5AUI6	1317	1333	0.0	16
B2RX14	PF00098	1358	1374	0.06411764705882353	16	G5AUI6	1382	1398	0.065	16
B2RX14	PF03828	648	697	18.757539999999988	49	G5AUI6	654	703	18.86748	49
B2RX14	PF03828	1200	1253	8.813018518518517	53	G5AUI6	1207	1260	8.815222222222225	53
B2RX14	PF19088	284	618	8.913701492537315	334	G5AUI6	290	624	9.052008955223881	334
B2RX14	PF19088	941	1159	6.681721461187215	218	G5AUI6	948	1166	6.682296803652968	218
Q8K394	PF00168	755	856	0.8308529411764706	101	G5BMI1	660	761	0.8312058823529412	101
Q8K394	PF00387	618	731	0.7973157894736841	113	G5BMI1	523	636	0.790517543859649	113
Q8K394	PF00388	428	571	5.621118055555552	143	G5BMI1	333	476	4.409451388888886	143
Q8K394	PF09279	336	419	9.678916666666664	83	G5BMI1	241	324	9.678869047619042	83
Q8K394	PF16457	137	250	3.2287719298245623	113	G5BMI1	42	155	3.254850877192982	113
Q8BJA3	PF00046	268	338	0.6947042253521126	70	G5AMH2	232	302	0.6959436619718311	70
Q8BJA3	PF04814	37	225	0.5776190476190477	188	G5AMH2	1	189	0.5786507936507936	188
J3S6Y1	PF03736	360	407	14.966458333333335	47	G5BG24	289	341	18.18535849056604	52
J3S6Y1	PF03736	412	459	8.652708333333335	47	G5BG24	346	393	2.5382708333333333	47
J3S6Y1	PF03736	465	510	21.219804347826084	45	G5BG24	399	444	23.444608695652175	45
J3S6Y1	PF03736	515	568	28.64101851851853	53	G5BG24	449	502	15.25218518518518	53
J3S6Y1	PF03736	575	621	9.624361702127661	46	G5BG24	509	555	11.567893617021284	46
Q80Z24	PF13927	131	200	0.7960714285714282	69	G5C4U1	60	129	0.8353714285714283	69
Q80Z24	PF13927	218	294	2.445558441558442	76	G5C4U1	147	223	2.446077922077922	76
Q7TQG0	PF00651	13	120	6.580620370370372	107	G5C1E0	14	121	6.575175925925926	107
Q9Z2Y3	PF00568	3	105	6.089291262135923	102	G5AST8	2	104	6.0913883495145615	102
Q01853	PF00004	240	369	10.75643846153846	129	G5BXB9	235	364	10.73146923076923	129
Q01853	PF00004	513	646	4.747074626865667	133	G5BXB9	508	641	4.691014925373134	133
Q01853	PF17862	392	434	0.01186046511627907	42	G5BXB9	387	429	0.01186046511627907	42
Q01853	PF17862	670	698	0.0	28	G5BXB9	664	691	0.0	27
Q01853	PF09336	719	759	0.0	40	G5BXB9	713	753	0.0	40
Q01853	PF02359	24	105	5.2870121951219495	81	G5BXB9	19	100	5.288109756097559	81
Q01853	PF02933	125	189	1.0504769230769238	64	G5BXB9	120	184	1.0512461538461544	64
Q9WV66	PF12906	553	608	0.0	55	G5C002	544	599	0.0	55
Q9R0L1	PF00447	19	119	3.7117722772277215	100	G5C646	20	120	3.709366336633662	100
Q9JLB2	PF09060	122	169	4.2729791666666666	47	G5C7Y4	123	170	4.2642500000000005	47
Q9JLB2	PF00595	257	330	5.039337837837838	73	G5C7Y4	258	331	6.068932432432432	73
Q9JLB2	PF00625	478	660	2.7104590163934428	182	G5C7Y4	479	661	2.7455792349726784	182
Q9JLB2	PF02828	186	230	2.083333333333333	44	G5C7Y4	187	231	1.9914222222222215	44
Q9JLB2	PF07653	348	411	0.15315625000000002	63	G5C7Y4	349	412	0.15032812499999998	63
Q8R3K3	PF10037	86	206	9.254719008264463	120	G5B210	42	162	8.841652892561983	120
Q91WM3	PF00400	138	172	15.325114285714278	34	G5AXN8	140	174	15.237571428571426	34
Q91WM3	PF00400	196	225	19.284366666666664	29	G5AXN8	198	227	19.2927	29
Q91WM3	PF00400	232	268	0.9065135135135134	36	G5AXN8	234	270	1.3030540540540545	36
Q91WM3	PF00400	277	310	0.0725	33	G5AXN8	279	312	0.0726470588235294	33
Q91WM3	PF00400	315	349	3.9828857142857146	34	G5AXN8	317	351	4.203657142857144	34
P47873	PF07400	33	197	1.072678787878787	164	G5BVZ4	34	198	1.6316909090909082	164
Q6ZPS6	PF00023	146	175	0.0988	29	G5C9K0	147	176	0.0988	29
Q6ZPS6	PF01485	402	478	0.40310389610389596	76	G5C9K0	403	479	0.4027532467532468	76
Q6ZPS6	PF01485	515	556	1.7535714285714288	41	G5C9K0	516	557	1.7406904761904758	41
Q61312	PF03299	222	417	2.861005102040817	195	G5AUN5	254	449	3.304632653061226	195
Q8R3L8	PF00069	25	334	7.570351612903228	309	G5AMX6	26	335	7.345912903225808	309
Q99L28	PF01246	26	64	0.0	38	G5B2P6	1	39	0.0	38
Q8R121	PF00079	82	444	6.6063994490358215	362	G5AXJ7	79	442	7.180208791208784	363
Q9DBA6	PF13365	358	497	12.908171428571428	139	G5B192	103	270	9.499154761904762	167
Q8VEG0	PF15374	7	429	1.8768628841607569	422	G5BZV6	100	547	1.740151785714287	447
Q768S4	PF02318	46	157	5.345687500000001	111	G5BVL0	47	208	2.2400123456790126	161
Q922L6	PF04858	13	586	5.968611498257848	573	G5AKZ4	22	645	5.494014423076917	623
Q9DCS9	PF10249	41	167	0.8970551181102365	126	G5BY58	42	168	0.8821968503937011	126
Q80VR2	PF07303	288	388	0.040792079207920766	100	G5BM54	286	386	0.0	100
Q80VR2	PF10390	72	116	6.3846888888888875	44	G5BM54	99	143	4.221466666666666	44
Q8R164	PF00561	64	172	10.162284403669727	108	G5BKE7	52	159	16.154287037037033	107
P63085	PF00069	38	310	4.104326007326008	272	G5BKG1	40	312	4.107586080586081	272
Q80YV3	PF00454	2243	2487	4.804281632653062	244	G5AX85	3528	3772	4.9660448979591845	244
Q80YV3	PF02259	1549	1891	2.267387755102042	342	G5AX85	2841	3194	2.263220338983051	353
P63318	PF00069	352	598	8.672178137651812	246	G5CBF1	315	561	8.28865182186235	246
P63318	PF00130	38	86	8.852571428571428	48	G5CBF1	1	49	8.860673469387752	48
P63318	PF00130	100	151	4.853461538461539	51	G5CBF1	63	114	4.859423076923077	51
P63318	PF00168	172	276	2.8455238095238102	104	G5CBF1	135	239	2.8480761904761907	104
P63318	PF00433	641	674	5.8100588235294115	33	G5CBF1	604	637	5.89058823529412	33
Q8CIN6	PF00076	8	75	3.706264705882353	67	G5B8L4	9	76	3.710470588235294	67
Q8CIN6	PF00076	95	160	0.4195151515151516	65	G5B8L4	97	162	0.3640151515151515	65
Q8CIN6	PF00076	423	450	6.7881785714285705	27	G5B8L4	340	367	0.5808214285714285	27
Q9D8N6	PF15306	88	238	0.12517880794701985	150	G5BXN4	89	239	3.393172185430463	150
Q3U288	PF00096	297	318	0.15731818181818186	21	G5CAA3	297	318	0.1575909090909091	21
Q3U288	PF00096	324	346	0.0	22	G5CAA3	324	346	0.0	22
Q3U288	PF00096	352	374	0.0	22	G5CAA3	352	374	0.0	22
Q3U288	PF00096	380	402	0.0	22	G5CAA3	380	402	0.0	22
Q3U288	PF00096	408	430	0.02817391304347826	22	G5CAA3	408	430	0.021130434782608697	22
Q3U288	PF00096	436	458	0.0	22	G5CAA3	436	458	0.0	22
Q3U288	PF00096	464	486	0.0	22	G5CAA3	464	486	0.0	22
Q3U288	PF00096	492	514	0.05369565217391304	22	G5CAA3	492	514	0.05369565217391304	22
Q3U288	PF00096	520	542	0.0	22	G5CAA3	520	542	0.0	22
Q3U288	PF00096	548	570	0.03847826086956522	22	G5CAA3	548	570	0.03847826086956522	22
Q3U288	PF00096	576	599	0.0	23	G5CAA3	576	599	0.0	23
O89094	PF00656	30	254	3.0347866666666685	224	G5BYQ6	14	227	4.572345794392523	213
Q9CQK1	PF04438	9	34	17.275576923076922	25	G5ARB8	10	35	16.047653846153846	25
Q80XJ2	PF14447	15	61	0.0	46	G5ALC0	16	62	0.0	46
Q9D1M4	PF00043	88	149	10.495677419354836	61	G5BAT9	89	150	12.045564516129033	61
Q8C033	PF00621	403	581	7.195966480446926	178	G5AYN1	400	578	6.7501229050279346	178
Q8C033	PF19056	861	1342	7.433958506224066	481	G5AYN1	858	1339	7.9344854771784235	481
Q8C033	PF19057	604	753	1.0222200000000001	149	G5AYN1	601	750	2.289153333333333	149
Q8BHE1	PF15348	9	237	0.06181222707423579	228	G5AR50	44	272	0.4334912280701755	228
Q9JKK0	PF04847	56	224	2.6234852071005927	168	G5BHX0	57	225	2.559538461538462	168
P35831	PF00102	57	290	6.148713675213673	233	G5AJU8	27	260	6.121307692307688	233
Q60764	PF00097	346	399	1.3865740740740744	53	G5C219	326	379	0.5575	53
Q60764	PF14608	279	297	0.0	18	G5C219	259	277	0.0	18
Q60764	PF14608	434	455	0.0	21	G5C219	414	435	0.0	21
Q60764	PF15815	457	540	2.3476666666666666	83	G5C219	437	518	16.356243902439026	81
Q60764	PF18044	96	116	0.0	20	G5C219	100	120	0.0	20
O35655	PF00149	169	406	7.694042016806719	237	G5BDT4	203	438	7.812877118644067	235
O35655	PF08321	131	157	0.2846666666666667	26	G5BDT4	165	191	7.646333333333336	26
O35655	PF13499	569	635	12.89249253731343	66	G5BDT4	598	664	7.89610447761194	66
Q5IR70	PF15066	0	525	0.34936692015209136	525	G5BAT2	1	526	0.575429657794677	525
Q8CCB4	PF04100	39	451	3.7708062953995176	412	G5BVK7	66	478	3.6754503631961226	412
Q62191	PF00622	403	453	13.805078431372554	50	G5B9B8	363	413	10.437039215686276	50
Q62191	PF13765	292	322	8.411225806451613	30	G5B9B8	335	364	1.3975666666666664	29
Q62191	PF00097	19	57	0.0	38	G5B9B8	62	100	0.0	38
Q62191	PF00643	91	131	5.2134634146341465	40	G5B9B8	166	206	1.800219512195122	40
Q91WZ8	PF04440	175	309	0.06042962962962964	134	G5C849	176	310	0.012	134
O88543	PF01399	258	360	2.4537281553398063	102	G5C330	259	361	2.4537281553398063	102
Q8BLB8	PF12796	15	115	5.866752475247524	100	G5B3N7	92	192	5.8067425742574255	100
A2ARP1	PF00328	389	905	4.8263442940038725	516	G5BM51	356	872	4.795154738878146	516
A2ARP1	PF18086	54	143	11.756122222222226	89	G5BM51	55	144	11.005833333333333	89
Q8CDM8	PF10257	77	494	10.046755980861247	417	G5BKB0	135	550	9.959286057692307	415
P49766	PF00341	46	123	0.35397435897435897	77	G5B6Q8	47	124	0.16407692307692304	77
Q8CIB9	PF13878	370	408	0.3232820512820513	38	G5BY85	264	302	0.3264615384615385	38
Q8CIB9	PF13880	519	587	6.0550579710144925	68	G5BY85	419	487	6.742724637681159	68
Q9WV56	PF00688	58	233	2.3741590909090906	175	G5AZY9	52	232	2.0389613259668504	180
Q9WV56	PF00019	324	426	2.8103203883495147	102	G5AZY9	330	432	2.8430873786407767	102
Q9D742	PF15001	0	138	15.343769784172665	138	G5B4U9	1	138	15.61436231884058	137
Q8BL80	PF00169	43	149	1.4382242990654206	106	G5B0W3	27	134	5.718749999999997	107
Q8BL80	PF00620	178	325	0.9107432432432434	147	G5B0W3	179	325	0.9139115646258504	146
Q5BU09	PF10238	135	278	1.738597222222222	143	G5BG35	232	376	1.7121724137931034	144
P30999	PF00514	396	435	6.785124999999999	39	G5AMQ9	410	449	6.954175000000001	39
P30999	PF00514	439	480	0.8664761904761905	41	G5AMQ9	453	494	0.8645476190476192	41
P30999	PF00514	702	737	0.2428888888888889	35	G5AMQ9	710	745	0.2424166666666667	35
Q8VCZ9	PF01619	188	436	3.987072289156627	248	G5BXN9	191	439	3.66516064257028	248
P63328	PF00149	83	283	6.992039800995022	200	G5AP69	65	265	6.9894726368159175	200
Q61501	PF02319	123	186	0.21378125	63	G5BPU4	87	150	0.214265625	63
Q61501	PF16421	200	293	5.890446808510642	93	G5BPU4	164	280	4.081059829059829	116
A2CG63	PF01388	307	393	1.5821149425287353	86	G5AKC3	308	394	1.5852873563218393	86
A2CG63	PF08169	169	262	0.8877765957446805	93	G5AKC3	170	263	0.7188617021276601	93
A2CG63	PF11717	571	623	6.398490566037736	52	G5AKC3	570	622	11.573471698113213	52
O35484	PF00278	278	384	10.276766355140188	106	G5C0G8	549	652	12.503576923076913	103
O35484	PF02784	44	277	1.9719786324786317	233	G5C0G8	316	548	1.7570257510729608	232
P29268	PF00007	252	342	0.03291208791208791	90	G5C780	116	206	0.06367032967032965	90
P29268	PF00093	137	164	0.0	27	G5C780	1	28	0.0	27
P29268	PF00219	38	77	2.174925	39	G5C780	121	159	0.05251282051282052	38
P29268	PF19035	197	240	0.0	43	G5C780	61	104	0.0	43
P13412	PF00992	14	144	0.5629770992366413	130	G5C2F9	11	141	0.5571984732824428	130
Q8BVP6	PF00021	141	217	5.655441558441559	76	G5AZP9	142	218	7.633259740259747	76
Q9QZM2	PF03129	365	450	8.285011627906979	85	G5BVF3	386	471	7.531139534883722	85
O70481	PF02207	98	165	0.018382352941176468	67	G5BM39	45	112	0.01852941176470588	67
O70481	PF02617	221	299	8.056101265822786	78	G5BM39	168	246	8.057898734177218	78
O70481	PF18995	1304	1491	9.788792553191493	187	G5BM39	1218	1400	10.469617486338796	182
Q3UKZ7	PF14949	35	136	0.3324901960784313	101	G5BJS9	36	137	0.3896764705882353	101
Q8K2I1	PF00432	125	163	8.738564102564101	38	G5BD08	160	198	8.866512820512822	38
Q8K2I1	PF00432	171	212	3.2456428571428577	41	G5BD08	206	247	3.233571428571428	41
Q8K2I1	PF00432	224	261	20.89944736842105	37	G5BD08	259	296	20.946368421052632	37
Q8K2I1	PF00432	268	310	0.4681627906976745	42	G5BD08	303	345	6.351837209302326	42
Q8K2I1	PF00432	330	372	0.6373255813953486	42	G5BD08	365	407	0.4243255813953487	42
E9Q7D5	PF00621	1163	1339	0.4947175141242937	176	G5C2N9	1190	1366	0.5741751412429374	176
E9Q7D5	PF14604	1503	1549	2.9682340425531915	46	G5C2N9	1530	1576	2.963510638297872	46
E9Q7D5	PF15441	0	476	0.7781215932914047	476	G5C2N9	1	486	0.1210082304526749	485
Q9ERR8	PF00096	200	222	0.0	22	G5AUF9	202	224	0.0	22
Q9ERR8	PF00096	228	250	0.0	22	G5AUF9	230	252	0.0	22
Q9ERR8	PF00096	256	278	0.0	22	G5AUF9	258	280	0.0	22
Q9ERR8	PF00096	313	335	0.0	22	G5AUF9	315	337	0.0	22
Q9ERR8	PF00096	341	363	0.0	22	G5AUF9	343	365	0.0	22
Q9ERR8	PF00096	369	391	0.0	22	G5AUF9	371	393	0.0	22
Q9ERR8	PF00096	426	448	0.0	22	G5AUF9	428	450	0.0	22
Q9ERR8	PF13465	498	523	0.0	25	G5AUF9	500	525	0.0	25
Q8K368	PF14674	0	52	0.8532452830188685	52	G5CA91	1	53	0.7383584905660376	52
Q8K368	PF14675	63	279	14.680534562211983	216	G5CA91	64	280	11.881686635944698	216
Q8K368	PF14676	377	539	6.070515337423312	162	G5CA91	378	541	6.884463414634148	163
Q8K368	PF14677	804	1027	10.384348214285714	223	G5CA91	805	1028	7.589245535714285	223
Q8K368	PF14678	1041	1292	12.50490476190476	251	G5CA91	1042	1290	11.865791164658633	248
Q8K368	PF14679	283	369	8.64444827586207	86	G5CA91	284	370	10.406586206896556	86
Q8K368	PF14680	560	783	3.0921875	223	G5CA91	562	784	4.405448430493274	222
Q8CFW7	PF00168	1048	1209	2.380771604938272	161	G5BGC0	1125	1286	2.1011172839506176	161
Q8CFW7	PF15625	645	819	1.4068457142857145	174	G5BGC0	727	901	1.436148571428571	174
Q8CFW7	PF17661	136	382	0.7531578947368426	246	G5BGC0	221	469	0.7249839357429716	248
Q3UTQ7	PF00096	633	655	0.0	22	G5ALV8	634	656	0.0	22
Q3UTQ7	PF00096	662	684	0.049565217391304345	22	G5ALV8	663	685	0.03704347826086956	22
Q3UTQ7	PF12171	350	370	0.0	20	G5ALV8	352	372	0.0	20
Q3UTQ7	PF12874	550	569	0.07735	19	G5ALV8	551	570	0.05565	19
Q3UTQ7	PF16638	373	503	0.02970229007633588	130	G5ALV8	375	505	0.02970229007633588	130
Q61765	PF00038	54	365	0.6723205128205129	311	G5B0N4	55	366	0.07908653846153846	311
Q04692	PF00176	506	780	6.4770145454545425	274	G5BXP6	515	789	7.611901818181815	274
Q04692	PF00271	850	961	14.089678571428573	111	G5BXP6	859	970	13.984446428571427	111
P70314	PF00046	90	146	0.40998245614035095	56	G5BQ23	68	124	0.41157894736842093	56
P70314	PF03826	276	288	0.0	12	G5BQ23	273	284	0.06333333333333334	11
Q9EQ21	PF06446	31	82	0.7210384615384615	51	G5BXJ4	32	83	1.5484117647058822	51
P08043	PF00096	101	121	0.0	20	G5BCG7	201	221	0.0	20
P08043	PF00096	127	149	0.0	22	G5BCG7	227	249	0.0	22
P08043	PF00096	155	177	0.02934782608695652	22	G5BCG7	255	277	0.02978260869565217	22
P08043	PF00096	183	205	0.0	22	G5BCG7	283	305	0.0	22
P08043	PF00096	211	233	0.02956521739130435	22	G5BCG7	311	333	0.03	22
P08043	PF00096	239	261	0.04065217391304348	22	G5BCG7	339	361	0.041086956521739125	22
P08043	PF00096	267	289	0.0	22	G5BCG7	367	389	0.0	22
P08043	PF00096	295	317	0.17908695652173912	22	G5BCG7	395	417	0.18186956521739134	22
P08043	PF00096	323	345	0.0	22	G5BCG7	423	445	0.0	22
P08043	PF00096	351	373	0.0	22	G5BCG7	451	473	0.0	22
P08043	PF00096	379	401	0.34060869565217394	22	G5BCG7	479	501	0.3453478260869565	22
P08043	PF00096	407	429	0.07521739130434782	22	G5BCG7	507	529	0.07630434782608696	22
P08043	PF00096	435	457	0.0	22	G5BCG7	535	557	0.0	22
Q9Z2E1	PF01429	183	216	0.022411764705882357	33	G5B2E2	1	34	0.0	33
Q9Z2E1	PF14048	299	389	2.0137252747252745	90	G5B2E2	117	207	1.996076923076923	90
Q9Z2E1	PF16564	225	294	0.0	69	G5B2E2	43	112	0.0	69
Q99MD8	PF00096	303	323	0.0	20	G5AY00	303	323	0.0	20
Q99MD8	PF00096	329	351	0.0	22	G5AY00	329	351	0.0	22
Q99MD8	PF00096	386	408	0.0	22	G5AY00	386	408	0.0	22
Q99MD8	PF00096	414	436	0.0	22	G5AY00	414	436	0.0	22
Q99MD8	PF00096	442	464	0.620304347826087	22	G5AY00	442	464	0.620304347826087	22
Q99MD8	PF00096	470	492	0.0958695652173913	22	G5AY00	470	492	0.07669565217391304	22
Q99MD8	PF00651	13	114	3.1679313725490186	101	G5AY00	14	115	3.1556862745098027	101
Q99MD8	PF13912	498	521	0.0	23	G5AY00	498	521	0.0	23
Q60823	PF00069	153	408	1.7940781250000009	255	G5C9Y3	127	382	1.93855078125	255
Q60823	PF00169	27	105	2.69120253164557	78	G5C9Y3	1	79	2.6861898734177214	78
Q60823	PF00433	429	474	0.0	45	G5C9Y3	403	448	0.0	45
Q9ER42	PF00046	142	198	0.0	56	G5BIP2	87	143	0.0	56
Q8BWW9	PF00069	660	914	10.064537254901964	254	G5BGG0	580	813	5.6815128205128165	233
Q8BWW9	PF00433	936	977	0.0	41	G5BGG0	835	876	0.0	41
Q8BWW9	PF02185	50	107	0.05881034482758622	57	G5BGG0	51	108	0.16689655172413784	57
Q8BWW9	PF02185	136	198	0.14809523809523809	62	G5BGG0	137	199	0.1488095238095238	62
Q8BWW9	PF02185	217	279	0.4336825396825397	62	G5BGG0	218	280	0.13638095238095238	62
Q3UFT3	PF12736	31	311	2.151128113879004	280	G5C301	32	311	2.136564285714285	279
P15620	PF00096	77	99	0.4115652173913043	22	G5C293	68	90	0.6468695652173914	22
P15620	PF00096	103	125	0.6853043478260871	22	G5C293	95	117	0.6916521739130436	22
P15620	PF00096	131	153	0.0	22	G5C293	123	145	0.0	22
P15620	PF00096	159	181	0.0	22	G5C293	151	173	0.0	22
P15620	PF00096	187	209	0.0	22	G5C293	179	201	0.0	22
P15620	PF00096	215	237	0.0	22	G5C293	207	229	0.0	22
P15620	PF00096	243	265	0.0	22	G5C293	235	257	0.0	22
P15620	PF00096	271	293	0.0	22	G5C293	263	285	0.0	22
P15620	PF00096	299	321	6.8136086956521735	22	G5C293	291	313	6.851913043478262	22
P15620	PF00096	327	349	0.0	22	G5C293	319	341	0.0	22
P15620	PF00096	355	377	0.0	22	G5C293	347	369	0.0	22
P15620	PF00096	383	405	0.02717391304347826	22	G5C293	375	397	0.02739130434782609	22
P15620	PF00096	411	433	0.0	22	G5C293	123	145	0.0	22
P15620	PF00096	439	461	0.0	22	G5C293	431	453	0.0	22
P15620	PF00096	467	489	0.0	22	G5C293	459	481	0.0	22
P15620	PF00096	495	517	0.0	22	G5C293	487	509	0.0	22
P15620	PF00096	550	572	0.0	22	G5C293	543	565	0.0	22
Q9D4Q1	PF05914	3	308	0.1405392156862745	305	G5C7S3	72	377	0.7376491803278687	305
Q9CWH0	PF14047	210	276	2.6284477611940296	66	G5AUN6	216	282	2.0019104477611944	66
Q9CWH0	PF14049	123	205	0.4686987951807229	82	G5AUN6	129	211	0.05478313253012048	82
Q8CIN4	PF00069	248	499	3.0059642857142856	251	G5ALC8	249	500	2.8803174603174595	251
Q8CIN4	PF00786	72	129	2.0025172413793104	57	G5ALC8	73	130	2.0032068965517245	57
Q5DW34	PF00856	1134	1240	0.2805327102803739	106	G5BG04	1126	1232	0.3963084112149532	106
Q5DW34	PF05033	1011	1115	0.10598095238095237	104	G5BG04	1003	1107	0.01	104
Q5DW34	PF12796	830	900	2.335225352112676	70	G5BG04	822	892	2.3386197183098587	70
Q5DW34	PF12796	907	981	8.890039999999999	74	G5BG04	899	973	8.899306666666666	74
Q5DW34	PF13637	771	823	0.10499999999999997	52	G5BG04	763	815	0.10520754716981133	52
P11031	PF02229	63	114	0.12219230769230773	51	G5AKD5	86	137	0.1276153846153846	51
Q99LS1	PF10229	24	292	4.276657992565056	268	G5B7S8	22	290	4.1276059479553915	268
Q8BJI4	PF00046	607	662	1.5186428571428567	55	G5B6U1	538	593	1.5039107142857142	55
Q8BJI4	PF00157	479	523	0.0	44	G5B6U1	410	454	0.0	44
Q8BJI4	PF00157	558	585	0.0	27	G5B6U1	489	516	0.0	27
Q9Z0H4	PF00076	42	110	7.6745942028985485	68	G5BBE6	25	93	7.668623188405799	68
Q9Z0H4	PF00076	133	197	4.4864	64	G5BBE6	116	180	4.1296	64
Q9Z0H4	PF00076	424	493	2.5006714285714287	69	G5BBE6	413	482	1.9809142857142863	69
P35601	PF00004	631	758	1.9390000000000007	127	G5C3V0	951	1081	1.8959541984732833	130
P35601	PF00533	400	475	8.958026315789473	75	G5C3V0	703	778	9.699394736842107	75
P35601	PF08519	898	1051	1.0265844155844157	153	G5C3V0	1221	1374	5.610746753246754	153
A6X8Z5	PF00620	34	182	1.140241610738255	148	G5AUA8	35	182	1.0467905405405404	147
Q5DU02	PF00443	175	516	4.123605263157893	341	G5C335	141	482	4.1251432748538015	341
Q5DU02	PF02148	62	122	15.124049180327866	60	G5C335	28	88	14.823131147540984	60
Q9DAT5	PF03054	5	382	6.0477883597883615	377	G5BVB3	6	383	5.7374603174603145	377
Q9D818	PF11414	223	303	0.006382716049382716	80	G5BEJ3	42	121	0.0101625	79
Q8CAT8	PF12937	37	80	0.7076136363636364	43	G5B7W4	38	81	2.0689545454545457	43
Q3ZRW6	PF01093	33	461	2.944589743589741	428	G5BTS7	4	431	0.7554485981308409	427
Q7TN98	PF16366	652	714	1.4712857142857143	62	G5BGJ1	708	770	1.4677142857142855	62
Q7TN98	PF16367	471	559	7.589348314606738	88	G5BGJ1	527	615	6.919516853932589	88
Q8VHX2	PF00531	120	190	0.01563380281690141	70	G5APM4	107	177	0.0	70
Q9JJA2	PF04124	72	393	0.7559844720496899	321	G5AK46	1	322	1.040009316770186	321
Q9D5K4	PF15427	20	381	0.023964088397790056	361	G5B5K0	21	399	0.1262058047493403	378
Q91V57	PF00017	49	117	0.27223188405797105	68	G5C943	51	119	0.27236231884057976	68
Q91V57	PF00130	205	256	5.363038461538464	51	G5C943	207	258	5.374923076923077	51
Q91V57	PF00620	281	430	0.8858266666666669	149	G5C943	283	438	0.8527564102564102	155
P02469	PF00053	270	323	0.00962962962962963	53	G5C2C5	275	328	0.006555555555555555	53
P02469	PF00053	334	389	5.597035714285712	55	G5C2C5	339	394	2.7359642857142847	55
P02469	PF00053	397	454	1.0277241379310345	57	G5C2C5	402	459	0.04960344827586207	57
P02469	PF00053	457	506	0.0	49	G5C2C5	462	511	0.0	49
P02469	PF00053	509	547	0.6742307692307693	38	G5C2C5	514	552	1.0323589743589745	38
P02469	PF00053	772	817	0.0008478260869565218	45	G5C2C5	777	822	0.0	45
P02469	PF00053	820	864	0.0	44	G5C2C5	825	869	0.0	44
P02469	PF00053	866	913	0.11639583333333332	47	G5C2C5	871	918	0.11616666666666667	47
P02469	PF00053	916	972	0.1424561403508772	56	G5C2C5	921	977	0.14331578947368426	56
P02469	PF00053	975	1024	0.0	49	G5C2C5	980	1029	0.0	49
P02469	PF00053	1027	1080	0.22279629629629627	53	G5C2C5	1032	1085	0.334462962962963	53
P02469	PF00053	1083	1125	0.0	42	G5C2C5	1088	1130	0.0	42
P02469	PF00053	1131	1171	0.0	40	G5C2C5	1136	1176	0.0	40
P02469	PF00055	34	268	2.9254425531914894	234	G5C2C5	39	273	2.91180425531915	234
P68500	PF00041	671	758	1.031988636363636	87	G5BUD5	495	582	0.7951931818181815	87
P68500	PF00041	876	960	7.385094117647062	84	G5BUD5	700	784	10.357235294117645	84
P68500	PF00041	976	1055	1.5900625000000002	79	G5BUD5	800	879	1.966975	79
P68500	PF07679	97	180	0.3747142857142857	83	G5BUD5	212	289	0.5229358974358975	77
P68500	PF07679	305	384	0.2512	79	G5BUD5	129	208	0.16648749999999993	79
P68500	PF07679	388	473	0.7624651162790697	85	G5BUD5	212	297	0.5157209302325584	85
P68500	PF07679	483	566	1.1208095238095237	83	G5BUD5	307	390	1.8800357142857145	83
P68500	PF07679	572	665	6.983319148936173	93	G5BUD5	396	489	4.660361702127659	93
O88329	PF00063	9	680	6.074034226190477	671	G5BB59	10	681	7.232312499999996	671
O88329	PF00612	699	717	0.9671052631578948	18	G5BB59	700	718	0.7464736842105263	18
O88329	PF00612	743	763	33.33990476190476	20	G5BB59	744	764	19.984238095238094	20
O88329	PF06017	846	1040	1.4073435897435895	194	G5BB59	847	1043	2.5095837563451786	196
P16331	PF00351	118	442	2.9424923076923086	324	G5AMD7	281	604	3.142765432098764	323
P16331	PF01842	35	81	14.479042553191494	46	G5AMD7	36	82	7.968021276595738	46
Q8VDL9	PF00096	234	256	0.0	22	G5C0J1	236	258	0.0	22
Q8VDL9	PF00096	262	286	0.0	24	G5C0J1	264	288	0.0	24
Q8VDL9	PF00096	292	316	0.0	24	G5C0J1	294	318	0.0	24
P49117	PF00104	373	565	9.347300518134716	192	G5ANT1	394	586	9.561196891191706	192
P49117	PF00105	115	182	0.08339705882352941	67	G5ANT1	136	203	0.06770588235294117	67
Q62511	PF00096	373	395	0.0	22	G5AP47	310	332	0.0	22
Q62511	PF00096	435	454	0.0	19	G5AP47	340	359	0.0	19
Q10738	PF00413	102	258	5.087382165605097	156	G5BUB9	103	259	0.7798407643312103	156
Q10738	PF01471	31	81	0.026568627450980396	50	G5BUB9	32	82	0.9483137254901959	50
Q61701	PF00076	52	122	1.7895070422535215	70	G5C4G5	53	123	1.670704225352113	70
Q61701	PF00076	138	203	0.12368181818181817	65	G5C4G5	139	204	0.09796969696969697	65
Q61701	PF00076	303	372	9.2908	69	G5C4G5	304	373	7.944271428571423	69
Q6PNC0	PF00400	158	193	7.6681944444444445	35	G5C5M7	147	182	3.660638888888888	35
Q6PNC0	PF00400	2908	2941	0.26517647058823524	33	G5C5M7	2916	2949	5.132558823529412	33
Q6PNC0	PF12234	1110	1383	2.917496350364962	273	G5C5M7	1101	1374	2.631145985401459	273
Q6PNC0	PF12234	1452	1875	6.480495283018872	423	G5C5M7	1443	1864	7.042864928909958	421
Q9D0A3	PF10574	0	223	2.90021875	223	G5CAA2	1	224	2.770071428571429	223
Q9D023	PF03650	27	116	20.211511111111108	89	G5AQ53	28	116	20.982909090909097	88
O09102	PF03615	34	171	2.322130434782608	137	G5BN59	55	192	2.549188405797102	137
Q8BGV4	PF10521	216	389	7.566580459770115	173	G5B9U3	214	387	5.315580459770115	173
Q8K1L0	PF00170	225	282	1.800293103448276	57	G5C2A7	438	495	1.838879310344828	57
Q9R1E0	PF16675	419	500	0.0	81	G5B957	186	267	0.0	81
Q9R1E0	PF16676	591	629	0.0	38	G5B957	357	395	0.0	38
Q8CFZ4	PF01153	109	523	2.485587951807229	414	G5BJG3	1	414	2.804663438256658	413
Q5SUF2	PF03194	3	244	2.0598512396694213	241	G5C4K7	4	245	2.058863636363637	241
Q6NS86	PF00096	250	271	0.1597727272727273	21	G5B209	254	275	0.16081818181818178	21
Q6NS86	PF00096	305	327	0.0	22	G5B209	309	331	0.0	22
Q6NS86	PF00096	363	383	0.0	20	G5B209	367	387	0.0	20
Q6NS86	PF00096	389	411	0.0	22	G5B209	393	415	0.0	22
Q6NS86	PF00096	417	439	0.0	22	G5B209	421	443	0.0	22
Q6NS86	PF00096	445	467	5.676173913043478	22	G5B209	449	471	5.7046086956521735	22
Q6NS86	PF00096	473	495	0.0	22	G5B209	477	499	0.0	22
Q6NS86	PF00096	529	552	0.0	23	G5B209	533	556	0.0	23
Q6NS86	PF13912	501	521	0.0	20	G5B209	505	525	0.0	20
O08583	PF00076	106	174	0.19579710144927534	68	G5BJ79	60	128	0.16639130434782606	68
O08583	PF13865	224	249	0.0	25	G5BJ79	179	204	0.0	25
Q9D9R0	PF05605	140	196	0.0	56	G5C304	84	140	0.0	56
Q9D9R0	PF13923	55	75	0.05952380952380953	20	G5C304	1	20	0.03125	19
Q9D9R0	PF18574	94	126	0.43696969696969695	32	G5C304	39	71	0.24796969696969698	32
Q3UVV9	PF13768	142	296	10.57922580645162	154	G5BV86	135	289	7.646787096774196	154
Q3UVV9	PF13768	483	607	12.977783999999987	124	G5BV86	476	599	11.496362903225807	123
Q3UVV9	PF13768	922	1076	7.916658064516122	154	G5BV86	837	1010	5.242086206896554	173
Q3UJB9	PF16529	113	439	5.967067278287468	326	G5C677	114	440	5.970562691131502	326
Q6WKZ8	PF02207	98	165	0.16798529411764704	67	G5BNJ9	99	166	0.16867647058823532	67
Q6WKZ8	PF02617	222	299	7.693474358974358	77	G5BNJ9	223	300	7.707743589743589	77
Q6WKZ8	PF18995	1565	1729	2.6371939393939394	164	G5BNJ9	1441	1579	3.8255971223021583	138
Q99LJ7	PF00415	116	166	0.2734901960784313	50	G5BFH7	93	143	0.3202745098039216	50
Q99LJ7	PF00415	169	219	2.036509803921569	50	G5BFH7	146	196	7.431392156862742	50
Q99LJ7	PF00415	223	271	7.19889795918367	48	G5BFH7	200	248	8.095020408163265	48
Q99LJ7	PF00415	274	322	0.4890000000000002	48	G5BFH7	251	299	0.5120204081632654	48
Q99LJ7	PF00651	385	484	2.4909600000000007	99	G5BFH7	362	461	1.28578	99
P28649	PF00067	246	483	8.944172268907568	237	G5C8S5	54	290	9.649067510548527	236
O08808	PF06367	265	454	4.789410526315789	189	G5AQQ8	239	434	4.330795918367347	195
O08808	PF06371	76	258	5.629568306010932	182	G5AQQ8	50	232	5.619005464480873	182
O08808	PF02181	752	1127	1.644114361702128	375	G5AQQ8	733	1098	1.756672131147541	365
O08808	PF06345	1179	1193	0.0	14	G5AQQ8	1150	1164	0.0	14
O08808	PF06346	619	677	0.0	58	G5AQQ8	589	658	0.0	69
Q5EBP3	PF00651	744	839	0.0090625	95	G5BYB9	757	851	2.738368421052632	94
Q05A56	PF01630	40	372	5.817609609609609	332	G5BZQ1	41	373	3.721513513513514	332
Q9QZC7	PF00169	3	104	1.7180392156862745	101	G5B9X8	9	110	1.71443137254902	101
Q6PDN3	PF00041	1355	1437	0.6443253012048193	82	G5AV90	1350	1432	4.782891566265062	82
Q6PDN3	PF00069	1485	1740	5.682601562499999	255	G5AV90	1480	1735	5.805792968749998	255
Q6PDN3	PF07679	32	122	3.279912087912088	90	G5AV90	33	123	1.6251978021978022	90
Q6PDN3	PF07679	155	244	4.706922222222222	89	G5AV90	161	250	4.1959777777777765	89
Q6PDN3	PF07679	401	491	2.736087912087912	90	G5AV90	408	498	8.660296703296702	90
Q6PDN3	PF07679	501	587	1.66219540229885	86	G5AV90	508	594	5.716183908045975	86
Q6PDN3	PF07679	611	699	2.9013258426966293	88	G5AV90	617	705	0.6975056179775281	88
Q6PDN3	PF07679	709	796	8.957659090909091	87	G5AV90	715	802	8.90296590909091	87
Q6PDN3	PF07679	1119	1208	5.757744444444448	89	G5AV90	1114	1203	4.652388888888892	89
Q6PDN3	PF07679	1259	1348	4.536455555555556	89	G5AV90	1254	1343	3.981044444444444	89
Q6PDN3	PF07679	1830	1920	0.0606043956043956	90	G5AV90	1825	1915	0.08337362637362639	90
Q6PDN3	PF16620	245	399	0.020458064516129037	154	G5AV90	251	406	1.244948717948718	155
Q80TM9	PF00787	38	117	1.395925	79	G5BUM3	28	107	5.3534375	79
Q80TM9	PF12799	311	349	0.3932051282051282	38	G5BUM3	300	338	3.8519487179487166	38
Q8BWU5	PF00814	28	299	4.952536764705885	271	G5B5Q7	29	332	10.168453947368414	303
Q08AT1	PF00071	27	183	5.78164331210191	156	G5AN65	3	159	5.7881019108280265	156
Q8BVK9	PF01342	358	426	0.027942028985507253	68	G5ASW3	434	502	0.0	68
Q8BVK9	PF03172	8	104	10.10039175257732	96	G5ASW3	116	212	16.71117525773196	96
Q2TBA3	PF00656	350	543	14.103685567010308	193	G5AYY1	274	467	14.028592783505161	193
Q2TBA3	PF13895	239	315	4.619805194805194	76	G5AYY1	162	237	6.263934210526314	75
Q2TBA3	PF13927	133	199	1.7997462686567165	66	G5AYY1	59	125	5.430985074626866	66
Q2TBA3	PF18703	590	726	11.17870072992701	136	G5AYY1	514	650	11.179700729927003	136
Q8R480	PF07575	241	605	5.41091780821918	364	G5BNC1	255	591	3.491661721068249	336
Q9R060	PF10609	52	302	3.6001035856573718	250	G5BWF6	53	303	3.8797729083665353	250
Q9Z1R3	PF11032	0	188	10.441306878306877	188	G5C3E9	1	187	9.03741711229947	186
Q8K202	PF06870	50	473	4.295271226415093	423	G5C1D9	18	393	4.589095744680849	375
B9EHT4	PF01302	295	359	0.2307230769230769	64	G5BK14	296	360	0.2300923076923077	64
B9EHT4	PF01302	417	480	1.7622187499999995	63	G5BK14	418	481	1.7596249999999996	63
B9EHT4	PF12796	143	226	0.4474999999999998	83	G5BK14	144	227	0.4469285714285713	83
Q6P9L6	PF00225	31	362	8.681400602409646	331	G5B431	32	363	7.708948795180727	331
Q6P9L6	PF15908	1271	1383	0.1410619469026549	112	G5B431	1270	1375	0.023443396226415097	105
Q8R3P2	PF00097	408	468	11.098590163934428	60	G5AXA0	409	469	10.26122950819672	60
Q8R3P2	PF02825	19	96	3.9389102564102547	77	G5AXA0	20	97	1.6773846153846157	77
Q8R3P2	PF02825	111	173	0.511015873015873	62	G5AXA0	112	174	0.1307936507936508	62
Q8R3P2	PF18102	476	610	5.68628888888889	134	G5AXA0	477	611	5.751392592592592	134
Q5M8M2	PF07004	24	37	0.0	13	G5B2G2	39	51	0.0	12
Q5M8M2	PF07004	100	121	0.0	21	G5B2G2	126	147	0.0	21
Q5M8M2	PF07004	137	169	0.050303030303030315	32	G5B2G2	163	194	0.051875	31
Q5M8M2	PF07004	180	207	0.13799999999999998	27	G5B2G2	206	233	0.1385714285714286	27
Q8R0F9	PF00650	85	243	5.398427672955977	158	G5APU6	86	244	6.640050314465407	158
Q6SP97	PF13864	151	247	1.8499278350515465	96	G5AVY5	152	248	0.35816494845360825	96
O35887	PF13202	78	93	0.7703125	15	G5BH98	81	96	0.76875	15
O35887	PF13202	193	212	0.0	19	G5BH98	196	215	0.0	19
O35887	PF13833	266	290	0.0	24	G5BH98	269	293	0.0	24
Q8VBW5	PF00505	80	147	6.8390588235294105	67	G5AQE0	81	148	6.853691176470589	67
Q8VBW5	PF09667	189	308	1.3289833333333336	119	G5AQE0	191	310	1.5221500000000003	119
Q80XP9	PF00069	150	403	2.1109330708661407	253	G5BAB5	152	405	2.108397637795276	253
Q80XP9	PF12202	424	486	0.013587301587301587	62	G5BAB5	426	488	0.011888888888888888	62
Q8BWQ5	PF00069	514	770	4.996856031128403	256	G5BZ13	356	612	5.892054474708169	256
Q91W50	PF00313	26	88	2.8740952380952383	62	G5ATE9	73	135	2.873428571428571	62
Q91W50	PF00313	185	245	5.505229508196722	60	G5ATE9	201	261	5.5094754098360665	60
Q91W50	PF00313	350	410	2.0654754098360666	60	G5ATE9	366	426	1.943934426229508	60
Q91W50	PF00313	520	580	3.004032786885245	60	G5ATE9	536	596	2.7529836065573754	60
Q91W50	PF00313	674	736	2.808396825396825	62	G5ATE9	690	752	2.8104444444444434	62
Q91W50	PF12901	755	786	0.0	31	G5ATE9	771	802	0.0	31
Q9D1M0	PF00400	10	40	0.07438709677419356	30	G5BX70	11	41	0.0879032258064516	30
Q9D1M0	PF00400	50	86	2.247918918918918	36	G5BX70	51	87	2.244945945945947	36
Q9D1M0	PF00400	93	129	3.232729729729729	36	G5BX70	94	130	3.618648648648649	36
Q9D1M0	PF00400	203	242	9.103	39	G5BX70	204	243	11.416600000000004	39
Q9D1M0	PF00400	258	289	10.704937500000002	31	G5BX70	259	290	10.6855625	31
A2A825	PF00071	56	199	10.5609375	143	G5BRU6	56	199	10.88125	143
Q9QWT9	PF00225	510	661	6.4118421052631565	151	G5BK18	187	337	6.429715231788082	150
P55194	PF00620	291	437	8.994625850340135	146	G5AYX5	295	441	4.893435374149659	146
P55194	PF03114	1	251	0.2003466135458168	250	G5AYX5	2	255	0.19822047244094487	253
Q3V124	PF08743	281	371	9.74557142857143	90	G5AR45	245	333	8.563865168539326	88
Q3V124	PF15412	131	176	23.11582608695652	45	G5AR45	99	143	23.03240000000001	44
P51569	PF16499	38	321	4.176204225352111	283	G5C2S8	39	322	1.78455985915493	283
P51569	PF17450	324	410	4.419712643678159	86	G5C2S8	325	411	12.059977011494254	86
P55104	PF00019	246	350	1.9258285714285712	104	G5BED7	247	351	1.9658380952380956	104
P54822	PF00206	98	307	2.021352380952381	209	G5AYW4	99	308	2.018652380952381	209
P54822	PF10397	377	459	5.744469879518074	82	G5AYW4	378	460	5.7012409638554225	82
Q99LC8	PF01008	17	292	7.513481884057972	275	G5AWT7	18	298	6.210889679715304	280
Q8BGY2	PF01287	82	149	1.838205882352941	67	G5BT60	83	150	1.838205882352941	67
Q8R1Z4	PF12799	71	105	5.1051142857142855	34	G5AQN2	72	106	6.8982	34
Q8R1Z4	PF14580	145	248	0.11447115384615385	103	G5AQN2	146	248	2.886242718446601	102
P62878	PF12678	39	97	1.0305762711864408	58	G5BVC3	40	98	1.0321694915254236	58
Q8BHI9	PF00069	73	324	5.8418214285714285	251	G5BCR7	74	325	6.3356666666666674	251
Q8VHI3	PF10250	44	398	1.4063154929577466	354	G5BMG2	191	580	3.875597435897435	389
P59280	PF00651	68	169	8.57507843137255	101	G5BSV5	59	160	6.8950588235294115	101
P59280	PF01344	326	361	10.670777777777776	35	G5BSV5	317	352	10.376416666666664	35
P59280	PF01344	363	408	3.541195652173913	45	G5BSV5	354	399	3.591239130434781	45
P59280	PF01344	411	455	0.5089333333333333	44	G5BSV5	355	399	3.6710444444444432	44
P59280	PF01344	458	501	3.635431818181819	43	G5BSV5	355	398	3.754477272727272	43
P59280	PF01344	504	543	6.4582000000000015	39	G5BSV5	354	392	4.235820512820512	38
P59280	PF01344	552	590	2.139820512820512	38	G5BSV5	355	392	4.347289473684209	37
P59280	PF07707	177	278	4.31356862745098	101	G5BSV5	168	269	4.5320294117647055	101
Q6NS57	PF00400	84	120	2.2040810810810827	36	G5BM19	84	119	2.7694444444444435	35
Q6NS57	PF00400	126	163	18.69878947368421	37	G5BM19	126	163	20.400052631578948	37
Q6NS57	PF00400	178	203	8.273807692307694	25	G5BM19	178	203	8.445153846153849	25
Q6NS57	PF00400	343	366	5.774791666666667	23	G5BM19	349	372	5.500208333333332	23
Q6NS57	PF00400	386	421	0.5948888888888892	35	G5BM19	392	427	0.4538333333333333	35
Q6NS57	PF00400	687	724	13.718921052631574	37	G5BM19	693	730	13.724736842105264	37
P48774	PF00043	106	193	3.3342386363636365	87	G5BQX5	102	189	10.740363636363632	87
P48774	PF02798	5	84	2.720575	79	G5BQX5	1	80	2.725487499999999	79
Q9JI91	PF00307	38	141	12.383249999999995	103	G5APM7	39	142	12.432730769230766	103
Q9JI91	PF00307	151	256	11.415943396226414	105	G5APM7	152	257	11.43645283018868	105
Q9JI91	PF00435	281	389	0.029935779816513762	108	G5APM7	282	390	0.029935779816513762	108
Q9JI91	PF00435	400	504	0.0640952380952381	104	G5APM7	401	505	0.0640952380952381	104
Q9JI91	PF00435	516	626	0.2363153153153153	110	G5APM7	517	627	0.033243243243243244	110
Q9JI91	PF00435	637	738	4.706823529411765	101	G5APM7	638	739	4.706823529411765	101
Q9JI91	PF08726	823	889	1.8141940298507464	66	G5APM7	824	890	1.8141940298507464	66
P35283	PF00071	74	203	4.891723076923074	129	G5C057	1	130	9.228007692307688	129
Q9CWH6	PF00227	27	212	10.772430107526882	185	G5BJS1	28	213	10.16333870967742	185
Q9CWH6	PF10584	4	26	11.910391304347828	22	G5BJS1	5	27	11.787304347826085	22
Q5U4C1	PF04826	1112	1305	10.388623711340207	193	G5B0C2	1149	1341	7.813367875647667	192
Q60969	PF00782	35	171	8.86394890510949	136	G5BD33	12	148	11.441547445255482	136
Q8BWR2	PF06201	41	174	2.562097014925373	133	G5BHY3	1	134	2.5697238805970164	133
B2RWS6	PF00439	1066	1141	7.546828947368419	75	G5BVC4	1069	1144	7.565855263157895	75
B2RWS6	PF00569	1663	1703	0.9953902439024388	40	G5BVC4	1666	1706	0.9996097560975606	40
B2RWS6	PF02135	338	414	5.860701298701298	76	G5BVC4	339	415	5.862116883116884	76
B2RWS6	PF02135	1733	1804	0.7879444444444442	71	G5BVC4	1736	1807	0.7953888888888891	71
B2RWS6	PF02172	567	646	0.8100499999999998	79	G5BVC4	568	647	0.8134124999999999	79
B2RWS6	PF06001	1154	1193	0.0963	39	G5BVC4	1157	1196	0.096725	39
B2RWS6	PF08214	1304	1604	4.082043189368768	300	G5BVC4	1307	1606	4.100556666666665	299
B2RWS6	PF09030	1992	2098	4.212336448598132	106	G5BVC4	1995	2101	4.2181775700934585	106
O88904	PF00069	189	517	0.6038905775075986	328	G5ATD8	210	547	0.6190295857988164	337
Q99KG7	PF19031	14	120	10.152691588785046	106	G5BGM3	10	116	13.806140186915885	106
Q99KG7	PF19033	561	660	0.28331	99	G5BGM3	552	651	0.5334399999999999	99
P00520	PF07714	241	491	8.038362549800794	250	G5AT60	242	492	8.388920318725102	250
P00520	PF00018	66	112	7.087255319148937	46	G5AT60	67	113	5.2413617021276595	46
P00520	PF00017	126	201	0.22417105263157885	75	G5AT60	127	202	0.22407894736842096	75
P00520	PF08919	1019	1122	8.763442307692307	103	G5AT60	991	1094	8.847563106796116	103
Q2TBE6	PF00454	132	428	6.463090909090912	296	G5C0B7	75	371	6.453356902356902	296
Q80VY2	PF15342	120	177	0.0	57	G5BNX4	101	157	0.0	56
Q571E4	PF00884	37	351	4.0045682539682526	314	G5C2T7	1	314	4.774668789808915	313
Q571E4	PF14707	377	505	1.5192170542635663	128	G5C2T7	340	468	4.015356589147287	128
P70166	PF16366	500	557	0.1273448275862069	57	G5B1R4	496	553	0.0	57
P70166	PF16367	308	408	6.158435643564353	100	G5B1R4	304	404	6.1597425742574226	100
P70166	PF16368	5	305	0.3397574750830565	300	G5B1R4	1	301	0.16857807308970096	300
Q6RT24	PF00225	203	326	1.9730403225806443	123	G5BXB1	111	237	2.1791574803149616	126
O88531	PF02089	144	288	7.6851517241379295	144	G5BZ59	42	186	4.50378620689655	144
Q8C0Q4	PF00069	29	287	9.291841698841695	258	G5AM69	29	287	10.010393822393825	258
Q6GQT9	PF13620	321	379	3.1767796610169503	58	G5AK15	276	333	2.2526206896551724	57
Q6GQT9	PF17802	865	918	3.8542962962962983	53	G5AK15	820	873	4.23862962962963	53
P11404	PF00061	5	131	2.3268425196850395	126	G5BF59	6	132	2.708409448818897	126
Q3UHL1	PF00069	33	285	7.136086956521745	252	G5BZX7	34	293	6.9449153846153875	259
Q8BL99	PF04118	10	294	8.28463859649123	284	G5BZN9	11	295	8.179670175438591	284
Q8CC70	PF14926	13	258	6.599158536585361	245	G5BUB4	14	256	6.816497942386827	242
Q3UVL4	PF08700	63	145	1.056289156626506	82	G5B6L9	63	145	0.4738795180722892	82
Q3TY65	PF04629	306	392	0.41868965517241374	86	G5C1S3	325	411	0.6874022988505747	86
Q3TY65	PF04629	393	430	2.4184210526315786	37	G5C1S3	438	475	2.498189189189189	37
Q3TY65	PF06456	14	241	2.0388771929824565	227	G5C1S3	15	242	1.2536973684210524	227
Q8BKN6	PF00685	139	378	3.250495833333333	239	G5BRA4	26	264	3.5256066945606714	238
Q99JV5	PF01852	39	221	0.5881256830601094	182	G5C628	24	205	1.5440386740331495	181
P51865	PF09443	98	132	0.0	34	G5ANP7	130	165	0.0	35
Q62232	PF00046	129	179	0.0	50	G5C9U0	130	180	0.0	50
Q62232	PF16878	8	118	0.6580630630630631	110	G5C9U0	9	119	0.6568288288288288	110
Q9CSP9	PF13414	315	353	0.036333333333333336	38	G5BKA3	317	355	0.03094871794871795	38
Q8K2F0	PF00439	44	124	1.8867777777777777	80	G5B8I4	5	85	2.090913580246914	80
Q8K2F0	PF00439	313	400	0.3780454545454546	87	G5B8I4	274	361	0.3770227272727272	87
Q8K2F0	PF17035	571	635	0.12169230769230767	64	G5B8I4	568	632	0.12130769230769232	64
Q9ERI2	PF00071	10	181	6.781023255813942	171	G5B2P7	11	182	6.718738372093027	171
Q9JJ57	PF13499	135	208	1.1379594594594595	73	G5B471	112	185	1.1285540540540544	73
Q9JJ57	PF13833	76	125	10.18868	49	G5B471	53	102	12.074160000000001	49
Q9D4K7	PF03148	138	463	0.21199079754601216	325	G5BYQ8	50	431	0.4251125654450262	381
Q08093	PF00307	29	130	6.744372549019607	101	G5C5Y3	30	131	6.7608235294117645	101
Q08093	PF00402	165	189	0.2276	24	G5C5Y3	166	190	0.15868	24
Q08093	PF00402	205	229	0.0	24	G5C5Y3	206	230	0.0	24
Q08093	PF00402	244	267	0.04083333333333333	23	G5C5Y3	245	268	0.040625	23
P04351	PF00715	65	164	0.8453599999999999	99	G5C793	50	149	2.8811099999999987	99
Q921G8	PF04130	508	867	2.2917027777777794	359	G5AVB2	509	825	2.6196214511041003	316
Q921G8	PF17681	217	505	8.475785467128016	288	G5AVB2	218	506	8.486695501730097	288
Q9CZD0	PF16690	19	233	3.3193906976744176	214	G5ARW2	20	234	3.3494976744186062	214
Q8BFR6	PF01428	9	45	0.09405405405405404	36	G5BAK2	10	46	0.3079729729729729	36
Q8BFR6	PF01428	63	101	8.788512820512821	38	G5BAK2	64	102	7.188256410256409	38
Q3V3E1	PF00300	410	574	5.851739393939393	164	G5B2T4	561	725	3.815381818181818	164
Q3V3E1	PF00627	27	56	0.0	29	G5B2T4	89	118	0.04866666666666666	29
Q3V3E1	PF14604	244	298	0.20870909090909096	54	G5B2T4	394	448	0.16892727272727273	54
B2RPU2	PF00169	30	133	12.179749999999995	103	G5BQM8	31	134	12.01220192307692	103
Q9QXC1	PF00031	37	124	10.978727272727273	87	G5BT88	37	124	6.388920454545456	87
Q9QXC1	PF00031	156	236	0.43675308641975297	80	G5BT88	156	239	0.5010238095238095	83
P97819	PF01734	481	664	8.80813043478261	183	G5AYS6	481	664	8.808722826086955	183
P97819	PF12796	171	247	1.3792467532467532	76	G5AYS6	172	248	1.4643636363636363	76
P97819	PF12796	295	377	13.439120481927713	82	G5AYS6	296	378	12.023120481927707	82
P36993	PF00481	22	287	3.1632894736842103	265	G5BI63	23	288	3.304680451127819	265
P36993	PF07830	288	366	7.5771518987341775	78	G5BI63	289	367	7.336949367088606	78
P24807	PF14984	26	74	7.22342857142857	48	G5BMN9	27	77	16.956156862745097	50
Q3U435	PF00045	374	417	0.3392045454545455	43	G5B1I9	340	383	0.06727272727272728	43
Q3U435	PF00045	423	464	7.928785714285714	41	G5B1I9	389	430	6.648190476190474	41
Q3U435	PF00045	469	512	0.2615909090909091	43	G5B1I9	435	478	0.0	43
Q3U435	PF00045	519	559	0.0	40	G5B1I9	485	525	0.0	40
Q3U435	PF00413	169	333	8.375715151515152	164	G5B1I9	135	299	3.0330727272727267	164
Q3U435	PF01471	87	139	0.08432075471698114	52	G5B1I9	52	104	0.9874528301886792	52
Q9CZQ9	PF07289	6	338	7.307399399399402	332	G5C8Q6	7	339	8.280780780780784	332
Q9WTK2	PF00378	356	493	12.672028985507248	137	G5C8X1	446	582	12.677569343065695	136
Q9WTK2	PF00385	56	106	0.0	50	G5C8X1	146	196	0.012941176470588235	50
Q8BWY4	PF00753	81	133	4.790698113207547	52	G5AN19	81	133	7.969018867924527	52
Q7TNC4	PF03194	20	243	0.019906250000000004	223	G5B558	1	224	0.01999553571428572	223
P48614	PF00110	50	388	1.720262536873157	338	G5AU36	51	389	1.699328402366864	338
Q64131	PF00853	94	183	13.111955555555555	89	G5BHW7	112	201	12.723177777777776	89
Q64131	PF08504	314	408	0.12161052631578945	94	G5BHW7	331	429	0.22402040816326532	98
O35900	PF01423	5	70	2.5496212121212114	65	G5C3G4	5	70	0.8052575757575758	65
Q8BHL6	PF12826	165	215	0.036470588235294116	50	G5BXH6	208	257	2.4126122448979594	49
Q8BHL6	PF17949	11	134	8.341540322580649	123	G5BXH6	54	177	9.798653225806452	123
Q8K0C9	PF16363	26	329	3.9964046052631588	303	G5BKF5	41	382	6.387394736842108	341
Q9WVG5	PF00151	45	343	2.5718093645484945	298	G5AX31	46	344	2.261190635451505	298
Q9WVG5	PF01477	348	480	6.019481203007518	132	G5AX31	349	481	6.4984887218045095	132
P27870	PF00018	616	651	0.0	35	G5C0N9	703	738	0.0	35
P27870	PF00018	787	833	0.16391489361702127	46	G5C0N9	874	920	0.16595744680851066	46
P27870	PF00621	218	370	3.31816339869281	152	G5C0N9	305	457	2.884169934640523	152
P27870	PF00017	670	744	1.819453333333335	74	G5C0N9	757	831	2.456586666666667	74
P27870	PF00130	515	564	0.0	49	G5C0N9	602	651	0.0	49
P27870	PF00169	404	502	7.607333333333334	98	G5C0N9	491	589	7.582272727272727	98
P27870	PF11971	18	68	1.3861764705882351	50	G5C0N9	19	68	1.4002200000000002	49
Q8C551	PF15696	292	330	0.0	38	G5AS01	228	266	0.0	38
Q9JJ80	PF04427	39	226	2.3017553191489344	187	G5ARK5	40	227	3.12909574468085	187
Q8C0E3	PF00643	181	220	0.0	39	G5BNA0	178	217	0.0	39
Q8C0E3	PF13765	433	475	4.830930232558139	42	G5BNA0	431	473	1.9138372093023253	42
Q8C0E3	PF15227	8	56	0.5817755102040816	48	G5BNA0	9	57	0.5833877551020408	48
A6H687	PF03399	179	373	7.801389743589746	194	G5B6M6	1	195	9.350399999999997	194
Q9DAI2	PF08477	4	122	8.184697478991598	118	G5AXB6	5	123	8.062773109243697	118
Q8R0J8	PF01202	12	138	6.420094488188977	126	G5BP05	13	186	2.414028735632184	173
P03995	PF00038	65	372	0.3117532467532467	307	G5BJ09	69	376	0.3087337662337661	307
P03995	PF04732	7	62	0.01294642857142857	55	G5BJ09	8	66	0.34	58
A3KGF7	PF00168	688	777	2.9290888888888884	89	G5BLY4	687	776	0.6564444444444446	89
A3KGF7	PF00387	546	659	2.1276491228070173	113	G5BLY4	533	646	2.159201754385964	113
A3KGF7	PF00388	313	463	0.9483907284768212	150	G5BLY4	303	453	0.9510397350993376	150
A3KGF7	PF08703	974	1148	0.2618	174	G5BLY4	972	1141	0.2619411764705883	169
A3KGF7	PF09279	213	302	6.55668888888889	89	G5BLY4	203	292	5.3082666666666665	89
A3KGF7	PF17787	12	140	8.838310077519381	128	G5BLY4	13	137	7.216088	124
Q68FG3	PF08243	595	661	0.0	66	G5AK99	591	656	0.0	65
Q60629	PF00041	307	389	5.361253012048193	82	G5C8U2	119	201	5.146506024096387	82
Q60629	PF00536	805	865	0.4707540983606557	60	G5C8U2	617	677	0.9934918032786886	60
Q60629	PF07714	514	770	5.232400778210119	256	G5C8U2	326	582	5.23258365758755	256
Q60629	PF14575	412	510	16.95891919191919	98	G5C8U2	224	322	16.529676767676772	98
Q8BHN5	PF00076	34	91	0.2258275862068965	57	G5C708	10	66	0.21392982456140347	56
Q8BHN5	PF00076	126	182	0.3634035087719298	56	G5C708	102	158	0.30319298245614035	56
Q8BHN5	PF00076	258	312	9.035690909090908	54	G5C708	232	286	9.030818181818182	54
Q8BHN5	PF00076	404	456	4.932509433962261	52	G5C708	378	430	4.920301886792451	52
Q8R550	PF14604	5	52	0.2936458333333333	47	G5BQ96	6	53	0.29635416666666664	47
Q8R550	PF14604	105	152	0.3762708333333333	47	G5BQ96	106	153	0.280125	47
Q8R550	PF14604	317	367	8.814705882352941	50	G5BQ96	274	324	8.812196078431372	50
Q58FA4	PF02319	113	181	0.3705507246376811	68	G5AR20	50	118	0.3696956521739129	68
Q58FA4	PF02319	261	346	11.677069767441866	85	G5AR20	198	283	11.670813953488366	85
Q8VCY6	PF08640	8	90	0.26721686746987955	82	G5B507	9	91	0.2659638554216867	82
P20067	PF00010	60	98	0.0	38	G5C6K4	64	102	0.0	38
Q7TPM6	PF00041	172	257	4.49706976744186	85	G5BZA6	171	256	5.971499999999998	85
Q7TPM6	PF00622	355	470	3.725362068965516	115	G5BZA6	354	469	3.818836206896552	115
P48787	PF00992	46	177	0.030484848484848486	131	G5BW07	43	174	1.4689166666666669	131
P48787	PF11636	4	31	0.0	27	G5BW07	1	28	0.0	27
P22387	PF00322	48	76	3.4024137931034484	28	G5BN52	49	77	3.4229655172413795	28
Q8CII0	PF00096	358	381	0.0	23	G5B5M1	363	386	0.0	23
Q8CII0	PF00651	13	120	1.3046111111111105	107	G5B5M1	14	121	1.9922777777777776	107
Q8CII0	PF13909	330	354	0.0	24	G5B5M1	335	359	0.0	24
Q8C2Q3	PF00076	2	59	1.1898448275862066	57	G5BWZ1	3	60	1.0949999999999998	57
Q8C2Q3	PF00076	80	141	0.7498870967741934	61	G5BWZ1	81	142	0.5179677419354838	61
P63038	PF00118	135	547	3.427401937046005	412	G5B2V7	2	384	5.010618798955616	382
Q8C0F9	PF00089	137	195	0.1561016949152542	58	G5B8B6	138	195	0.2437241379310345	57
Q99PT3	PF04438	323	354	0.0	31	G5AXF7	292	323	0.0	31
Q99PT3	PF04795	227	306	0.0	79	G5AXF7	198	275	0.0	77
Q3UKU4	PF07894	156	289	11.090126865671639	133	G5AYW1	12	145	11.308514925373135	133
Q91X45	PF00096	445	468	0.0	23	G5AYJ0	444	467	0.0	23
Q91X45	PF00651	13	120	5.154166666666669	107	G5AYJ0	14	121	5.086305555555559	107
P29699	PF00031	153	234	2.172256097560976	81	G5BT89	154	234	0.3768888888888888	80
Q08122	PF00400	481	512	12.441531249999995	31	G5C6T5	358	389	12.487968750000006	31
Q08122	PF00400	609	645	0.0	36	G5C6T5	486	522	0.0	36
Q08122	PF03920	56	132	3.6326233766233766	76	G5C6T5	1	77	3.6591038961038933	76
Q9JLZ3	PF00378	62	312	1.8762509960159368	250	G5C2H3	1	251	2.221800796812748	250
Q9CZ62	PF14580	106	255	5.388320000000001	149	G5C021	106	255	5.873686666666668	149
Q9CZ28	PF04157	5	224	1.4783499999999996	219	G5C4N2	6	225	1.4750590909090906	219
Q8VDU1	PF00071	68	202	8.810555555555554	134	G5BM04	46	180	9.688444444444439	134
Q9CWQ8	PF13840	71	136	8.963090909090912	65	G5APV4	72	138	8.798343283582089	66
Q9CWQ8	PF13840	257	319	3.9332698412698415	62	G5APV4	259	321	3.928365079365079	62
Q9CWQ8	PF18700	8	68	3.6715081967213097	60	G5APV4	9	69	3.6492131147540983	60
Q9QZN3	PF01369	138	310	7.506300578034682	172	G5B404	139	311	7.2697341040462415	172
Q9QZN3	PF12937	73	111	12.561794871794865	38	G5B404	74	112	12.561794871794865	38
Q9Z2D3	PF04598	0	245	2.52180487804878	245	G5BCX8	1	246	3.6814308943089435	245
Q9Z2D3	PF17708	279	465	10.389358288770056	186	G5BCX8	280	465	16.645424731182796	185
Q3UZA1	PF05177	234	315	0.0	81	G5AQ50	230	300	0.0	70
Q3UZA1	PF15255	80	166	0.0	86	G5AQ50	81	166	0.06693023255813953	85
Q9DBL2	PF01661	90	184	3.240652631578948	94	G5B2R6	1	95	2.9195894736842103	94
Q9DBL2	PF13716	349	481	21.24622556390976	132	G5B2R6	259	391	21.24736842105263	132
Q8K2W9	PF15394	1	537	1.6809646182495352	536	G5ASJ9	2	547	1.6070678899082564	545
Q8VEE4	PF01336	205	288	0.7643571428571427	83	G5BCU8	131	214	1.5456666666666667	83
Q8VEE4	PF08646	469	614	7.648301369863018	145	G5BCU8	395	504	7.839327272727274	109
Q8VEE4	PF16900	313	410	6.145132653061224	97	G5BCU8	239	336	5.428102040816324	97
Q8BGV9	PF03416	109	409	5.156139534883722	300	G5BUH2	242	542	4.808697674418604	300
Q7TPW1	PF07679	513	601	1.5359999999999998	88	G5AXK7	573	661	1.385426966292135	88
Q8R332	PF15967	2	586	1.1554615384615383	584	G5AMY1	3	504	1.4187465069860279	501
Q61602	PF00096	512	539	13.298071428571427	27	G5B6V0	362	389	13.263035714285715	27
Q61602	PF00096	545	569	0.0	24	G5B6V0	395	419	0.0	24
Q61602	PF00096	575	600	0.0	25	G5B6V0	425	450	0.0	25
Q61602	PF00096	606	631	0.0	25	G5B6V0	456	481	0.0	25
P11214	PF00008	82	114	0.16424242424242427	32	G5BT55	83	115	0.9050303030303032	32
P11214	PF00039	37	74	0.0	37	G5BT55	38	75	0.0	37
P11214	PF00051	123	204	1.9367073170731708	81	G5BT55	124	205	2.0027560975609755	81
P11214	PF00051	212	293	0.5162926829268291	81	G5BT55	213	294	0.04469512195121951	81
P11214	PF00089	308	552	5.764722448979591	244	G5BT55	309	554	8.78422764227642	245
Q8BX94	PF01237	86	473	3.726706185567013	387	G5BDW8	50	407	4.424206703910613	357
Q8BP48	PF00557	136	364	0.2610655021834059	228	G5AYP8	99	327	0.258755458515284	228
Q8BP48	PF15801	38	53	0.0	15	G5AYP8	1	16	0.0	15
Q80SY5	PF03371	48	229	4.75163736263736	181	G5BQU6	50	231	4.7516923076923065	181
Q9CRC3	PF02594	35	104	6.646528571428571	69	G5BF06	74	143	2.6539714285714275	69
P70266	PF00300	253	435	5.01514207650273	182	G5B5P9	156	338	5.01935519125683	182
P70266	PF01591	98	250	2.9850065359477123	152	G5B5P9	1	153	4.0913006535947725	152
Q64008	PF00071	53	212	12.572500000000005	159	G5BVI2	90	275	10.226494623655912	185
Q99J87	PF00271	351	474	7.7924838709677395	123	G5B0K8	352	475	5.924782258064513	123
Q99J87	PF04851	0	169	7.171700000000005	169	G5B0K8	1	170	10.317717647058828	169
Q99J87	PF11648	551	665	7.429104347826081	114	G5B0K8	552	666	4.536217391304348	114
Q99J87	PF18119	215	341	0.1010551181102362	126	G5B0K8	216	342	4.960968503937009	126
Q9JIL2	PF00048	28	85	5.491879310344826	57	G5BCR5	8	64	5.5559122807017545	56
Q63943	PF00319	9	56	11.94683333333333	47	G5AR89	10	57	11.942208333333333	47
Q63943	PF12347	116	153	0.0	37	G5AR89	55	108	0.1054074074074074	53
Q4KUS1	PF00014	126	177	0.3644423076923077	51	G5B7N5	86	137	2.093884615384616	51
Q4KUS1	PF00095	78	121	0.0	43	G5B7N5	38	81	0.0	43
Q4KUS1	PF00095	181	222	0.0	41	G5B7N5	141	182	0.01404761904761905	41
Q4KUS1	PF00095	228	270	0.0	42	G5B7N5	188	230	0.0	42
P47806	PF00096	270	297	13.895821428571427	27	G5BED5	198	225	13.778107142857142	27
P47806	PF00096	303	327	0.0	24	G5BED5	231	255	0.0	24
P47806	PF00096	364	389	0.0	25	G5BED5	292	317	0.0	25
Q0VE29	PF07647	74	140	0.3462537313432835	66	G5AT79	12	78	0.2706567164179106	66
Q9Z0K7	PF00021	24	99	1.4250394736842105	75	G5C8X7	21	96	1.4399342105263158	75
Q6P1G0	PF13251	514	544	22.52632258064517	30	G5B248	2	31	21.591700000000003	29
P97384	PF00191	201	266	2.85659090909091	65	G5BRK3	185	250	2.439939393939394	65
P97384	PF00191	273	338	0.6002878787878788	65	G5BRK3	257	317	0.6655245901639344	60
P97384	PF00191	357	421	7.7812769230769225	64	G5BRK3	336	400	7.906446153846155	64
P97384	PF00191	432	496	0.010523076923076923	64	G5BRK3	411	474	3.937625	63
O35347	PF07324	2	194	2.3136528497409325	192	G5CA33	3	198	2.280642857142857	195
Q9DBN9	PF00270	226	392	2.8969999999999985	166	G5B3B1	227	393	3.552131736526944	166
Q9DBN9	PF00271	428	539	11.712169642857145	111	G5B3B1	429	540	14.696071428571429	111
Q9DBN9	PF04438	105	131	4.773666666666667	26	G5B3B1	106	132	7.377518518518517	26
P70362	PF03152	18	193	0.5728295454545455	175	G5CA13	19	183	0.6123393939393939	164
Q810J8	PF01363	593	655	0.0	62	G5BP39	594	656	0.0	62
Q810J8	PF01363	710	772	0.018476190476190483	62	G5BP39	710	772	0.013809523809523808	62
P20263	PF00046	223	279	1.0439122807017542	56	G5C3D5	232	288	1.0372105263157896	56
P20263	PF00157	135	204	9.82244285714286	69	G5C3D5	143	212	4.4587571428571415	69
Q7TNF8	PF07653	1620	1681	7.9307741935483875	61	G5BJT7	1616	1677	6.338903225806451	61
Q7TNF8	PF07653	1759	1817	8.296135593220338	58	G5BJT7	1755	1813	7.227881355932201	58
Q7TNF8	PF14604	670	711	8.108666666666666	41	G5BJT7	664	705	8.252904761904762	41
Q8CI04	PF04136	122	268	0.4925986394557821	146	G5C905	131	277	0.8369523809523808	146
Q8R349	PF13424	446	509	0.7087656250000001	63	G5AVU5	387	450	0.710921875	63
Q924H7	PF00397	132	159	0.0	27	G5BI25	119	146	0.0	27
Q91ZR2	PF00787	296	369	2.230256756756757	73	G5C6Y2	104	177	2.2399864864864862	73
Q91ZR2	PF10456	375	611	3.026586497890296	236	G5C6Y2	183	419	3.033426160337553	236
P97823	PF02230	23	213	3.1317539267015757	190	G5B612	1	190	2.9767195767195767	189
Q64726	PF00129	22	195	7.167954022988508	173	G5AN09	31	204	5.5180977011494265	173
Q64726	PF07654	214	280	2.4586865671641798	66	G5AN09	223	289	2.706029850746269	66
Q8QZV4	PF00069	93	345	6.308940711462448	252	G5BFB5	6	258	6.315173913043483	252
Q9R0E2	PF03171	640	726	12.75855172413793	86	G5C502	677	763	11.677160919540231	86
Q8CGW9	PF00751	37	83	4.622276595744681	46	G5AZQ0	38	84	4.609936170212765	46
Q8CGW9	PF15791	242	368	1.262818897637796	126	G5AZQ0	245	371	1.1575196850393707	126
Q9DB07	PF12317	59	269	3.2180236966824647	210	G5BHM1	50	260	3.341535545023697	210
P12961	PF05281	62	154	0.008602150537634409	92	G5BWE3	63	155	0.008602150537634409	92
Q8VBV3	PF14382	25	62	3.6118947368421055	37	G5AT62	26	63	3.6118947368421055	37
Q8VBV3	PF15985	168	207	11.10405	39	G5AT62	169	208	11.048325	39
Q8BLR7	PF00071	14	182	2.5005325443786988	168	G5AU40	15	183	2.4999230769230776	168
Q99PI5	PF04571	0	106	4.9168878504672895	106	G5CAX8	1	107	4.914532710280372	106
Q99PI5	PF08235	633	858	3.910849557522125	225	G5CAX8	610	836	4.364643171806168	226
Q99PI5	PF16876	465	557	2.0141827956989244	92	G5CAX8	442	534	2.008817204301076	92
Q7TSG1	PF00168	10	113	9.315836538461538	103	G5C983	11	114	7.640019230769233	103
Q7TSG1	PF00168	531	563	3.766848484848485	32	G5C983	530	562	2.06151515151515	32
Q7TSG1	PF12416	117	339	11.55116591928251	222	G5C983	118	340	11.147264573991043	222
Q9CQV3	PF00079	6	387	7.042869109947642	381	G5BH05	7	386	7.626063324538263	379
O54782	PF01074	28	350	5.130758513931889	322	G5B322	27	349	4.205687306501551	322
O54782	PF07748	596	806	3.30098104265403	210	G5B322	576	788	0.9803145539906104	212
O54782	PF09261	356	451	1.1477708333333332	95	G5B322	355	450	0.6296041666666664	95
O54782	PF17677	903	1012	1.348009090909091	109	G5B322	892	1001	0.10054545454545454	109
Q99K28	PF01412	11	116	8.686849056603771	105	G5BPC0	12	117	8.648613207547164	105
Q8BI79	PF08647	829	927	0.04196969696969696	98	G5AKP1	594	692	0.02287878787878788	98
Q9D3G5	PF00804	40	237	4.160060606060607	197	G5BL64	41	238	3.4177979797979794	197
Q7TNB8	PF13871	725	1003	3.8985949820788552	278	G5C5Y9	1046	1324	4.1954874551971315	278
Q7TNB8	PF13872	208	499	4.701852739726027	291	G5C5Y9	447	738	5.25389041095891	291
Q9D3D9	PF02823	37	118	2.8040000000000007	81	G5AZL3	38	119	2.8123780487804866	81
Q8BND3	PF12894	120	195	7.2465131578947375	75	G5AZA7	114	189	7.422065789473687	75
Q8BW88	PF00169	25	119	1.4212631578947366	94	G5BKD8	59	152	3.2523191489361705	93
Q3UGM2	PF00069	518	778	4.941770114942528	260	G5BNZ9	520	780	6.912819923371644	260
Q8VCN5	PF01053	17	393	4.1006286472148545	376	G5C4T8	19	431	4.685600484261501	412
Q8BK72	PF10037	23	411	4.851262210796915	388	G5B211	1	397	8.837136020151126	396
P05132	PF00069	44	297	7.825484251968503	253	G5BYT3	37	290	7.012216535433072	253
P28741	PF00225	19	344	5.753776073619635	325	G5ASQ1	18	343	5.7460889570552185	325
Q80YR2	PF10257	78	476	5.898862155388472	398	G5B9P5	152	549	8.973736180904528	397
P70290	PF00018	164	219	4.962857142857144	55	G5C0D2	119	174	4.951678571428571	55
P70290	PF00595	71	147	0.044870129870129866	76	G5C0D2	26	102	0.04461038961038962	76
P70290	PF00625	280	451	4.157575581395348	171	G5C0D2	235	406	4.163988372093024	171
P37804	PF00307	24	134	1.5973063063063058	110	G5BHJ9	25	135	1.5432252252252243	110
P37804	PF00402	174	198	0.0	24	G5BHJ9	175	199	0.0	24
Q91Z46	PF00581	61	182	5.068122950819672	121	G5AXN1	42	163	5.092532786885246	121
Q91Z46	PF00782	254	385	6.0711818181818185	131	G5AXN1	235	366	6.044818181818182	131
Q8VDF2	PF02182	421	587	1.262035928143712	166	G5C0R2	419	586	1.108494047619048	167
Q8VDF2	PF00240	2	74	2.4395342465753425	72	G5C0R2	3	75	2.4477671232876714	72
Q8VDF2	PF00628	322	369	1.059875	47	G5C0R2	319	367	0.02277551020408164	48
Q8VDF2	PF12148	128	279	0.5807500000000004	151	G5C0R2	133	284	1.249730263157896	151
Q9QZ11	PF00752	0	86	3.4319425287356315	86	G5BL24	1	86	4.672348837209301	85
Q9QZ11	PF00867	139	224	3.2251395348837204	85	G5BL24	140	225	3.1645581395348823	85
Q3UHE1	PF02862	389	592	4.961671568627453	203	G5BW88	302	505	4.951053921568628	203
P57722	PF00013	46	107	6.181032258064518	61	G5ATA6	90	151	6.208983870967745	61
P57722	PF00013	130	193	1.939984375	63	G5ATA6	174	237	3.314375	63
P57722	PF00013	294	357	4.165062500000001	63	G5ATA6	351	414	4.1503125	63
Q6IME9	PF00038	132	445	0.9757515923566876	313	G5ALS6	171	484	0.340732484076433	313
Q6IME9	PF16208	63	129	5.006149253731344	66	G5ALS6	66	132	4.905194029850746	66
P45591	PF00241	26	145	8.683916666666667	119	G5B110	27	146	8.6838	119
P53351	PF00069	80	330	7.46511155378486	250	G5C024	81	331	7.473609561752987	250
P53351	PF00659	507	567	8.998131147540983	60	G5C024	508	568	9.602131147540984	60
P53351	PF00659	603	672	6.940057142857148	69	G5C024	604	673	7.089300000000002	69
Q69Z36	PF00013	193	253	7.517196721311477	60	G5BEZ6	97	157	7.50839344262295	60
Q69Z36	PF13920	547	594	1.6388125	47	G5BEZ6	449	496	1.6273958333333332	47
Q61187	PF05743	21	140	13.230325	119	G5AKA1	22	141	17.58016666666667	119
Q61187	PF09454	316	379	1.9010937499999996	63	G5AKA1	317	380	1.8991093749999992	63
Q8CIM1	PF13516	84	105	0.0	21	G5BJ90	85	106	0.21690909090909088	21
Q8CIM1	PF13516	142	164	0.6171304347826088	22	G5BJ90	143	165	0.18769565217391304	22
Q8CIM1	PF13516	170	191	0.0	21	G5BJ90	171	196	1.3197692307692306	25
Q9D071	PF12460	527	962	7.062240825688077	435	G5C0C2	514	949	8.803559633027518	435
Q9D071	PF14500	50	311	6.93199236641221	261	G5C0C2	38	299	6.601251908396941	261
Q9ERC3	PF06031	33	67	0.0	34	G5C9X7	36	71	0.0	35
Q5XG71	PF07539	910	1531	5.663771704180068	621	G5BBI8	910	1560	6.6614807987711275	650
Q3V1N1	PF08477	406	536	10.524366412213745	130	G5AV60	392	522	10.563435114503813	130
Q3V1N1	PF13855	83	142	0.9771166666666669	59	G5AV60	69	128	0.4797833333333334	59
Q3V1N1	PF13855	178	231	1.0142592592592594	53	G5AV60	164	217	1.4081296296296295	53
Q3V1N1	PF13855	246	303	0.0	57	G5AV60	232	289	0.0	57
Q3U1D0	PF14694	210	557	8.442367816091943	347	G5ARY8	194	542	10.901171919770766	348
Q3U1D0	PF14695	723	758	0.0	35	G5ARY8	714	749	0.016222222222222218	35
Q9CXD9	PF13855	107	164	2.408965517241379	57	G5BI55	107	164	2.5417586206896554	57
Q9CXD9	PF13855	294	351	15.76406896551724	57	G5BI55	294	351	12.43493103448276	57
Q02614	PF07818	118	211	0.674212765957447	93	G5BNA7	119	212	0.674212765957447	93
Q8C181	PF00642	16	39	0.06879166666666668	23	G5B178	17	40	0.04283333333333333	23
Q8C181	PF00642	177	201	0.0	24	G5B178	178	202	0.0	24
Q8C181	PF14608	52	70	4.3945263157894745	18	G5B178	53	71	2.2078421052631576	18
Q8C181	PF14608	217	235	0.17642105263157895	18	G5B178	218	236	0.09889473684210524	18
Q9CQZ6	PF08122	47	102	19.76905357142857	55	G5BDR3	45	105	16.116163934426226	60
Q8R4L0	PF00017	92	174	0.9574939759036142	82	G5B833	94	176	3.6733132530120485	82
Q91X79	PF00089	26	258	0.9572746781115884	232	G5ATY5	19	251	2.1652188841201707	232
P32883	PF00071	4	163	8.036706250000002	159	G5BQA1	5	164	8.011831250000002	159
Q9R0U0	PF00076	16	80	1.7782923076923076	64	G5BTZ6	17	80	1.798515625	63
A9Z1V5	PF13757	9	77	5.633811594202897	68	G5C4W4	15	83	6.4518985507246365	68
A9Z1V5	PF13768	352	505	11.289019480519473	153	G5C4W4	366	518	11.27028758169934	152
Q9Z2F2	PF00240	436	502	9.820970149253734	66	G5AWY1	436	502	5.390656716417911	66
Q9Z2F2	PF10421	169	350	6.2862692307692365	181	G5AWY1	170	350	8.643806629834254	180
P51855	PF03199	204	301	11.2859693877551	97	G5C6I7	223	320	10.159602040816328	97
P51855	PF03917	11	203	1.82940414507772	192	G5C6I7	12	222	2.4126824644549765	210
Q3UIW5	PF13639	223	265	24.04202325581395	42	G5AWW8	195	237	24.04606976744185	42
Q66JY6	PF00621	26	193	6.466267857142858	167	G5BL01	256	440	4.623832432432431	184
P22339	PF01248	21	119	9.855323232323233	98	G5BZC2	22	120	9.02129292929293	98
Q8CDU6	PF00632	464	773	8.18451612903226	309	G5BV03	350	659	8.873799352750806	309
Q99JX4	PF01399	236	334	10.357464646464644	98	G5C8K6	224	322	10.357272727272726	98
Q99JX4	PF18005	339	366	0.016928571428571428	27	G5C8K6	327	354	0.033857142857142856	27
Q9CR37	PF15060	0	109	4.259963636363636	109	G5C8D2	1	109	4.5410733944954105	108
Q64374	PF08450	15	262	6.159899193548388	247	G5AZF6	16	263	7.0077862903225805	247
Q91V80	PF15148	51	249	4.9537135678391975	198	G5BB73	50	246	4.535116751269034	196
Q8CG79	PF12796	935	1015	5.228851851851854	80	G5C192	879	959	6.078481481481483	80
Q8CG79	PF14604	1063	1111	6.021795918367349	48	G5C192	1007	1055	4.024938775510205	48
Q8C3S2	PF10363	840	934	10.157884210526316	94	G5C699	653	747	7.816136842105262	94
O70354	PF00194	33	299	8.362292134831463	266	G5B893	26	292	8.349048689138575	266
P57746	PF01813	16	206	2.9500157068062838	190	G5C7Y3	17	207	2.947748691099477	190
Q9ESN2	PF00622	361	467	3.2424859813084113	106	G5C3B1	396	502	3.2373738317757	106
Q9ESN2	PF00643	102	142	7.863829268292683	40	G5C3B1	103	143	7.9759024390243916	40
Q9ESN2	PF13765	308	357	0.057179999999999995	49	G5C3B1	343	392	0.04928000000000001	49
Q9ESN2	PF15227	28	68	0.0	40	G5C3B1	29	69	0.0	40
Q9QXV8	PF05210	182	293	0.7708839285714284	111	G5B9S4	183	294	0.7708839285714284	111
Q3UQI9	PF13898	402	729	9.516600609756098	327	G5C3J6	422	760	8.001745562130175	338
Q8K221	PF06456	96	315	5.3781363636363615	219	G5BBQ8	97	316	5.37757727272727	219
Q9D7G4	PF06937	0	281	0.5435460992907803	281	G5BAA2	134	421	0.5206631944444445	287
Q8BW70	PF00443	444	945	5.0998127490039815	501	G5BRR3	445	943	5.503857715430863	498
Q9ER10	PF00089	49	284	6.3677076271186435	235	G5AQC4	50	286	7.338713080168778	236
Q60875	PF00621	239	429	2.641591623036649	190	G5ARA7	220	410	2.9704921465968583	190
Q60875	PF17838	463	570	11.012805555555556	107	G5ARA7	444	551	10.5289537037037	107
Q9WTZ0	PF02996	28	145	9.857228813559326	117	G5B0C7	41	158	8.801728813559325	117
Q6ZPY7	PF02373	1399	1504	3.380311320754717	105	G5BA44	1533	1638	3.3946886792452813	105
Q9D9M5	PF06888	3	238	5.03372033898305	235	G5C8Q1	4	239	8.392207627118644	235
P51661	PF00106	83	276	7.173783505154638	193	G5C661	31	224	11.573680412371134	193
Q9D9S3	PF05773	10	130	5.187132231404959	120	G5BZP1	11	131	5.909876033057853	120
Q9D9S3	PF06544	159	225	0.6259552238805971	66	G5BZP1	160	226	0.6014925373134329	66
Q80TD3	PF14636	41	162	0.4004098360655737	121	G5AXX9	69	182	0.7496842105263162	113
Q80TD3	PF14637	293	526	15.067512820512812	233	G5AXX9	313	546	14.558675213675206	233
Q80TD3	PF14638	920	1102	3.3938142076502724	182	G5AXX9	944	1126	2.951191256830601	182
Q8BH59	PF00153	327	419	2.27089247311828	92	G5ANG4	328	420	2.257172043010753	92
Q8BH59	PF00153	423	510	2.066386363636364	87	G5ANG4	424	511	1.5261477272727275	87
Q8BH59	PF00153	519	605	13.923034482758622	86	G5ANG4	520	606	14.573701149425288	86
Q5UAK0	PF00249	285	329	15.401155555555553	44	G5BSP9	353	397	15.402733333333332	44
Q5UAK0	PF01448	180	230	10.482196078431373	50	G5BSP9	248	298	10.38329411764706	50
Q9D281	PF05334	134	299	2.2570783132530114	165	G5C3V4	133	297	0.1988	164
Q3ULA2	PF00400	303	328	0.4742307692307692	25	G5CAF6	154	179	0.4746153846153848	25
Q3ULA2	PF00400	333	368	1.9738055555555565	35	G5CAF6	184	219	2.0636666666666663	35
Q3ULA2	PF00400	418	450	3.641090909090909	32	G5CAF6	269	300	3.7598125	31
Q3ULA2	PF00400	457	491	0.2355714285714286	34	G5CAF6	314	348	0.23571428571428574	34
Q3ULA2	PF00400	495	531	0.5115405405405405	36	G5CAF6	352	388	2.439837837837838	36
Q3ULA2	PF00400	546	580	1.2818571428571428	34	G5CAF6	403	437	1.2814285714285714	34
Q3ULA2	PF12937	190	227	0.36126315789473695	37	G5CAF6	41	78	0.37581578947368416	37
P70425	PF00071	21	144	6.276766129032259	123	G5AQ19	22	144	5.983368852459017	122
Q9JLR5	PF00010	80	126	18.697936170212763	46	G5BYZ6	82	128	18.75340425531915	46
Q4ZJM7	PF00386	348	471	7.418943548387093	123	G5C1U2	331	454	9.525620967741935	123
Q4ZJM7	PF01391	117	174	0.0	57	G5C1U2	100	157	0.0	57
Q4ZJM7	PF01391	243	297	0.0	54	G5C1U2	226	280	0.0	54
Q4ZJM7	PF01391	282	340	0.0	58	G5C1U2	265	323	0.0	58
P48453	PF00149	92	292	7.2350597014925375	200	G5C7G8	48	248	7.23647263681592	200
Q9CXU1	PF05669	15	107	4.813311827956988	92	G5B909	16	108	4.813311827956988	92
Q3U8K7	PF00856	250	308	0.5166610169491526	58	G5BTV4	250	308	0.4357288135593221	58
O88951	PF02828	13	65	0.031981132075471694	52	G5BAF6	9	61	0.03188679245283019	52
O88951	PF00595	93	171	0.0	78	G5BAF6	89	167	0.0	78
P48755	PF00170	102	161	0.0	59	G5BWV6	172	231	0.0	59
P62267	PF00164	29	141	4.846849557522126	112	G5AT27	30	142	4.846849557522126	112
Q5DTJ9	PF07679	266	353	0.11701136363636365	87	G5B7Z1	261	348	0.11667045454545458	87
Q5DTJ9	PF07679	431	528	1.837316326530612	97	G5B7Z1	427	524	1.8334489795918365	97
Q5DTJ9	PF07679	940	1031	0.22096739130434784	91	G5B7Z1	940	1031	0.22032608695652173	91
Q5DTJ9	PF07679	1067	1157	1.497384615384615	90	G5B7Z1	1068	1158	1.7417582417582418	90
Q5DTJ9	PF07679	1166	1257	5.665989130434784	91	G5B7Z1	1167	1258	5.667489130434781	91
Q8BP40	PF00328	41	182	1.4585704225352107	141	G5BBL5	49	190	1.3457464788732385	141
Q8BP40	PF00328	299	370	16.226166666666668	71	G5BBL5	308	379	17.14672222222222	71
Q9CR46	PF16740	1	102	1.4087745098039206	101	G5AXY6	2	102	0.731148514851485	100
Q3U1C6	PF01026	30	223	3.4051907216494817	193	G5C7N3	1	193	6.80275129533679	192
Q9DC61	PF00675	75	224	4.592986666666664	149	G5B6B2	169	318	5.133546666666667	149
Q9DC61	PF05193	230	429	2.64378	199	G5B6B2	324	523	2.2716849999999997	199
Q8BJG4	PF03637	34	206	7.57749132947977	172	G5BYH2	35	207	6.6483872832369935	172
Q0VBV7	PF15352	99	1060	0.5049646569646565	961	G5BUB3	105	1081	0.6076223132036844	976
Q8BY71	PF10394	22	183	9.228185185185179	161	G5ANG3	20	180	9.737757763975157	160
Q8CIZ8	PF00092	1276	1446	9.251321637426901	170	G5CAN6	1278	1434	8.85112738853503	156
Q8CIZ8	PF00092	1497	1643	7.483401360544216	146	G5CAN6	1485	1630	10.84816438356164	145
Q8CIZ8	PF00092	1690	1857	8.209625000000003	167	G5CAN6	1678	1844	8.246347305389216	166
Q8CIZ8	PF00093	2430	2493	1.1519374999999998	63	G5CAN6	2418	2481	7.196781249999999	63
Q8CIZ8	PF00093	2593	2643	0.01647058823529412	50	G5CAN6	2584	2634	2.9488823529411765	50
Q8CIZ8	PF00094	34	178	0.7367034482758618	144	G5CAN6	35	179	4.9536965517241365	144
Q8CIZ8	PF00094	387	539	2.8672941176470585	152	G5CAN6	388	540	2.3301176470588234	152
Q8CIZ8	PF00094	869	1010	17.519366197183096	141	G5CAN6	871	1012	6.319352112676058	141
Q8CIZ8	PF00094	1949	2101	2.46367320261438	152	G5CAN6	1937	2089	0.8884052287581707	152
Q8CIZ8	PF01826	294	347	0.0	53	G5CAN6	295	348	0.0	53
Q8CIZ8	PF01826	651	706	0.020625	55	G5CAN6	652	707	0.02089285714285714	55
Q8CIZ8	PF01826	786	826	0.0	40	G5CAN6	788	828	0.0	40
Q8CIZ8	PF01826	1144	1195	0.0	51	G5CAN6	1146	1197	0.0	51
Q8CIZ8	PF08742	223	290	2.7360882352941176	67	G5CAN6	224	291	1.0712058823529411	67
Q8CIZ8	PF08742	583	647	0.015415384615384616	64	G5CAN6	584	648	0.15030769230769234	64
Q8CIZ8	PF08742	1059	1125	0.16258208955223888	66	G5CAN6	1061	1127	0.12382089552238808	66
Q8CIZ8	PF08742	2137	2198	1.0202419354838712	61	G5CAN6	2125	2186	11.719161290322578	61
Q8CIZ8	PF16164	1197	1275	1.9777088607594933	78	G5CAN6	1199	1277	1.3047848101265824	78
Q9D823	PF01907	1	53	0.0	52	G5B842	2	54	0.0	52
P30276	PF00134	136	260	12.005247999999998	124	G5AQ67	129	253	12.149959999999998	124
P30276	PF02984	263	325	0.7495079365079367	62	G5AQ67	256	317	0.7229344262295081	61
Q9JM98	PF00400	225	248	1.5501250000000002	23	G5CBI7	256	279	2.2532916666666667	23
Q8CEZ0	PF02214	84	161	2.3668717948717948	77	G5BND1	86	163	2.6167948717948715	77
Q8CDT7	PF14769	0	90	8.697593406593407	90	G5C359	1	91	10.47089010989011	90
Q9D275	PF00170	28	83	0.0	55	G5BSH7	77	132	0.11467857142857145	55
Q9Z1S8	PF00169	40	117	6.029564102564103	77	G5AW62	1	78	6.185217948717949	77
Q8CDZ2	PF10294	53	215	12.652509202453995	162	G5B9M1	63	225	10.133214723926372	162
Q3UP87	PF00089	28	241	3.183359813084113	213	G5C5X4	30	243	1.4879158878504684	213
Q7TN33	PF00076	87	114	4.547535714285714	27	G5BHB3	1	28	4.403964285714286	27
Q7TN33	PF00076	135	198	0.43503125	63	G5BHB3	49	112	0.37128125	63
Q7TN33	PF00076	376	445	5.044228571428572	69	G5BHB3	310	379	4.866500000000001	69
F8VQB6	PF00063	64	726	5.098334841628959	662	G5B0X8	48	717	4.626543283582087	669
F8VQB6	PF00169	1217	1311	1.6770842105263155	94	G5B0X8	1092	1186	1.6741789473684208	94
F8VQB6	PF00169	1399	1498	4.43641	99	G5B0X8	1274	1373	4.3455299999999975	99
F8VQB6	PF00373	1799	1840	4.687238095238096	41	G5B0X8	1674	1714	5.329073170731707	40
F8VQB6	PF00612	743	762	2.7806	19	G5B0X8	734	753	1.4082500000000002	19
F8VQB6	PF00612	793	808	0.9502500000000002	15	G5B0X8	784	799	0.0193125	15
F8VQB6	PF00784	1591	1696	7.852330188679245	105	G5B0X8	1466	1571	5.096396226415095	105
F8VQB6	PF18597	39	57	0.40242105263157896	18	G5B0X8	23	41	0.037894736842105266	18
Q8BTI9	PF00454	793	1009	11.790585253456225	216	G5AQ99	800	1016	11.464672811059911	216
Q8BTI9	PF00613	525	701	7.797372881355937	176	G5AQ99	532	708	7.734723163841804	176
Q8BTI9	PF00792	343	458	10.31343103448276	115	G5AQ99	350	465	10.311750000000002	115
Q8BTI9	PF00794	175	280	4.509500000000001	105	G5AQ99	182	286	8.632371428571433	104
Q8BTI9	PF02192	35	110	1.5350000000000004	75	G5AQ99	42	117	1.4651973684210529	75
Q6ZPS2	PF15632	597	695	8.312070707070706	98	G5BSA8	729	827	8.176242424242425	98
Q6ZPS2	PF18130	410	490	9.940629629629628	80	G5BSA8	542	622	7.942185185185188	80
Q9CZA6	PF04880	133	306	0.2909770114942529	173	G5AK09	134	308	0.2794057142857143	174
Q9EPA7	PF01467	11	229	3.844342465753424	218	G5C533	12	230	1.3403881278538816	218
Q8CC21	PF13374	308	337	16.6428	29	G5BEV0	319	348	16.1114	29
Q8CC21	PF13424	236	300	2.584230769230769	64	G5BEV0	247	311	2.5929538461538466	64
P62077	PF02953	15	74	0.6104333333333333	59	G5CAZ5	16	75	1.4964500000000005	59
Q9JJX7	PF03372	127	358	4.721922413793104	231	G5BJY5	112	345	3.8585982905982914	233
P70315	PF00568	37	145	11.920376146788984	108	G5BJH7	36	144	10.921348623853214	108
P70315	PF00786	238	295	0.05322413793103448	57	G5BJH7	219	276	0.0533448275862069	57
P70315	PF02205	450	468	0.0	18	G5BJH7	408	426	0.0	18
Q9CR26	PF04652	15	157	15.534216783216785	142	G5ANT4	16	158	15.535139860139866	142
Q9CR26	PF18097	267	304	0.030789473684210526	37	G5ANT4	266	303	0.040947368421052635	37
Q9DB96	PF04000	17	97	6.368728395061728	80	G5ASM0	44	124	6.3	80
Q3TTP0	PF13229	469	583	2.450791304347826	114	G5B453	321	438	3.14037288135593	117
Q8VDG7	PF03403	1	377	8.122649867373998	376	G5AUQ1	2	380	6.096957783641156	378
F6ZDS4	PF07926	1112	1239	0.0	127	G5C6C2	1038	1165	0.0	127
Q99N94	PF01281	91	135	1.4701555555555554	44	G5B8L2	83	127	2.506733333333333	44
Q8C4M7	PF13097	139	311	3.20893063583815	172	G5BGG5	128	302	1.660005714285714	174
Q8CHW4	PF00132	360	385	1.3665769230769231	25	G5BTE3	370	395	0.10615384615384614	25
Q8CHW4	PF02020	637	707	10.743704225352118	70	G5BTE3	647	716	11.985185714285715	69
Q8CI03	PF04500	91	149	0.0	58	G5B1K0	115	173	3.5101694915254247	58
Q8CI03	PF04500	234	292	1.319508474576271	58	G5B1K0	259	317	5.081813559322033	58
Q8CI03	PF04500	401	459	5.3758813559322025	58	G5B1K0	407	465	6.046372881355933	58
Q8CI03	PF04500	489	547	6.030508474576273	58	G5B1K0	529	587	6.063779661016947	58
Q8CI03	PF04500	580	638	5.807389830508474	58	G5B1K0	620	678	5.8290000000000015	58
Q8CI03	PF15423	0	36	0.0	36	G5B1K0	1	31	0.0	30
Q8CI03	PF16662	293	360	0.0	67	G5B1K0	318	377	0.0	59
Q8CI03	PF16662	460	475	0.0	15	G5B1K0	466	481	0.0	15
Q8CI03	PF16662	548	561	0.0	13	G5B1K0	588	601	0.0	13
Q8CI03	PF16662	639	655	0.0	16	G5B1K0	588	604	0.0	16
Q8BMD2	PF13815	42	162	0.5977107438016528	120	G5B163	16	136	0.6052892561983474	120
Q61411	PF00071	4	163	8.003462500000001	159	G5C480	5	164	7.97891875	159
Q6UL01	PF02493	14	35	0.0	21	G5CA67	15	36	0.0	21
Q6UL01	PF02493	37	57	0.0	20	G5CA67	38	58	0.0	20
P56473	PF05039	34	120	0.2820114942528736	86	G5C663	35	119	0.2928	84
Q9CQ02	PF07258	128	197	1.7060285714285712	69	G5AL74	129	198	2.0588285714285712	69
Q3SXC5	PF00025	6	173	5.847178571428571	167	G5C817	7	172	8.441307228915665	165
P07309	PF00576	33	137	3.002828571428571	104	G5C307	34	138	5.777761904761901	104
Q9QXW4	PF06268	24	136	3.9440265486725683	112	G5BHA7	25	137	3.2220707964601787	112
Q9QXW4	PF06268	272	377	4.913264150943398	105	G5BHA7	273	391	1.6961932773109236	118
Q920P3	PF01823	93	158	1.29839393939394	65	G5ATG9	94	159	1.3011666666666664	65
Q920P3	PF19052	305	759	3.034907692307692	454	G5ATG9	306	761	3.4158637362637347	455
Q80XL1	PF02262	39	143	7.694666666666665	104	G5CBN1	2	104	3.2500582524271846	102
Q80XL1	PF02761	147	230	0.2633214285714286	83	G5CBN1	108	191	0.273797619047619	83
Q80XL1	PF02762	232	317	4.159290697674417	85	G5CBN1	193	278	6.91006976744186	85
Q80XL1	PF14447	349	394	0.2110652173913044	45	G5CBN1	310	355	0.17706521739130435	45
Q91Y47	PF00024	23	85	17.215063492063493	62	G5BNV1	143	203	10.013409836065572	60
Q91Y47	PF00024	114	192	2.713607594936709	78	G5BNV1	54	132	2.109367088607595	78
Q91Y47	PF00024	202	282	7.805111111111111	80	G5BNV1	142	222	7.540962962962962	80
Q91Y47	PF00024	295	374	0.1098	79	G5BNV1	235	312	0.04605128205128205	77
Q91Y47	PF00089	389	616	4.725135964912281	227	G5BNV1	327	557	5.773307359307362	230
Q91XT4	PF12931	438	671	3.3951623931623907	233	G5BIB0	431	664	6.131499999999997	233
Q91XT4	PF12932	271	369	10.40809090909091	98	G5BIB0	264	362	10.6500101010101	98
Q9CQR5	PF00642	53	75	0.06478260869565218	22	G5APW3	54	73	0.0	19
Q9CQR5	PF06220	2	37	0.0628611111111111	35	G5APW3	3	38	0.0	35
O88851	PF06821	7	173	5.583928143712576	166	G5CBB2	8	174	6.668485029940117	166
Q8CDI6	PF15921	0	1108	0.12189359783588816	1108	G5BJQ7	1	1111	0.8660540540540546	1110
O35719	PF08423	64	179	6.400724137931032	115	G5BME0	65	178	6.894412280701755	113
Q8R361	PF00168	19	147	3.4674728682170546	128	G5CBQ6	20	148	2.923232558139535	128
Q8R361	PF09457	592	638	6.366765957446806	46	G5CBQ6	597	643	6.288361702127656	46
Q80U87	PF00443	738	1067	5.2847363636363625	329	G5C8T1	765	1094	5.342436363636363	329
Q80U87	PF00581	183	304	4.42477049180328	121	G5C8T1	184	305	6.445639344262296	121
Q80U87	PF08969	7	114	5.459907407407405	107	G5C8T1	8	115	4.18712962962963	107
Q9DBQ9	PF13638	396	531	6.270279411764707	135	G5ATN6	319	454	5.548205882352943	135
Q91XE4	PF04952	12	298	1.7906794425087114	286	G5BTW1	13	299	1.4564947735191631	286
Q99K85	PF00266	20	356	7.479356083086053	336	G5BLA9	1	337	8.477121661721073	336
Q8BJ63	PF00928	196	474	2.8311039426523297	278	G5ANI4	197	475	3.7885017921146944	278
Q7TNK1	PF02257	59	134	1.7640921052631582	75	G5C458	46	121	1.7643421052631585	75
Q6PDE7	PF01019	124	173	23.749640000000007	49	G5B920	127	176	25.32792	49
Q6PDE7	PF01019	185	268	0.4668571428571429	83	G5B920	188	271	0.07505952380952381	83
Q6PDE7	PF01019	344	395	8.501596153846151	51	G5B920	346	397	9.656903846153844	51
Q3UYI5	PF00617	250	450	0.8885074626865678	200	G5BUJ6	187	347	0.8645838509316771	160
Q3UYI5	PF00618	125	168	6.321545454545454	43	G5BUJ6	71	114	13.155204545454545	43
Q3UYI5	PF00788	614	697	2.731702380952381	83	G5BUJ6	510	593	2.078214285714286	83
Q8BTV2	PF00076	83	154	9.584708333333333	71	G5AYG1	84	155	8.785861111111107	71
P83877	PF02966	3	135	9.991142857142858	132	G5AVW4	4	116	4.967283185840708	112
P61514	PF01780	3	87	0.05643529411764706	84	E3VX70	4	88	0.05643529411764706	84
Q8C7M3	PF00041	453	524	0.01666666666666667	71	G5BLN5	620	691	0.01611111111111111	71
Q8C7M3	PF00622	674	785	8.110178571428571	111	G5BLN5	835	946	8.915133928571429	111
Q8C7M3	PF00643	224	264	0.016219512195121952	40	G5BLN5	321	361	0.016219512195121952	40
Q8C7M3	PF13920	6	38	0.060363636363636376	32	G5BLN5	103	135	0.05981818181818181	32
Q60902	PF12763	32	71	2.202475	39	G5C2V7	107	145	2.0766666666666667	38
Q60902	PF12763	152	214	2.490666666666668	62	G5C2V7	385	457	2.1519315068493143	72
Q60902	PF12763	276	358	9.553963855421687	82	G5C2V7	521	603	0.7737108433734938	82
Q9D7W5	PF10232	0	264	2.43962641509434	264	G5AQF9	9	273	2.439728301886793	264
A2AEV7	PF11819	1	138	0.004855072463768115	137	G5BJJ3	17	154	0.004855072463768115	137
Q9WV52	PF00169	13	98	0.4803488372093022	85	G5C7Y1	142	227	1.2652558139534886	85
Q9WV52	PF00169	247	351	0.1201428571428572	104	G5C7Y1	417	521	0.10094285714285718	104
Q9WV52	PF00610	142	222	1.0212716049382715	80	G5C7Y1	312	392	0.9029753086419754	80
Q8BKV1	PF01153	23	563	2.0443585951940864	540	G5AN25	24	507	1.4611219008264456	483
Q91ZA8	PF12796	19	106	7.884977272727273	87	G5BFZ5	73	160	7.923136363636362	87
Q8C1F5	PF13181	323	352	0.06066666666666666	29	G5BLG7	308	337	0.06083333333333332	29
Q9QXD1	PF01756	495	662	6.680732142857143	167	G5BUK5	474	640	5.3707108433734945	166
Q9QXD1	PF02770	150	259	7.127309090909089	109	G5BUK5	129	238	2.4565636363636365	109
Q9QXD1	PF14749	32	147	1.251413793103448	115	G5BUK5	11	126	2.550594827586207	115
Q9WV76	PF01602	10	521	8.539443359375003	511	G5ATD6	11	522	10.471119140624998	511
Q9WV76	PF09066	620	729	2.043890909090909	109	G5ATD6	622	731	3.388118181818182	109
P70313	PF00175	1009	1121	3.0916283185840716	112	G5AMS6	1014	1126	3.6798407079646	112
P70313	PF00258	520	696	4.487542372881354	176	G5AMS6	525	701	4.519372881355934	176
P70313	PF00667	750	977	4.898776315789475	227	G5AMS6	755	982	7.524307017543862	227
P70313	PF02898	121	479	1.2363871866295264	358	G5AMS6	126	484	1.1941754874651818	358
Q9DBJ3	PF08397	19	235	1.4398064516129032	216	G5AX80	1	217	1.2384792626728112	216
Q9DBJ3	PF14604	348	398	3.1984509803921566	50	G5AX80	330	380	3.09743137254902	50
Q9JI44	PF05499	242	400	1.6178867924528304	158	G5ARW0	244	402	1.61748427672956	158
Q9JI44	PF16282	123	201	3.1131392405063303	78	G5ARW0	125	203	3.1122784810126576	78
Q99MQ4	PF01462	67	93	0.0	26	G5C2Q6	68	94	0.0	26
Q99MQ4	PF13855	98	154	9.94042105263158	56	G5C2Q6	99	155	9.942982456140351	56
Q99MQ4	PF13855	164	212	0.2460612244897959	48	G5C2Q6	165	213	0.21475510204081635	48
Q99MQ4	PF13855	257	316	9.053616666666667	59	G5C2Q6	258	317	9.159983333333336	59
Q64028	PF00536	945	1009	4.61816923076923	64	G5BPM4	983	1047	4.623507692307693	64
Q64028	PF16616	835	942	0.03986111111111111	107	G5BPM4	873	980	0.03972222222222222	107
P43883	PF03036	75	406	3.353719879518072	331	G5B2K0	20	351	1.4750783132530123	331
A2A6Q5	PF00515	567	600	1.4459117647058823	33	G5BMZ4	559	592	2.6132058823529407	33
A2A6Q5	PF00515	636	667	10.12909375	31	G5BMZ4	628	659	10.115499999999997	31
A2A6Q5	PF12895	16	92	15.308194805194805	76	G5BMZ4	10	86	15.328961038961037	76
A2A6Q5	PF13181	602	633	9.30559375	31	G5BMZ4	594	625	7.782531249999997	31
A2A6Q5	PF13181	672	702	9.08154838709677	30	G5BMZ4	664	694	7.730709677419352	30
Q9CQT1	PF01008	43	345	5.929072607260728	302	G5BYU9	44	339	4.094344594594595	295
Q571C7	PF15963	294	380	8.336379310344824	86	G5C0H7	292	378	8.341436781609199	86
Q00724	PF00061	38	170	4.9051954887218026	132	G5BE83	26	158	5.654315789473682	132
Q91YE2	PF13640	294	385	17.78979347826086	91	G5C9W6	282	373	18.79782608695652	91
P60843	PF00270	56	220	6.864006060606061	164	G5B5C8	41	205	6.864012121212119	164
P60843	PF00271	258	366	10.79442201834862	108	G5B5C8	243	360	17.354864406779658	117
Q9R1T2	PF00899	22	338	4.865397476340696	316	G5AV06	19	335	4.861892744479497	316
Q8BR90	PF17716	35	289	3.7031607843137255	254	G5C4Q8	36	290	2.752662745098036	254
Q8K2H2	PF02338	153	278	4.294642857142857	125	G5BBP6	153	278	2.4500555555555548	125
Q8C7W7	PF07522	264	298	1.964342857142857	34	G5ATD7	265	298	15.570794117647061	33
Q8BGF7	PF00929	973	1145	7.243890173410405	172	G5BB76	972	1144	7.24328901734104	172
Q8BGF7	PF13423	515	896	3.768958115183243	381	G5BB76	514	895	3.9837303664921446	381
Q9QY61	PF05920	160	199	15.235325	39	G5BPI6	61	100	15.268549999999996	39
Q6DIC0	PF00176	739	1026	9.262840277777775	287	G5C7C3	724	1011	9.225100694444446	287
Q6DIC0	PF00271	1055	1168	13.30973684210526	113	G5C7C3	1040	1153	13.316885964912275	113
Q6DIC0	PF00439	1404	1477	1.4567432432432432	73	G5C7C3	1407	1480	1.496054054054054	73
Q6DIC0	PF07529	442	511	0.06431428571428571	69	G5C7C3	427	496	0.06447142857142857	69
Q6DIC0	PF07533	593	636	0.0	43	G5C7C3	578	621	0.0	43
Q6DIC0	PF14619	1264	1330	0.0	66	G5C7C3	1249	1315	0.0	66
Q5PR73	PF00071	9	166	4.713278481012659	157	G5C2H5	10	167	4.666183544303798	157
Q9D1B9	PF00830	78	135	5.340913793103447	57	G5BXX3	79	136	7.097775862068965	57
Q9ER72	PF01406	126	534	1.2499242053789732	408	G5BST5	219	627	0.6045232273838635	408
O35914	PF12874	325	344	0.9004000000000001	19	G5BF01	328	347	0.6839500000000001	19
O35914	PF12874	686	705	0.0	19	G5BF01	690	708	0.0	18
O35914	PF12874	895	914	0.0	19	G5BF01	899	918	0.0	19
P25916	PF13923	16	55	4.30105	39	G5BTK4	17	56	3.7998	39
P25916	PF16207	159	223	10.112907692307692	64	G5BTK4	162	226	10.114384615384614	64
Q8BJL0	PF07443	213	267	8.482181818181818	54	G5C2K2	243	297	7.983818181818181	54
Q8BJL0	PF07443	301	355	11.362545454545453	54	G5C2K2	331	387	13.626245614035088	56
Q8BJL0	PF00176	413	626	8.296943925233649	213	G5C2K2	445	658	7.720789719626162	213
Q8BJL0	PF00271	672	779	10.932712962962963	107	G5C2K2	704	811	11.25161111111111	107
Q6EDY6	PF16000	789	1080	2.3611335616438365	291	G5C0V2	786	1078	1.5721160409556316	292
Q6EDY6	PF13516	274	296	0.010956521739130434	22	G5C0V2	275	297	0.01643478260869565	22
Q6EDY6	PF13516	336	354	0.0	18	G5C0V2	337	355	0.0	18
Q6EDY6	PF13516	572	595	0.007083333333333335	23	G5C0V2	569	592	0.0	23
Q6EDY6	PF17888	37	118	3.3722926829268265	81	G5C0V2	38	119	4.164780487804878	81
Q501J7	PF02755	64	86	0.0	22	G5AP89	61	83	0.0	22
Q501J7	PF02755	576	597	0.0	21	G5AP89	578	599	0.0	21
Q501J7	PF02755	613	636	0.0	23	G5AP89	615	638	0.0	23
Q6PGL7	PF15255	952	1071	0.005333333333333333	119	G5ATS3	828	947	0.0	119
Q80TF4	PF00651	80	186	6.816168224299065	106	G5BCW3	82	188	7.522299065420562	106
Q80TF4	PF01344	376	426	19.946078431372552	50	G5BCW3	378	428	19.54894117647059	50
Q80TF4	PF01344	439	473	10.454057142857145	34	G5BCW3	441	475	6.532971428571429	34
Q80TF4	PF01344	477	519	5.3729069767441855	42	G5BCW3	479	521	5.36353488372093	42
Q80TF4	PF01344	523	571	3.2815306122448984	48	G5BCW3	525	573	3.42538775510204	48
Q80TF4	PF01344	577	617	14.953414634146345	40	G5BCW3	579	619	14.93890243902439	40
Q80TF4	PF07707	194	295	6.331852941176474	101	G5BCW3	196	297	8.435186274509803	101
Q569N2	PF12796	35	116	9.42917073170731	81	G5B2W6	36	117	9.931670731707317	81
Q8CBY3	PF03399	565	752	3.7720212765957415	187	G5CBG7	564	750	3.143754010695185	186
Q9DAK9	PF05005	6	115	0.5896727272727275	109	G5BEI1	8	117	0.881345454545455	109
P43300	PF00096	275	298	0.0	23	G5B9R2	277	324	0.0	47
P43300	PF00096	304	326	0.0	22	G5B9R2	302	324	0.0	22
P43300	PF00096	332	354	0.0	22	G5B9R2	330	352	0.0	22
P43300	PF11928	86	155	0.7016999999999999	69	G5B9R2	87	157	0.6899295774647888	70
Q9DAR0	PF15074	83	167	0.941858823529412	84	G5AX02	2	86	0.8784235294117645	84
P00687	PF00128	81	326	3.2807317073170723	245	G5AZM7	82	327	4.75387804878049	245
P00687	PF02806	424	506	4.2270240963855406	82	G5AZM7	425	507	4.258710843373492	82
Q80TB8	PF08240	66	128	6.5702380952380945	62	G5BIN6	8	70	6.773841269841269	62
Q80TB8	PF13602	231	375	6.893248275862072	144	G5BIN6	173	317	6.840772413793102	144
Q9JI08	PF03114	17	223	0.7458599033816425	206	G5B9R1	45	251	0.8507971014492755	206
Q9ERD8	PF00307	44	150	5.754205607476635	106	G5BKH4	46	152	4.442934579439252	106
Q9ERD8	PF00307	211	315	12.000428571428573	104	G5BKH4	213	317	12.794380952380948	104
Q8K1M6	PF00350	33	221	5.675275132275134	188	G5BSI1	49	231	5.901633879781419	182
Q8K1M6	PF01031	286	514	4.26282096069869	228	G5BSI1	365	563	3.3894422110552744	198
Q8K1M6	PF02212	644	734	4.189758241758241	90	G5BSI1	682	772	4.183725274725275	90
Q8CG71	PF13640	574	663	7.982533333333333	89	G5CA57	405	494	8.972677777777779	89
Q6A065	PF15308	802	1504	0.8881891891891901	702	G5AM39	709	1402	0.8412406340057642	693
P35123	PF06337	30	121	1.6039347826086958	91	G5BZW1	31	122	0.6989891304347825	91
P35123	PF14836	139	225	0.9338390804597702	86	G5BZW1	140	226	0.916057471264368	86
P35123	PF00443	301	918	2.323857605177995	617	G5BZW1	302	920	2.3337932148626814	618
Q9CR21	PF00550	91	147	0.0731578947368421	56	G5BV71	36	92	0.07245614035087719	56
Q9WVL0	PF02798	6	79	3.4255540540540537	73	G5B679	22	95	2.7866351351351355	73
Q9WVL0	PF14497	124	189	0.060484848484848475	65	G5B679	140	205	0.7808636363636365	65
Q8BYZ7	PF04727	292	467	5.1888011363636375	175	G5C651	293	468	6.000386363636363	175
Q8BYZ7	PF11841	114	267	4.040935064935064	153	G5C651	115	268	7.835961038961037	153
Q8BYZ7	PF16457	534	662	5.201449612403098	128	G5C651	535	663	5.519372093023255	128
Q6GQT0	PF00782	257	324	11.662647058823529	67	G5AYQ2	258	325	11.731926470588233	67
Q6GQT0	PF14671	12	151	10.050635714285713	139	G5AYQ2	13	152	10.449478571428571	139
Q9WV04	PF00225	11	338	3.264512195121952	327	G5BTA9	12	339	3.56932012195122	327
A2ACP1	PF10300	215	482	15.106287313432839	267	G5C862	280	547	15.377533582089553	267
P97927	PF00053	81	121	0.0	40	G5AKC5	20	65	0.0	45
P97927	PF00053	167	183	0.08029411764705884	16	G5AKC5	1	17	0.08088235294117647	16
P97927	PF00053	186	237	0.0	51	G5AKC5	20	71	0.0	51
P97927	PF02210	876	1007	9.953704545454542	131	G5AKC5	715	846	9.176340909090916	131
P97927	PF02210	1073	1089	35.419411764705885	16	G5AKC5	912	927	36.53266666666666	15
P97927	PF02210	1495	1535	33.33719512195123	40	G5AKC5	710	750	23.99417073170732	40
P97927	PF06008	290	546	0.06535408560311286	256	G5AKC5	131	387	0.5286498054474706	256
P97927	PF06009	726	853	0.246578125	127	G5AKC5	567	694	0.2152734375	127
Q9D2A5	PF00170	190	244	0.0019090909090909087	54	G5BES3	216	270	0.0	54
Q8VDD8	PF11945	12	293	1.071039007092198	281	G5B7J2	13	295	1.0929187279151946	282
Q9CYH5	PF01408	6	110	0.5466095238095239	104	G5C671	7	111	1.3968380952380948	104
Q9CYH5	PF02894	133	264	2.5328257575757585	131	G5C671	134	265	2.4223787878787872	131
P63321	PF00071	15	175	3.946391304347825	160	G5B6U4	16	176	3.946391304347825	160
Q8K259	PF17921	64	122	5.679084745762713	58	G5B9C5	65	123	5.0509152542372915	58
Q8CEE6	PF00069	1058	1310	13.566268774703564	252	G5C3R4	964	1216	11.69550988142292	252
Q8CEE6	PF13426	131	220	12.029111111111105	89	G5C3R4	73	162	14.657611111111105	89
Q8CEE6	PF13426	345	410	12.130030303030304	65	G5C3R4	286	350	11.147784615384618	64
Q64471	PF00043	117	199	0.38185542168674697	82	G5B637	122	204	0.7633493975903611	82
Q64471	PF02798	15	74	17.458083333333335	59	G5B637	16	78	15.364428571428574	62
Q64311	PF14736	36	303	3.993951492537316	267	G5C0V8	37	304	4.075018656716418	267
Q8BVQ5	PF12697	78	361	6.176827464788734	283	G5AS94	84	367	6.1712676056337985	283
Q91W96	PF12894	25	116	11.385510869565225	91	G5B021	26	117	10.50008695652174	91
Q91W96	PF12896	233	429	6.4935279187817265	196	G5B021	234	430	6.494289340101522	196
P23780	PF01301	41	356	8.341170886075956	315	G5BIV1	16	330	6.776587301587303	314
P23780	PF13364	551	620	0.6736857142857146	69	G5BIV1	526	595	0.4488999999999999	69
Q91XC8	PF15228	17	101	6.052670588235293	84	G5BI15	1	85	6.132761904761906	84
O88940	PF00010	102	154	0.0	52	G5BAU4	108	160	0.0	52
Q14BU0	PF17085	0	133	11.490522388059704	133	G5BE19	1	134	10.430022388059703	133
P61161	PF00022	5	387	5.12979895561358	382	G5C5Z4	6	393	5.143319587628869	387
Q5NC05	PF00176	560	907	5.539818965517242	347	G5BFJ2	572	918	7.704573487031693	346
Q5NC05	PF00271	971	1081	10.646819819819825	110	G5BFJ2	982	1092	6.4312522522522535	110
Q5NC05	PF06839	4	40	0.06405405405405404	36	G5BFJ2	5	40	4.3213888888888885	35
Q3U4H6	PF00728	60	204	0.3447862068965517	144	G5BJA5	193	337	1.7983931034482763	144
Q8VE10	PF00583	89	187	12.034292929292938	98	G5B6G0	37	135	11.970202020202027	98
Q62083	PF00595	22	98	8.782649350649352	76	G5AYS3	23	99	8.772727272727273	76
Q62083	PF06456	116	351	3.189957627118643	235	G5AYS3	117	352	3.393453389830507	235
Q9QZD5	PF00996	6	70	4.324615384615384	64	G5BL26	7	70	6.507234375	63
Q9QZD5	PF00996	219	523	5.225954098360659	304	G5BL26	219	523	3.79743606557377	304
Q9JJY4	PF00270	87	249	5.318730061349694	162	G5BNX3	87	248	5.291777777777777	161
P70335	PF00069	75	337	11.385638783269966	262	G5BTS2	76	338	11.358087452471482	262
P70335	PF08912	947	1013	0.0	66	G5BTS2	948	1014	0.0	66
Q9QXY1	PF00595	12	88	6.337207792207793	76	G5BBD9	13	89	1.824532467532468	76
Q9QXY1	PF00595	188	260	7.12513698630137	72	G5BBD9	189	261	7.221027397260274	72
Q9QXY1	PF00595	375	434	5.213666666666667	59	G5BBD9	378	437	5.122183333333336	59
Q9QXY1	PF00625	653	754	4.1759509803921535	101	G5BBD9	728	825	4.31965306122449	97
Q9QXY1	PF07653	467	538	0.27895833333333336	71	G5BBD9	546	614	0.2107246376811594	68
Q91X83	PF00438	18	115	3.988959183673469	97	G5C4H9	19	116	3.808969387755102	97
Q91X83	PF02772	130	250	6.4760826446280975	120	G5C4H9	131	251	6.421421487603304	120
Q91X83	PF02773	252	388	8.231145985401461	136	G5C4H9	253	389	9.084094890510947	136
A2AB59	PF00169	479	591	4.7727079646017705	112	G5BIZ2	177	290	4.2745701754385985	113
A2AB59	PF00397	251	276	0.0	25	G5BIZ2	85	109	0.0	24
A2AB59	PF00397	301	329	0.0	28	G5BIZ2	82	110	0.0	28
A2AB59	PF00620	701	838	4.341804347826087	137	G5BIZ2	317	453	4.46414598540146	136
Q3UPH7	PF00621	1087	1242	1.0910128205128204	155	G5BFW0	1081	1236	1.2506602564102565	155
Q9D853	PF13847	80	207	7.181804687500002	127	G5BZ27	85	212	7.964367187499995	127
Q9QUH0	PF00462	14	79	7.3361363636363635	65	G5BU28	15	80	5.6534999999999975	65
Q8C8B0	PF00046	132	188	0.7640175438596492	56	G5BJL1	134	190	0.7638421052631578	56
Q8C8B0	PF03826	301	319	0.6243684210526317	18	G5BJL1	303	321	0.6241052631578948	18
Q61599	PF02115	10	196	0.5503422459893049	186	G5BV45	11	197	0.9067914438502672	186
A0A0B4J1F4	PF00339	99	165	0.15714925373134325	66	G5AT93	1	67	3.1110298507462693	66
A0A0B4J1F4	PF02752	188	313	4.1468968253968255	125	G5AT93	90	215	4.103873015873018	125
P09405	PF00076	310	378	1.8289565217391317	68	G5ASV2	356	424	1.627565217391305	68
P09405	PF00076	399	460	1.008241935483871	61	G5ASV2	445	506	1.3730967741935485	61
P09405	PF00076	488	554	0.8071492537313434	66	G5ASV2	535	601	0.916462686567164	66
P09405	PF00076	570	636	0.1930597014925373	66	G5ASV2	621	687	0.1930597014925373	66
Q8BYR1	PF04072	30	198	1.0144201183431951	168	G5BM45	31	198	1.4482202380952378	167
Q8R054	PF00084	84	116	0.0	32	G5B2L3	82	114	0.0	32
Q8R054	PF00084	127	178	0.020326923076923083	51	G5B2L3	125	167	0.02441860465116279	42
Q8R054	PF00084	266	321	0.0	55	G5B2L3	255	310	0.012410714285714287	55
Q8R054	PF02494	179	261	0.0	82	G5B2L3	168	250	0.0	82
Q8R054	PF13778	337	455	5.579966386554623	118	G5B2L3	326	444	5.9905966386554645	118
P97461	PF00177	61	203	7.596104895104898	142	G5B7K7	62	204	7.6517957746478915	142
Q9D6Z0	PF13532	80	201	0.5632622950819672	121	G5C4F8	42	163	1.2221065573770495	121
P56388	PF06373	66	128	0.027047619047619046	62	G5C0H4	53	115	0.027870967741935492	62
P47239	PF00046	215	271	0.8089473684210527	56	G5BZM4	200	256	0.8129298245614037	56
P47239	PF00292	33	158	0.2988809523809524	125	G5BZM4	18	143	0.3003968253968253	125
Q62422	PF00018	17	62	5.224239130434783	45	G5BHT6	7	52	5.199021739130434	45
Q62422	PF12796	76	168	6.8267741935483865	92	G5BHT6	66	158	4.5341505376344085	92
O70405	PF00069	16	277	6.615515267175572	261	G5AWQ1	5	266	4.7528702290076295	261
O70405	PF12063	844	1044	5.11610447761194	200	G5AWQ1	823	1023	7.142039800995024	200
O35417	PF01160	21	65	0.34379999999999994	44	G5BEP7	67	110	1.3081363636363637	43
Q810F8	PF00907	66	251	3.31894623655914	185	G5BTW2	65	250	3.2443440860215063	185
Q9JL95	PF00059	115	221	4.511168224299063	106	G5BLI8	170	277	1.4122897196261683	107
Q4VBE4	PF00008	568	599	0.042656250000000014	31	G5ANE4	587	618	0.0428125	31
Q4VBE4	PF00008	787	816	0.0	29	G5ANE4	806	835	0.0	29
Q4VBE4	PF00041	57	125	10.505507246376816	68	G5ANE4	2	79	4.598243589743589	77
Q4VBE4	PF00041	143	227	2.618305882352941	84	G5ANE4	97	181	2.434282352941176	84
Q4VBE4	PF00054	414	499	8.794802325581394	85	G5ANE4	366	450	11.42088235294118	84
Q4VBE4	PF02210	640	765	0.7753650793650793	125	G5ANE4	659	784	0.7606031746031742	125
Q4VBE4	PF02210	867	992	3.3125793650793667	125	G5ANE4	878	1003	5.0748571428571445	125
Q99L60	PF03223	3	416	5.823132850241549	413	G5B590	4	417	5.217270531400968	413
Q3UL97	PF16788	58	170	0.1688495575221239	112	G5BWF9	285	351	0.1735522388059701	66
Q3UL97	PF16794	345	442	6.1541530612244895	97	G5BWF9	377	475	3.4578484848484847	98
P97473	PF00035	30	94	0.0	64	G5BIF3	31	95	0.0	64
P97473	PF00035	158	220	0.020793650793650798	62	G5BIF3	160	222	0.020793650793650798	62
P70326	PF00907	56	236	4.218060773480663	180	G5AKX8	57	237	4.218060773480663	180
P60191	PF00168	127	234	9.140296296296297	107	G5BB31	128	235	7.210768518518513	107
Q9Z1M4	PF00069	67	327	2.8030000000000013	260	G5BSA7	66	330	2.1356641509433962	264
Q9Z1M4	PF00433	349	388	12.43035	39	G5BSA7	352	391	14.17205	39
Q6PDI6	PF04424	255	372	1.3501355932203392	117	G5BKV0	130	247	0.8293559322033897	117
Q8K2Y9	PF16545	295	395	1.6881584158415839	100	G5BIL6	235	315	1.2207283950617287	80
Q9Z101	PF00564	15	93	2.224075949367088	78	G5C668	16	94	0.1838101265822785	78
Q9Z101	PF00595	158	244	3.81435632183908	86	G5C668	159	245	4.484367816091956	86
Q9JMG1	PF01381	81	131	0.0	50	G5BEI3	45	95	0.0	50
Q9JMG1	PF08523	44	72	0.027551724137931038	28	G5BEI3	8	36	0.05455172413793103	28
D3Z3K2	PF14634	9	51	5.857674418604652	42	G5B5Q4	10	52	5.810023255813952	42
Q3UQV5	PF00651	39	145	6.197168224299065	106	G5AXP5	40	146	6.8906822429906525	106
Q3UQV5	PF01344	328	373	1.6791739130434784	45	G5AXP5	331	376	0.466	45
Q3UQV5	PF01344	376	420	0.7292444444444445	44	G5AXP5	379	423	0.4899111111111111	44
Q3UQV5	PF01344	473	511	11.015717948717949	38	G5AXP5	476	514	10.356820512820512	38
Q3UQV5	PF07707	152	251	6.427779999999995	99	G5AXP5	153	252	5.763300000000004	99
B1AZP2	PF03359	660	991	0.2547831325301207	331	G5B838	661	992	0.2555861027190334	331
Q6ZPY2	PF10373	196	400	13.823731707317073	204	G5AR95	191	395	13.867526829268293	204
Q6ZPY2	PF10373	649	742	5.843872340425534	93	G5AR95	645	738	5.938446808510637	93
Q6ZPY2	PF10374	76	187	9.720776785714287	111	G5AR95	71	182	9.7145625	111
B1AS42	PF00175	186	298	13.884823008849557	112	G5C9M0	184	296	12.55435398230088	112
B1AS42	PF00970	81	176	1.1358333333333333	95	G5C9M0	79	174	0.7317187499999998	95
B1AS42	PF09791	14	51	0.02173684210526316	37	G5C9M0	15	51	0.008756756756756755	36
Q9CPW2	PF00111	66	145	4.403499999999998	79	G5B228	68	147	0.3337875	79
Q8K4Q7	PF00781	131	272	5.043619718309858	141	G5BVB6	201	342	3.842676056338029	141
P03940	PF00067	48	470	6.3821891252955085	422	G5C3H7	47	474	6.534135514018693	427
Q8R331	PF04438	112	140	0.07051724137931034	28	G5AXB9	132	160	0.0696551724137931	28
Q62417	PF00018	1128	1174	0.0	46	G5C153	1483	1529	0.013404255319148937	46
Q62417	PF02208	205	243	0.0	38	G5C153	511	548	0.0	37
Q62417	PF07653	1053	1103	9.560274509803923	50	G5C153	1408	1458	9.548725490196077	50
Q62417	PF14604	1235	1285	0.6609803921568628	50	G5C153	1847	1897	0.7035882352941175	50
Q9D494	PF15101	1	200	4.491524999999996	199	G5BF72	2	235	2.904786324786328	233
Q9ESD1	PF00089	44	280	5.4022405063291155	236	G5BYC3	18	254	5.180919831223628	236
Q60739	PF00240	179	229	0.5913725490196079	50	G5B043	72	122	0.6205294117647059	50
Q60739	PF02179	266	333	3.1347205882352944	67	G5B043	159	226	0.3462941176470589	67
O35085	PF00046	360	386	1.5393333333333332	26	G5AZG2	63	89	1.5390000000000001	26
O35085	PF03826	531	545	0.04866666666666666	14	G5AZG2	163	177	0.15333333333333335	14
Q8R4N0	PF03328	43	271	7.237528384279478	228	G5B1U3	45	273	8.159545851528389	228
Q9JK92	PF00011	94	172	1.1300759493670889	78	G5BEF5	95	173	3.028493670886077	78
Q8BNE1	PF13402	632	891	2.1951461538461543	259	G5C2N1	633	889	2.5923540856031133	256
Q8BNE1	PF17291	523	630	8.257907407407409	107	G5C2N1	524	631	8.13786111111111	107
O35691	PF04696	134	258	0.6828799999999997	124	G5C811	136	260	0.681232	124
O35691	PF04697	0	130	0.10640458015267176	130	G5C811	1	132	0.10387121212121213	131
Q6P5B0	PF08161	470	671	6.572712871287128	201	G5C0A6	471	672	6.879049504950493	201
Q8R4H4	PF00246	144	421	1.9555899280575548	277	G5BH75	145	415	2.5364649446494463	270
Q8R4H4	PF02244	43	116	4.3094864864864855	73	G5BH75	44	117	5.3139324324324315	73
Q8BN58	PF00620	402	552	2.975860927152317	150	G5B1K9	347	497	4.456841059602651	150
Q80TC5	PF01352	48	85	3.189421052631578	37	G5AQ39	49	86	3.2002894736842107	37
Q80TC5	PF03184	395	566	4.4601744186046535	171	G5AQ39	396	570	4.430525714285714	174
Q80TC5	PF03221	259	321	0.0	62	G5AQ39	260	322	0.0	62
Q80TC5	PF09607	194	246	1.00822641509434	52	G5AQ39	195	247	1.012452830188679	52
P52946	PF00046	147	203	1.7811929824561403	56	G5ATU9	148	204	1.7851403508771932	56
Q9ESP1	PF02815	44	140	0.0	96	G5BKG5	45	141	0.0	96
Q6PHZ5	PF00076	334	403	0.7289142857142857	69	G5BZU0	81	150	0.6915142857142856	69
Q6PHZ5	PF00076	415	475	0.5714098360655738	60	G5BZU0	162	222	0.5700163934426229	60
Q6PHZ5	PF07744	709	883	7.168697142857143	174	G5BZU0	455	629	6.25104	174
G5E869	PF00096	391	410	0.0	19	G5AZI4	184	203	0.0	19
G5E869	PF00096	1720	1742	0.0	22	G5AZI4	1514	1536	0.0	22
G5E869	PF13909	600	624	0.0	24	G5AZI4	393	417	0.0	24
O55233	PF03045	147	242	0.06531249999999998	95	G5AP57	105	200	0.3900625	95
Q9Z2M6	PF13881	7	113	0.37230841121495306	106	G5ATT7	8	114	0.3668971962616823	106
Q9DB30	PF00069	25	290	7.364492481203006	265	G5BYK5	26	291	7.713139097744363	265
Q8C754	PF04129	93	600	6.6952618110236175	507	G5BAZ5	94	604	6.65774559686889	510
P57724	PF00013	18	78	3.8007704918032794	60	G5AXN5	59	119	3.7521967213114764	60
P57724	PF00013	102	166	9.976784615384616	64	G5AXN5	143	207	11.212276923076923	64
P57724	PF00013	243	305	13.665095238095233	62	G5AXN5	284	346	14.133888888888887	62
Q60770	PF00995	32	575	5.894715073529412	543	G5BQU8	33	577	5.768510091743117	544
P46938	PF00397	157	186	0.0	29	G5BUB5	66	95	0.027000000000000003	29
P46938	PF00397	216	245	1.8793666666666664	29	G5BUB5	125	154	1.7919333333333336	29
Q80T03	PF00094	82	156	4.329013333333334	74	G5C8F6	5	79	5.96896	74
Q80T03	PF00094	203	234	0.0	31	G5C8F6	85	116	5.4928125	31
Q80T03	PF00094	438	590	11.003575163398693	152	G5C8F6	320	472	10.511581699346413	152
Q80T03	PF00094	909	1059	2.72743046357616	150	G5C8F6	785	935	1.6927284768211923	150
Q80T03	PF01826	343	398	0.015625	55	G5C8F6	225	280	0.015	55
Q80T03	PF01826	805	868	0.0	63	G5C8F6	681	744	0.0	63
Q80T03	PF08742	284	338	0.057018181818181815	54	G5C8F6	166	220	0.0	54
Q80T03	PF08742	632	699	1.0720735294117647	67	G5C8F6	514	581	0.0964264705882353	67
Q80T03	PF08742	1101	1168	0.7323970588235293	67	G5C8F6	977	1044	0.16474999999999995	67
Q80U04	PF13639	632	673	2.4684761904761907	41	G5AMP4	628	669	2.4763095238095243	41
P21271	PF00063	468	749	0.7934751773049645	281	G5AX33	1	282	1.7804751773049634	281
P21271	PF00612	765	785	1.4572380952380957	20	G5AX33	298	318	0.5313333333333333	20
P21271	PF00612	788	805	0.0	17	G5AX33	321	338	0.0	17
P21271	PF00612	813	833	3.4561428571428565	20	G5AX33	346	366	3.135142857142857	20
P21271	PF00612	837	856	7.1051	19	G5AX33	370	389	17.004600000000003	19
P21271	PF00612	863	880	0.0	17	G5AX33	396	413	0.0	17
P21271	PF00612	884	904	17.676666666666666	20	G5AX33	417	437	17.69214285714286	20
P21271	PF01843	1649	1750	8.894019607843132	101	G5AX33	1198	1299	8.055598039215692	101
Q8BLY1	PF00086	93	156	0.797796875	63	G5BQM2	62	125	0.809125	63
Q8BLY1	PF00086	236	301	7.766212121212122	65	G5BQM2	194	259	7.787318181818181	65
Q8BLY1	PF07648	41	85	5.456244444444443	44	G5BQM2	10	54	1.026	44
Q8BLY1	PF10591	369	433	0.29381538461538464	64	G5BQM2	327	391	2.746169230769232	64
Q8BLY1	PF16597	157	228	3.7817916666666656	71	G5BQM2	126	186	0.0	60
P16330	PF05881	184	418	5.1649574468085095	234	G5B0L2	185	419	8.11201276595745	234
P16330	PF13671	51	155	3.8333047619047615	104	G5B0L2	52	156	3.9125047619047617	104
Q6P2K3	PF05018	93	173	3.1266543209876536	80	G5B0D1	60	140	1.147333333333333	80
A2RRY8	PF15160	57	254	0.10889898989898987	197	G5BNP4	35	228	1.151273195876289	193
Q8BTM8	PF00307	120	148	36.30668965517242	28	G5AVD8	10	38	36.36793103448277	28
Q8BTM8	PF00307	166	265	1.24445	99	G5AVD8	56	118	1.9712857142857143	62
Q8BTM8	PF00630	279	370	10.368206521739127	91	G5AVD8	132	223	10.359402173913043	91
Q8BTM8	PF00630	378	470	0.3921290322580645	92	G5AVD8	231	323	0.5001290322580645	92
Q8BTM8	PF00630	477	566	5.01218888888889	89	G5AVD8	330	419	5.010488888888887	89
Q8BTM8	PF00630	573	658	0.18845348837209305	85	G5AVD8	426	511	0.18748837209302324	85
Q8BTM8	PF00630	669	759	0.043956043956043966	90	G5AVD8	558	648	0.04384615384615384	90
Q8BTM8	PF00630	766	861	7.157218749999998	95	G5AVD8	655	750	7.246677083333334	95
Q8BTM8	PF00630	870	960	0.17334065934065934	90	G5AVD8	759	849	0.5103186813186812	90
Q8BTM8	PF00630	968	1056	0.0	88	G5AVD8	857	945	0.0	88
Q8BTM8	PF00630	1064	1150	1.215666666666667	86	G5AVD8	953	1039	1.2133908045977009	86
Q8BTM8	PF00630	1157	1243	0.5861379310344828	86	G5AVD8	1046	1132	0.5849425287356321	86
Q8BTM8	PF00630	1267	1345	0.0	78	G5AVD8	1214	1292	0.0	78
Q8BTM8	PF00630	1352	1438	0.09834482758620693	86	G5AVD8	1299	1385	0.098	86
Q8BTM8	PF00630	1445	1535	1.155912087912088	90	G5AVD8	1392	1482	1.1311098901098902	90
Q8BTM8	PF00630	1543	1632	1.7106888888888887	89	G5AVD8	1490	1579	1.7120666666666668	89
Q8BTM8	PF00630	1639	1736	1.819132653061225	97	G5AVD8	1586	1683	1.802112244897959	97
Q8BTM8	PF00630	1808	1855	0.10897916666666667	47	G5AVD8	1755	1802	0.1873125	47
Q8BTM8	PF00630	1866	1948	2.3888192771084342	82	G5AVD8	1813	1895	2.3858313253012047	82
Q8BTM8	PF00630	2045	2129	0.4054823529411763	84	G5AVD8	1992	2076	0.4046	84
Q8BTM8	PF00630	2175	2226	0.12280769230769233	51	G5AVD8	2122	2173	0.18380769230769234	51
Q8BTM8	PF00630	2237	2320	5.0332261904761895	83	G5AVD8	2184	2267	5.0751904761904765	83
Q8BTM8	PF00630	2330	2416	3.0916091954022997	86	G5AVD8	2277	2363	3.086356321839081	86
Q8BTM8	PF00630	2427	2512	1.0159883720930232	85	G5AVD8	2374	2459	1.0181627906976745	85
Q8BTM8	PF00630	2554	2642	9.93921348314607	88	G5AVD8	2525	2613	10.567438202247189	88
Q05AH6	PF18658	71	134	0.10665625	63	G5B6G3	71	134	0.111296875	63
Q8CFX1	PF00479	25	207	6.333836065573772	182	G5C542	203	385	5.8724098360655725	182
Q8CFX1	PF01182	557	779	3.748201793721973	222	G5C542	786	1008	4.720973094170404	222
Q8CFX1	PF02781	213	506	6.231585034013604	293	G5C542	391	734	2.919133720930233	343
P50247	PF00670	190	351	6.0661358024691365	161	G5BPT7	191	352	6.059746913580248	161
P50247	PF05221	6	140	0.8950814814814813	134	G5BPT7	7	141	0.9631555555555548	134
P97931	PF03167	137	291	12.338258064516127	154	G5AWY8	176	330	12.366703225806454	154
Q9D3N8	PF00566	77	160	7.165904761904762	83	G5AVV7	42	125	5.532238095238094	83
Q9D3N8	PF00566	178	299	23.514065573770484	121	G5AVV7	126	247	24.1542131147541	121
Q504M8	PF00071	68	229	13.212209876543202	161	G5BY45	128	289	13.023308641975307	161
P81270	PF00178	318	396	1.4600506329113925	78	G5AXI4	401	479	1.3873544303797474	78
P81270	PF02198	136	203	0.5151617647058825	67	G5AXI4	219	286	0.5188823529411765	67
P10754	PF00096	265	287	0.0	22	G5B1I6	281	303	0.0	22
P10754	PF00096	293	315	0.0	22	G5B1I6	309	331	0.0	22
P10754	PF00096	321	343	0.0	22	G5B1I6	337	359	0.0	22
P10754	PF00096	349	371	0.0	22	G5B1I6	365	387	0.0	22
P10754	PF00096	377	399	0.06391304347826086	22	G5B1I6	393	415	0.06304347826086956	22
P10754	PF00096	405	427	0.0	22	G5B1I6	421	443	0.0	22
P10754	PF00096	433	455	0.0	22	G5B1I6	449	471	0.0	22
P10754	PF00096	461	483	0.0	22	G5B1I6	477	499	0.0	22
P10754	PF01352	122	153	2.13821875	31	G5B1I6	93	124	7.30546875	31
Q571F5	PF00622	148	265	0.4915423728813559	117	G5BY66	149	266	0.5004830508474577	117
Q8BXK4	PF11968	224	320	19.396762886597934	96	G5ARE1	174	270	16.48462886597938	96
Q9WUD8	PF06905	1	115	3.3464347826086938	114	G5BPL2	12	125	2.1953185840707965	113
P70671	PF00605	6	108	0.1634466019417476	102	G5B8Q2	7	109	0.11171844660194176	102
P70671	PF10401	195	371	4.510231638418079	176	G5B8Q2	190	367	4.814494382022471	177
Q8VEE0	PF00834	5	199	0.7638564102564099	194	G5AL22	6	200	0.7644358974358976	194
Q6P539	PF15258	26	561	0.5174720149253726	535	G5BVI7	27	562	0.5184299065420558	535
Q5RJY2	PF00632	422	689	6.836869402985072	267	G5CAM5	433	700	6.889492537313437	267
Q5RJY2	PF13771	40	127	6.596534090909093	87	G5CAM5	41	128	6.894738636363638	87
Q9DBP5	PF00406	24	169	4.952931506849315	145	G5BI92	1	146	4.942554794520548	145
P43025	PF00059	89	198	0.5118818181818182	109	G5ANN0	90	199	0.6479727272727276	109
Q8BIW1	PF01368	19	171	10.475248366013071	152	G5AJY5	20	172	15.45467320261439	152
Q8BIW1	PF02833	217	357	9.546702127659575	140	G5AJY5	218	358	9.102425531914893	140
Q91VB2	PF00069	24	276	7.601422924901185	252	G5BAM0	25	277	6.7816086956521735	252
Q8R0F5	PF00076	57	107	10.062470588235293	50	G5AY37	2	52	10.05470588235294	50
Q3TC72	PF01557	106	312	10.038173913043476	206	G5APT7	107	314	7.386975845410634	207
P11276	PF00041	615	687	0.5357945205479453	72	G5BHR4	617	689	0.3084931506849316	72
P11276	PF00041	725	796	13.231111111111113	71	G5BHR4	727	798	13.227111111111114	71
P11276	PF00041	810	886	3.7462987012987017	76	G5BHR4	812	888	3.7294155844155843	76
P11276	PF00041	907	982	3.4259868421052637	75	G5BHR4	909	984	2.924421052631578	75
P11276	PF00041	996	1074	14.657620253164554	78	G5BHR4	998	1076	12.482443037974686	78
P11276	PF00041	1094	1157	10.561875000000002	63	G5BHR4	1096	1159	16.959687499999998	63
P11276	PF00041	1173	1253	6.023185185185187	80	G5BHR4	1175	1255	6.0219999999999985	80
P11276	PF00041	1267	1347	11.913283950617284	80	G5BHR4	1269	1349	11.908716049382715	80
P11276	PF00041	1357	1434	3.4398461538461538	77	G5BHR4	1359	1436	4.2023205128205126	77
P11276	PF00041	1449	1527	10.311025316455693	78	G5BHR4	1451	1529	9.628974683544305	78
P11276	PF00041	1540	1619	9.382387500000002	79	G5BHR4	1542	1621	2.990612500000001	79
P11276	PF00041	1632	1711	5.5920250000000005	79	G5BHR4	1634	1713	5.5900625	79
P11276	PF00041	1723	1800	4.458461538461538	77	G5BHR4	1725	1802	4.454820512820513	77
P11276	PF00041	1812	1887	11.593434210526313	75	G5BHR4	1814	1889	10.545013157894742	75
P11276	PF00041	1904	1979	0.8147368421052631	75	G5BHR4	1906	1981	0.7599736842105262	75
P11276	PF00041	1993	2071	10.652493670886077	78	G5BHR4	1995	2073	10.677898734177216	78
P11276	PF00041	2207	2267	8.6902131147541	60	G5BHR4	2209	2269	2.7636557377049176	60
P11276	PF00039	52	87	0.7098611111111109	35	G5BHR4	52	87	0.7090277777777777	35
P11276	PF00039	97	135	0.0	38	G5BHR4	97	135	0.0	38
P11276	PF00039	141	179	0.0	38	G5BHR4	141	179	0.0	38
P11276	PF00039	186	225	0.27309999999999995	39	G5BHR4	186	225	0.27280000000000004	39
P11276	PF00039	231	270	0.0592	39	G5BHR4	231	270	0.040125	39
P11276	PF00039	469	507	0.0	38	G5BHR4	471	509	0.6201282051282051	38
P11276	PF00039	523	554	0.0	31	G5BHR4	525	556	0.0	31
P11276	PF00039	560	598	0.3337435897435898	38	G5BHR4	562	600	0.33294871794871805	38
P11276	PF00039	2295	2334	0.0	39	G5BHR4	2297	2336	0.0	39
P11276	PF00039	2340	2377	0.0	37	G5BHR4	2342	2379	0.0	37
P11276	PF00039	2384	2419	0.5594166666666667	35	G5BHR4	2386	2421	0.5588055555555556	35
P11276	PF00040	359	400	0.05561904761904764	41	G5BHR4	361	402	0.06000000000000001	41
P11276	PF00040	419	460	0.0	41	G5BHR4	421	462	0.0	41
P42567	PF12763	36	80	10.945333333333332	44	G5C863	60	103	7.153431818181819	43
P42567	PF12763	127	215	11.448764044943822	88	G5C863	38	127	3.503344444444445	89
P42567	PF12763	222	316	1.7617263157894734	94	G5C863	37	131	3.318957894736843	94
Q00417	PF00505	303	370	4.632999999999999	67	G5BN10	187	254	4.581485294117648	67
Q00417	PF08347	94	215	1.1727131147540983	121	G5BN10	4	130	2.0443464566929133	126
Q61858	PF01585	270	314	0.0	44	G5C3F1	177	221	0.0	44
Q80WT5	PF15045	696	761	0.1549242424242424	65	G5BFI2	686	751	0.15490909090909089	65
Q32P12	PF15072	457	538	1.5980243902439026	81	G5BN72	376	457	2.7942682926829265	81
Q8BMI3	PF00790	4	141	3.4615507246376813	137	G5BNC0	5	142	3.736282608695652	137
Q8BMI3	PF02883	592	709	10.178347457627119	117	G5BNC0	601	718	10.172008474576266	117
Q8BMI3	PF03127	221	298	0.018769230769230767	77	G5BNC0	222	299	0.0	77
Q8BMI3	PF18308	168	206	0.0	38	G5BNC0	169	207	0.0	38
Q8BGT6	PF00307	49	107	3.4634406779661018	58	G5AYR9	1	59	3.4734237288135588	58
Q8BGT6	PF00412	164	216	0.16377358490566038	52	G5AYR9	115	167	1.9883207547169808	52
Q8BGT6	PF12130	691	821	4.256198473282441	130	G5AYR9	622	752	4.283984732824431	130
Q6KAU7	PF00169	331	403	6.8205753424657525	72	G5BJD8	216	288	5.514506849315066	72
Q6KAU7	PF00621	101	178	0.21866666666666665	77	G5BJD8	101	174	0.2498783783783783	73
Q8C1Z7	PF13181	270	301	1.6178437500000005	31	G5BRE7	250	281	1.7781562499999997	31
Q8C1Z7	PF13414	174	203	2.455833333333333	29	G5BRE7	154	182	2.348034482758621	28
Q8C1Z7	PF13432	344	398	19.67189090909091	54	G5BRE7	324	378	16.80469090909091	54
Q9CQQ7	PF05405	84	243	13.01009375	159	G5BNX8	90	249	11.420431250000005	159
P47963	PF01294	7	186	0.12776111111111116	179	G5API3	8	187	0.23939999999999995	179
Q80US8	PF00010	58	109	0.0381923076923077	51	G5BQ04	59	110	0.037596153846153835	51
Q9D131	PF06608	12	147	0.5310441176470588	135	G5CB03	1	136	0.07062500000000001	135
Q99M04	PF04055	133	293	3.6533726708074505	160	G5C3U7	135	295	3.3009068322981348	160
Q99M04	PF16881	3	109	0.16397196261682245	106	G5C3U7	4	111	0.029305555555555564	107
G5E897	PF00630	48	124	1.216116883116883	76	G5BXR3	21	97	0.9151558441558442	76
G5E897	PF05686	228	481	5.445232283464563	253	G5BXR3	269	522	2.8078188976377936	253
Q8BZR9	PF10309	122	174	4.820132075471697	52	G5B931	123	175	4.813075471698112	52
Q7TQK0	PF00134	11	146	4.302860294117645	135	G5C144	11	146	4.454220588235295	135
Q6PAL7	PF15735	579	638	0.4158333333333334	59	G5AUT9	441	500	0.41625	59
Q8JZY2	PF07258	131	170	0.37515	39	G5BJS8	118	156	0.4743589743589744	38
P32261	PF00079	86	461	7.803441489361701	375	G5ARS6	74	449	7.867563829787233	375
Q9CZR8	PF00889	114	266	3.8465032679738544	152	G5BEB3	116	268	4.34186274509804	152
Q2VWQ2	PF00093	272	330	0.28171186440677964	58	G5AR26	212	270	0.2844067796610169	58
Q2VWQ2	PF00093	698	748	0.3123529411764706	50	G5AR26	638	688	0.07127450980392158	50
Q2VWQ2	PF02210	98	205	3.2380000000000018	107	G5AR26	38	145	3.2451759259259236	107
Q2VWQ2	PF07645	433	473	0.0	40	G5AR26	373	413	0.0	40
Q2VWQ2	PF07645	548	581	0.0	33	G5AR26	488	521	0.0	33
Q2VWQ2	PF07645	595	626	0.0	31	G5AR26	535	566	0.0	31
Q2VWQ2	PF12947	479	514	0.0	35	G5AR26	419	454	0.0	35
E9Q735	PF04564	949	1020	0.011875000000000002	71	G5BHL6	988	1059	0.023208333333333345	71
E9Q735	PF10408	329	764	11.184215596330256	435	G5BHL6	330	765	9.948307339449538	435
E9Q735	PF10408	762	932	6.7416491228070194	170	G5BHL6	801	971	7.9269590643274865	170
Q5SW28	PF10486	34	870	4.566789725209079	836	G5B5G7	124	951	4.747501813784763	827
O70157	PF01131	195	605	3.9070656934306576	410	G5BMX8	196	606	2.4361824817518225	410
O70157	PF01396	654	692	0.3261025641025642	38	G5BMX8	655	693	0.22089743589743585	38
O70157	PF01751	35	180	3.8986027397260266	145	G5BMX8	36	181	4.115732876712329	145
O70157	PF06839	812	850	16.47192307692308	38	G5BMX8	810	847	18.759157894736845	37
O70157	PF06839	898	940	0.5984883720930233	42	G5BMX8	896	938	0.033720930232558136	42
Q08024	PF02312	0	95	2.341354166666666	95	G5BP64	1	95	2.3368631578947374	94
Q9CQ48	PF04969	18	90	0.8596986301369863	72	G5B244	19	91	0.8596986301369863	72
Q6ZPR1	PF13879	353	455	0.04519417475728155	102	G5B2W8	337	439	0.05315533980582525	102
Q9D8B4	PF02466	20	118	4.835535353535353	98	G5C0P7	21	119	13.381202020202014	98
P70336	PF00069	91	353	12.241038022813694	262	G5B595	6	268	9.431022813688216	262
P70336	PF08912	977	1045	0.00963768115942029	68	G5B595	888	956	0.022434782608695653	68
Q9D154	PF00079	6	378	6.611868632707778	372	G5BKF2	7	377	8.719002702702703	370
Q9CZV5	PF07524	148	226	7.84540506329114	78	G5C2Z4	149	227	7.865113924050632	78
Q8C1Z8	PF01746	109	274	4.2054156626506005	165	G5AP61	111	276	4.215644578313252	165
Q9CY16	PF10246	73	131	0.4817966101694915	58	G5BAJ6	74	131	0.9963859649122806	57
P20357	PF00418	1664	1691	0.0	27	G5AL24	1646	1673	0.017571428571428575	27
P20357	PF00418	1692	1721	0.08216666666666668	29	G5AL24	1674	1703	0.0656	29
P20357	PF00418	1723	1754	0.0	31	G5AL24	1705	1736	0.0	31
P20357	PF08377	375	1509	0.4099964757709251	1134	G5AL24	377	1487	0.4984527452745276	1110
Q8JZL7	PF00617	208	401	8.067237113402058	193	G5AMF0	209	398	8.241521052631578	189
Q8JZL7	PF00618	38	133	8.827187500000003	95	G5AMF0	39	134	8.770187500000004	95
Q9D4H2	PF01465	719	761	16.367488372093025	42	G5BHA9	717	759	16.369139534883725	42
Q9CRW3	PF10209	7	125	4.536294117647062	118	G5AW94	8	120	5.283607142857141	112
Q3TDX8	PF00173	57	128	1.8215000000000003	71	G5B8B9	58	129	1.318569444444445	71
Q3TDX8	PF00175	401	505	5.856371428571432	104	G5B8B9	394	497	3.6235961538461527	103
Q3TDX8	PF00970	284	389	3.7909905660377343	105	G5B8B9	277	382	6.0396698113207545	105
Q3TDX8	PF04969	174	252	8.456531645569617	78	G5B8B9	167	245	13.442189873417716	78
Q8BTU1	PF05018	28	183	3.942730769230773	155	G5AUG3	1	156	3.9463269230769216	155
Q80ZS3	PF14943	27	196	2.4608588235294104	169	G5B4S7	28	197	2.5496705882352937	169
Q6NVE9	PF07228	79	301	5.878793721973095	222	G5AWM0	1	223	6.2400582959641255	222
Q3V3V9	PF13516	272	293	0.0	21	G5C666	273	294	0.0	21
Q3V3V9	PF13516	540	563	0.0	23	G5C666	541	564	0.0	23
Q3V3V9	PF16000	751	854	0.17689423076923078	103	G5C666	753	856	0.13746153846153847	103
Q3V3V9	PF16000	931	998	0.4895735294117648	67	G5C666	916	983	0.4864558823529412	67
Q3V3V9	PF17888	38	118	1.7573580246913585	80	G5C666	39	119	1.6829012345679013	80
Q80T74	PF00651	318	429	6.334642857142859	111	G5C378	318	429	6.336348214285715	111
Q80T74	PF01344	671	716	0.2135	45	G5C378	671	716	0.2135	45
Q80T74	PF01344	721	763	8.794093023255812	42	G5C378	721	763	8.794162790697673	42
Q80T74	PF01344	810	856	6.463063829787233	46	G5C378	810	856	7.333446808510642	46
Q80T74	PF07707	435	536	14.458068627450983	101	G5C378	435	536	14.481745098039214	101
Q3UBG2	PF14719	58	202	4.311862068965517	144	G5C9F8	92	236	4.311234482758621	144
Q5BLK4	PF00098	959	975	0.4762941176470588	16	G5ARL8	971	987	0.09688235294117646	16
Q5BLK4	PF00098	1341	1356	0.0	15	G5ARL8	1353	1368	0.0	15
Q5BLK4	PF00098	1448	1463	0.0	15	G5ARL8	1460	1475	0.1115	15
Q5BLK4	PF03828	550	599	19.324299999999994	49	G5ARL8	551	600	19.3206	49
Q5BLK4	PF03828	1229	1281	2.415698113207549	52	G5ARL8	1241	1293	2.3941698113207557	52
Q5BLK4	PF16631	1366	1445	0.0	79	G5ARL8	1378	1457	0.0	79
Q5BLK4	PF19088	204	536	5.580045045045045	332	G5ARL8	205	537	6.317759759759762	332
Q5BLK4	PF19088	966	1187	4.816918918918919	221	G5ARL8	978	1199	5.864108108108107	221
Q61011	PF00400	47	82	0.6109166666666668	35	G5CAR2	48	83	0.6581666666666666	35
Q61011	PF00400	98	124	4.227074074074075	26	G5CAR2	99	125	3.666592592592592	26
Q61011	PF00400	135	169	0.05191428571428572	34	G5CAR2	136	170	0.04914285714285715	34
Q61011	PF00400	174	211	0.7203421052631579	37	G5CAR2	175	212	0.3845	37
Q61011	PF00400	215	253	0.15738461538461546	38	G5CAR2	216	254	0.16456410256410253	38
Q61011	PF00400	271	297	13.378444444444439	26	G5CAR2	272	298	12.365777777777776	26
Q61011	PF00400	304	339	0.3576111111111111	35	G5CAR2	305	340	0.1873714285714286	35
O08999	PF00008	1728	1755	0.0	27	G5C1M3	1785	1812	0.0	27
O08999	PF00683	545	579	2.3761714285714284	34	G5C1M3	573	606	6.0469117647058805	33
O08999	PF00683	669	713	0.0	44	G5C1M3	694	738	0.0	44
O08999	PF00683	1414	1457	0.0	43	G5C1M3	1476	1519	0.0	43
O08999	PF00683	1586	1628	0.0942093023255814	42	G5C1M3	1648	1690	0.10418604651162792	42
O08999	PF07645	608	647	0.28995000000000004	39	G5C1M3	633	672	0.8300749999999999	39
O08999	PF07645	877	918	3.1275476190476192	41	G5C1M3	902	943	0.050833333333333335	41
O08999	PF07645	920	951	0.1456875	31	G5C1M3	945	976	1.8768125	31
O08999	PF07645	960	997	0.0	37	G5C1M3	1023	1060	0.026184210526315786	37
O08999	PF07645	1000	1039	0.0	39	G5C1M3	1063	1102	0.0	39
O08999	PF07645	1041	1081	0.014146341463414631	40	G5C1M3	1104	1144	0.07890243902439026	40
O08999	PF07645	1083	1123	0.0	40	G5C1M3	1146	1186	0.019268292682926833	40
O08999	PF07645	1125	1160	0.02402777777777778	35	G5C1M3	1188	1223	0.0	35
O08999	PF07645	1166	1206	1.5188048780487806	40	G5C1M3	1229	1269	1.0937317073170734	40
O08999	PF07645	1208	1248	0.0	40	G5C1M3	1271	1310	0.0	39
O08999	PF07645	1250	1288	0.1496153846153846	38	G5C1M3	1312	1350	1.4648717948717949	38
O08999	PF07645	1294	1334	0.0	40	G5C1M3	1356	1396	0.0	40
O08999	PF07645	1336	1377	0.884	41	G5C1M3	1398	1439	2.396999999999999	41
O08999	PF07645	1476	1517	0.2793809523809524	41	G5C1M3	1538	1579	0.2785238095238095	41
O08999	PF07645	1519	1547	0.0	28	G5C1M3	1581	1609	0.0	28
O08999	PF07645	1765	1808	0.0	43	G5C1M3	1822	1865	0.0	43
O08999	PF12661	846	866	0.0	20	G5C1M3	871	891	0.0	20
Q9CQF8	PF14978	34	100	0.0	66	G5B3M0	1	67	0.0	66
Q8R2I5	PF13841	24	53	1.1576	29	G5BMG4	25	54	2.6684	29
Q9CQA0	PF11111	0	170	8.524274853801169	170	G5BPQ8	1	169	6.9822011834319495	168
P21279	PF00503	46	347	8.519831125827809	301	G5BLA6	14	315	8.48469536423841	301
Q9QZN0	PF12937	1	38	46.1790789473684	37	G5BAQ4	85	121	39.877135135135134	36
Q9WTL8	PF00010	80	131	0.0	51	G5C7T1	74	125	0.0	51
Q9WTL8	PF00989	155	258	10.554730769230767	103	G5C7T1	149	252	10.555951923076924	103
Q9WTL8	PF14598	344	446	5.753932038834951	102	G5C7T1	339	441	6.432563106796116	102
Q9R0G8	PF00069	25	312	7.042368055555556	287	G5ARR7	26	313	6.213052083333333	287
Q9R0G8	PF00780	1142	1420	4.658688172043007	278	G5ARR7	1213	1543	4.208462235649549	330
Q9JJA4	PF00400	102	126	0.0	24	G5C1S1	103	127	0.25476000000000004	24
Q9JJA4	PF00400	131	169	8.87079487179487	38	G5C1S1	132	170	9.985923076923072	38
Q9JJA4	PF00400	180	216	0.0	36	G5C1S1	181	217	0.0	36
Q9JJA4	PF00400	247	283	0.6274594594594596	36	G5C1S1	248	284	0.3348918918918919	36
Q9JJA4	PF00400	291	324	0.162	33	G5C1S1	292	325	0.1631470588235294	33
Q9JJA4	PF00400	336	370	0.6611428571428571	34	G5C1S1	337	371	0.5438571428571428	34
Q9JJA4	PF08154	4	69	0.14789393939393944	65	G5C1S1	5	70	0.147469696969697	65
Q8BVM4	PF00278	281	386	17.381047169811318	105	G5B5K6	277	383	12.2364859813084	106
Q8BVM4	PF02784	46	280	2.7430468085106394	234	G5B5K6	47	276	3.900504347826087	229
Q8BW49	PF00515	140	171	0.0	31	G5BEX5	184	215	0.0	31
Q8BW49	PF07719	173	204	0.0	31	G5BEX5	217	248	0.0	31
Q8BTQ0	PF13923	16	54	0.1968461538461539	38	G5BCK7	17	55	0.1968461538461539	38
Q8BTQ0	PF16207	170	234	4.8481538461538465	64	G5BCK7	171	235	4.8481538461538465	64
Q9DBG7	PF00448	416	633	12.484527522935776	217	G5AXW6	418	635	12.220022935779808	217
Q9DBG7	PF02881	317	386	0.2373571428571429	69	G5AXW6	319	388	0.2332857142857143	69
Q9DBG7	PF04086	27	276	6.388543999999999	249	G5AXW6	28	277	4.944540000000002	249
P35922	PF00013	220	276	0.09468421052631576	56	G5BKA1	205	261	0.09424561403508774	56
P35922	PF00013	284	331	0.0	47	G5BKA1	269	316	0.0	47
P35922	PF05641	89	116	0.8819642857142859	27	G5BKA1	74	101	0.11075	27
P35922	PF12235	418	540	0.0	122	G5BKA1	404	526	0.0	122
P35922	PF16098	547	577	0.0	30	G5BKA1	533	563	0.0	30
P35922	PF16098	577	613	0.0	36	G5BKA1	580	616	0.0	36
P35922	PF17904	122	206	6.631682352941174	84	G5BKA1	107	191	6.682858823529415	84
P35922	PF18336	17	51	1.6130857142857142	34	G5BKA1	26	60	1.5259714285714288	34
P62881	PF00400	96	132	0.22118918918918926	36	G5C9D3	97	133	0.25213513513513514	36
P62881	PF00400	226	266	0.017804878048780486	40	G5C9D3	227	267	0.01768292682926829	40
P62881	PF00400	270	308	0.0	38	G5C9D3	271	309	0.0	38
P62881	PF00400	337	352	7.92	15	G5C9D3	389	404	4.5308125000000015	15
P62881	PF00400	359	392	5.5624117647058835	33	G5C9D3	411	443	0.6851515151515153	32
O35103	PF01462	61	89	0.017586206896551725	28	G5C2Q7	61	89	0.0050344827586206896	28
O35103	PF13855	92	152	0.5611803278688524	60	G5C2Q7	92	152	0.6903278688524591	60
O35103	PF13855	234	291	0.5429655172413793	57	G5C2Q7	234	291	3.1611551724137934	57
Q6NXN1	PF12752	55	105	0.0	50	G5BRU8	39	89	0.0	50
Q6NXN1	PF12901	118	150	0.0	32	G5BRU8	102	134	0.0	32
P12970	PF01248	130	211	8.316475609756099	81	G5B8H0	171	252	8.301804878048774	81
Q8BUH8	PF02902	760	1001	11.343665289256199	241	G5C014	743	979	11.644337552742616	236
Q80W93	PF14874	848	897	3.52088	49	G5C1Q4	803	853	8.698078431372545	50
Q80W93	PF15780	559	655	0.7803917525773196	96	G5C1Q4	514	609	0.8155729166666666	95
Q80W93	PF17213	2073	2273	2.4437910447761184	200	G5C1Q4	2038	2235	1.3371868686868686	197
P59511	PF00090	556	606	0.0	50	G5C9U5	564	614	0.0	50
P59511	PF01421	254	463	10.880476190476193	209	G5C9U5	262	471	10.848533333333336	209
P59511	PF01562	40	185	0.6689657534246575	145	G5C9U5	41	186	0.6298972602739725	145
P59511	PF05986	718	835	6.429855932203392	117	G5C9U5	726	843	5.006940677966099	117
P59511	PF08685	1708	1904	0.4133604060913708	196	G5C9U5	1717	1914	3.705421319796955	197
P59511	PF17771	475	542	0.027367647058823528	67	G5C9U5	483	550	0.026897058823529413	67
P59511	PF19030	848	897	0.1051	49	G5C9U5	856	904	0.0	48
P59511	PF19030	909	957	0.0	48	G5C9U5	917	965	0.0	48
P59511	PF19030	965	1017	0.0	52	G5C9U5	973	1025	0.0	52
P59511	PF19030	1020	1072	0.3011132075471698	52	G5C9U5	1028	1080	0.35894339622641513	52
P59511	PF19030	1075	1129	0.04078181818181818	54	G5C9U5	1083	1137	0.3466545454545455	54
P59511	PF19030	1151	1201	0.5915490196078431	50	G5C9U5	1159	1209	0.4162745098039217	50
P59511	PF19030	1206	1258	0.3924528301886793	52	G5C9U5	1214	1266	0.16833962264150945	52
P59511	PF19030	1303	1354	0.014326923076923076	51	G5C9U5	1311	1362	0.019903846153846157	51
P59511	PF19030	1357	1409	0.062264150943396226	52	G5C9U5	1365	1418	0.06111111111111112	53
P59511	PF19030	1415	1468	0.0	53	G5C9U5	1424	1477	0.0	53
P59511	PF19030	1471	1524	0.0	53	G5C9U5	1480	1533	0.0	53
P59511	PF19030	1529	1582	0.0	53	G5C9U5	1538	1591	2.0563888888888893	53
P59511	PF19030	1653	1704	0.10690384615384617	51	G5C9U5	1662	1713	0.11369230769230768	51
Q920Q8	PF00651	21	125	1.2706476190476197	104	G5ATN5	22	126	1.2471428571428576	104
Q920Q8	PF01344	356	401	0.012391304347826088	45	G5ATN5	357	402	0.012391304347826088	45
Q920Q8	PF01344	403	449	15.111872340425535	46	G5ATN5	404	450	15.113127659574467	46
Q920Q8	PF01344	452	498	1.1824255319148935	46	G5ATN5	453	499	1.1827659574468083	46
Q920Q8	PF01344	500	545	10.901130434782612	45	G5ATN5	501	546	1.7380652173913038	45
Q920Q8	PF01344	547	591	2.6015777777777784	44	G5ATN5	548	592	2.6024222222222217	44
Q920Q8	PF01344	594	634	3.7103902439024377	40	G5ATN5	595	635	4.084195121951219	40
Q920Q8	PF07707	133	220	0.24837500000000004	87	G5ATN5	134	221	0.2523181818181819	87
Q5RKZ7	PF01967	492	627	12.917691176470587	135	G5B9E5	519	654	10.938301470588234	135
Q5RKZ7	PF04055	73	233	0.8179503105590058	160	G5B9E5	74	234	1.566124223602485	160
Q5RKZ7	PF06463	241	366	0.4811111111111109	125	G5B9E5	242	393	3.5851447368421065	151
Q5RKZ7	PF13353	75	179	1.03007619047619	104	G5B9E5	76	180	1.1641428571428576	104
Q9CZK6	PF00536	424	483	13.263116666666667	59	G5C0K3	428	487	13.243433333333332	59
Q9CZK6	PF12796	38	131	11.353436170212765	93	G5C0K3	39	132	6.375734042553191	93
Q9CZK6	PF13637	135	188	12.478740740740742	53	G5C0K3	136	189	12.452481481481481	53
Q9DCJ5	PF06747	77	111	0.18082857142857145	34	G5AJL4	78	112	0.1986	34
Q80VD1	PF10239	16	330	2.785076190476191	314	G5C7D0	18	304	3.0598850174216032	286
Q2LKU9	PF00619	1091	1171	0.051888888888888894	80	G5BW75	1238	1317	0.4671125000000001	79
Q2LKU9	PF05729	134	300	9.081802395209577	166	G5BW75	327	492	4.599277108433736	165
Q2LKU9	PF13516	690	710	0.0	20	G5BW75	781	801	0.0	20
Q2LKU9	PF13553	819	1071	3.8404743083003954	252	G5BW75	931	1227	8.184262626262624	296
Q2LKU9	PF17776	427	508	5.6673902439024415	81	G5BW75	620	700	13.322222222222221	80
Q2LKU9	PF17779	372	425	1.3073148148148148	53	G5BW75	565	618	10.970851851851853	53
Q9JHL1	PF00595	15	86	2.0252638888888885	71	G5BY49	118	189	0.0	71
Q9JHL1	PF00595	153	226	0.0	73	G5BY49	116	189	0.0	73
Q9JHL1	PF09007	272	336	0.0	64	G5BY49	235	299	0.0	64
Q8BSK8	PF00069	90	351	2.9381068702290096	261	G5C898	91	352	2.9264847328244303	261
Q8BSK8	PF00433	373	412	16.5506	39	G5C898	374	413	18.669175000000006	39
Q8VCF1	PF06079	114	402	6.448522491349482	288	G5AVF7	113	401	6.1538749999999975	288
Q6PE87	PF12018	213	490	7.608406474820138	277	G5B6Y3	214	491	7.0185791366906525	277
Q99K46	PF00443	256	885	2.9577476190476166	629	G5AZG1	255	876	2.306922829581993	621
Q99K46	PF06337	47	132	5.4849302325581375	85	G5AZG1	46	131	6.023267441860464	85
Q99K46	PF14836	151	232	0.4866951219512195	81	G5AZG1	150	231	0.2272682926829268	81
Q8VCW8	PF00501	78	514	5.498160183066361	436	G5C4J8	42	478	3.3547391304347824	436
Q8VCW8	PF13193	523	598	6.638473684210527	75	G5C4J8	487	562	7.538381578947368	75
P26043	PF00373	90	205	9.4848275862069	115	G5C2E0	91	178	12.500670454545455	87
P26043	PF09379	8	69	12.076403225806455	61	G5C2E0	9	70	12.076112903225813	61
P26043	PF09380	209	297	1.2090224719101126	88	G5C2E0	182	270	1.2083146067415729	88
P26043	PF00769	346	582	0.0	236	G5C2E0	319	555	0.0	236
P41969	PF00178	6	85	9.218887499999996	79	G5B0C6	7	86	8.1801875	79
O09110	PF00069	65	324	6.328042307692312	259	G5BKN0	58	331	7.1774525547445265	273
Q9D6J3	PF04502	8	310	0.04021452145214521	302	G5BZA9	9	311	0.3639537953795379	302
Q9CYW4	PF13419	109	209	0.8934752475247522	100	G5B1Z6	265	365	3.2839108910891084	100
O08899	PF00615	61	176	0.21708620689655173	115	G5BPL4	63	178	0.1634224137931035	115
Q61955	PF00089	32	251	1.5349	219	G5BR99	27	235	0.5629282296650717	208
Q9D3D0	PF00650	125	277	8.579660130718953	152	G5BB37	126	278	8.751888888888887	152
Q9D3D0	PF03765	67	101	2.0799142857142856	34	G5BB37	68	102	2.180171428571428	34
Q71FD7	PF00412	184	239	0.017357142857142856	55	G5BRT5	182	237	0.1290892857142857	55
Q71FD7	PF00412	244	300	0.6337543859649123	56	G5BRT5	242	298	0.3027543859649124	56
Q71FD7	PF00412	304	368	1.1754	64	G5BRT5	302	366	1.1698000000000002	64
O88974	PF00856	830	1281	2.7336637168141604	451	G5AJY0	816	1258	2.7898577878103845	442
O88974	PF01429	611	682	0.2823194444444444	71	G5AJY0	597	668	0.2846388888888889	71
O88974	PF05033	699	811	0.07854867256637167	112	G5AJY0	685	797	0.0776725663716814	112
O88974	PF18300	192	249	4.5923620689655165	57	G5AJY0	193	250	4.200689655172414	57
O88974	PF18358	347	396	2.7478599999999997	49	G5AJY0	348	397	2.7475400000000003	49
O88974	PF18359	257	307	24.760686274509805	50	G5AJY0	258	308	24.740490196078444	50
Q07139	PF00533	266	340	2.8706266666666664	74	G5BT69	236	310	2.7060000000000004	74
Q07139	PF00621	455	638	7.157320652173915	183	G5BT69	425	608	7.153375000000005	183
Q07139	PF12738	178	241	12.951671875	63	G5BT69	148	211	9.811265625000008	63
O88559	PF05053	3	497	9.745509090909108	494	G5B6N7	4	503	9.735220000000012	499
O88559	PF05053	548	608	2.1487377049180334	60	G5B6N7	553	613	2.1501311475409843	60
Q8BH70	PF00646	279	318	3.4878249999999995	39	G5AY39	280	319	3.666775	39
Q69ZS0	PF00595	305	334	13.751433333333333	29	G5BD91	1	30	15.688733333333333	29
Q69ZS0	PF00595	425	497	1.7069315068493154	72	G5BD91	121	193	1.8626986301369868	72
Q8BVU0	PF00307	665	753	4.161370786516853	88	G5ALA7	487	575	8.519842696629214	88
Q8BVU0	PF13855	108	139	10.272749999999998	31	G5ALA7	17	48	0.0	31
Q8BVU0	PF13855	177	207	0.0	30	G5ALA7	18	48	0.0	30
D3Z4S3	PF01981	25	138	5.7133333333333365	113	G5CBJ8	26	139	4.871324561403507	113
P09066	PF00046	235	291	0.0356140350877193	56	G5AVD0	132	188	0.03508771929824561	56
P09066	PF10525	292	322	0.0	30	G5AVD0	189	219	0.0	30
Q8BGR5	PF15242	26	302	0.8059061371841155	276	G5BZ29	1	278	1.1168057553956834	277
P70451	PF00017	460	531	9.847805555555553	71	G5AMP2	460	531	9.847597222222218	71
P70451	PF00611	12	84	3.4445342465753424	72	G5AMP2	13	85	2.8776849315068493	72
P70451	PF07714	564	814	6.981820717131474	250	G5AMP2	564	814	4.881752988047805	250
Q9CY18	PF00787	62	145	0.943345238095238	83	G5BEK9	63	146	1.4893809523809525	83
Q8K339	PF10357	51	176	2.983515873015873	125	G5AXV7	52	177	2.9911349206349205	125
Q8K339	PF18131	273	325	1.908377358490566	52	G5AXV7	276	328	4.0552264150943405	52
Q9Z1S0	PF08311	50	172	4.3769593495934975	122	G5BLY2	98	220	3.358674796747968	122
Q8R368	PF04969	7	76	10.2533	69	G5B2P9	8	77	9.624442857142858	69
Q0P523	PF13499	79	145	1.6807611940298504	66	G5C2V5	107	173	1.3006417910447754	66
Q9R0R1	PF00405	22	355	2.907053892215566	333	G5ALD3	26	359	3.1770269461077816	333
Q9R0R1	PF00405	365	703	5.060451327433622	338	G5ALD3	369	706	2.309035502958581	337
Q6IFX3	PF00038	87	398	0.15091346153846158	311	G5AX62	83	394	0.12080128205128207	311
P38060	PF00682	31	305	2.5427781818181807	274	G5BHY0	32	306	2.016789090909091	274
Q920G8	PF00153	72	133	0.9030645161290324	61	G5B9S0	1	62	1.3185806451612905	61
Q920G8	PF00153	142	225	0.29839285714285724	83	G5B9S0	71	154	0.6692500000000003	83
Q920G8	PF00153	231	329	12.145060606060607	98	G5B9S0	160	258	12.488797979797976	98
Q80YT7	PF06758	1503	1568	0.26396969696969697	65	G5BA04	1560	1625	0.2560757575757576	65
Q80YT7	PF07989	7	73	0.08504477611940296	66	G5BA04	8	74	0.08497014925373136	66
Q60790	PF00168	12	113	4.631754901960785	101	G5AVU7	13	114	4.6293725490196085	101
Q60790	PF00168	145	262	1.371135593220339	117	G5AVU7	146	271	1.5754206349206348	125
Q60790	PF00169	581	674	0.7757872340425532	93	G5AVU7	586	679	2.574095744680851	93
Q60790	PF00616	350	418	1.6049420289855063	68	G5AVU7	358	426	1.5121159420289854	68
Q60790	PF00616	421	521	12.730910891089106	100	G5AVU7	429	529	13.42569306930693	100
Q60790	PF00779	685	712	0.0	27	G5AVU7	690	717	0.0	27
B1AVZ0	PF14681	116	294	7.348301675977651	178	G5AMM8	116	294	7.322854748603351	178
Q9WTX5	PF01466	112	159	0.0	47	G5BN11	113	160	0.0	47
Q9WTX5	PF03931	2	66	0.07784615384615384	64	G5BN11	3	67	0.07784615384615384	64
P11103	PF00533	386	460	0.04133333333333333	74	G5BAN6	506	579	0.14155405405405408	73
P11103	PF00644	806	1005	3.8651050000000002	199	G5BAN6	926	1125	5.325429999999998	199
P11103	PF00645	40	86	0.9267021276595744	46	G5BAN6	165	211	0.9207021276595744	46
P11103	PF00645	115	197	0.060361445783132524	82	G5BAN6	240	322	0.0178433734939759	82
P11103	PF02877	661	792	1.9632045454545457	131	G5BAN6	781	912	2.33880303030303	131
P11103	PF05406	552	628	3.918844155844156	76	G5BAN6	672	748	3.30187012987013	76
P11103	PF08063	279	330	0.2827115384615384	51	G5BAN6	404	455	0.4924423076923077	51
Q14B98	PF00169	19	119	9.87159405940594	100	G5BPR3	20	120	6.101346534653465	100
P07934	PF00069	19	287	5.648223048327138	268	G5ASS5	20	288	5.879881040892192	268
Q925I7	PF00341	271	361	0.07437362637362636	90	G5BUD3	282	372	0.07423076923076925	90
Q925I7	PF00431	58	166	6.397385321100918	108	G5BUD3	69	177	1.192137614678899	108
P48776	PF03301	27	371	9.152257971014492	344	G5BLV6	28	372	7.859394202898549	344
Q9QYJ0	PF00226	8	66	0.3338135593220338	58	G5BAE6	9	67	0.3338135593220338	58
Q9QYJ0	PF00684	142	208	0.0	66	G5BAE6	143	209	0.0	66
Q9QYJ0	PF01556	116	141	0.0	25	G5BAE6	117	142	0.0	25
Q9QXU7	PF06607	19	124	3.676028301886792	105	G5AVP8	21	126	3.5314433962264147	105
Q8R2R3	PF10199	154	294	0.25412056737588656	140	G5C5G1	155	294	0.4992428571428572	139
Q8R1F6	PF12722	129	784	11.883057926829267	655	G5BND5	118	773	11.803155487804872	655
Q8K2M0	PF01161	199	278	15.3509375	79	G5BN98	185	264	8.803987500000002	79
Q9D722	PF05604	0	179	0.19677222222222224	179	G5BCW4	1	180	0.036227777777777775	179
Q5SWY7	PF07894	14	307	5.240081632653056	293	G5BKM7	15	305	5.212006872852234	290
Q3V0J4	PF12796	145	211	0.04970149253731344	66	G5B4Z2	99	163	4.726353846153848	64
Q924K1	PF00254	28	88	1.9992622950819667	60	G5BW86	29	89	1.08072131147541	60
A2A591	PF04579	2	97	0.9579375	95	G5B0P7	3	98	2.128968421052632	95
Q8BUH1	PF02966	3	135	8.045248120300748	132	G5B5U7	4	136	8.054804511278194	132
Q08331	PF00036	198	225	18.40817857142857	27	G5C1Q6	199	226	18.40817857142857	27
Q08331	PF13499	20	90	0.03329577464788732	70	G5C1Q6	21	91	0.027746478873239437	70
Q08331	PF13499	110	177	0.07751470588235294	67	G5C1Q6	111	178	0.07751470588235294	67
Q9DBF1	PF00171	63	518	7.499087719298244	455	G5BHU2	64	519	6.199230263157896	455
O70576	PF08514	188	297	4.270472727272726	109	G5AN26	195	304	1.7651090909090923	109
Q6A0D4	PF15250	0	468	2.8592196162046912	468	G5BMH8	1	463	2.7021641468682502	462
Q149L6	PF00226	107	168	1.4097258064516127	61	G5AP65	58	119	1.6471451612903223	61
Q149L6	PF09320	270	370	6.3135346534653465	100	G5AP65	221	321	6.2892475247524775	100
Q8BGN3	PF01663	25	356	5.1776024096385544	331	G5CAL2	26	357	3.687837349397589	331
P12367	PF02197	8	43	0.30280555555555555	35	G5C9G1	9	44	0.17127777777777778	35
P12367	PF00027	156	239	2.2250714285714293	83	G5C9G1	151	234	2.3045476190476193	83
P12367	PF00027	276	367	5.393032608695655	91	G5C9G1	271	362	6.211782608695653	91
Q8R116	PF03283	115	423	5.5932362459546905	308	G5BJ87	55	363	6.5947184466019415	308
Q9DAQ9	PF15212	24	153	0.21733846153846156	129	G5C0D7	25	168	2.4593356643356645	143
Q8JZX4	PF00076	331	386	0.8691607142857141	55	G5BP94	332	387	0.8731071428571425	55
Q8JZX4	PF01585	236	275	0.200475	39	G5BP94	237	276	0.200475	39
Q8CGB3	PF12796	117	198	1.7409878048780485	81	G5C6T7	90	171	1.7440731707317072	81
Q9R0Z9	PF00620	655	799	5.969572413793102	144	G5ANJ0	653	797	5.970089655172412	144
Q9R0Z9	PF01852	889	1084	1.0301428571428577	195	G5ANJ0	887	1082	1.0356632653061226	195
Q9R0Z9	PF07647	16	75	0.15306666666666666	59	G5ANJ0	15	74	0.10523333333333333	59
Q6NZB1	PF13649	88	184	3.67784536082474	96	G5C6Z9	86	182	3.6816907216494825	96
Q8R2U7	PF13516	174	187	0.0	13	G5C9L6	175	188	0.0	13
Q8R2U7	PF13516	200	219	0.0	19	G5C9L6	201	220	0.0	19
Q8R2U7	PF13516	236	250	2.1726	14	G5C9L6	237	251	3.7994	14
Q9CQR4	PF03061	52	126	3.6827333333333336	74	G5BJY7	12	86	13.924933333333328	74
Q9QZ82	PF00067	48	505	3.1792096069869027	457	G5BRG4	53	472	4.991828571428568	419
Q562E2	PF02214	30	78	0.8778979591836734	48	G5C657	199	245	1.8388297872340424	46
Q6P5D8	PF06470	1721	1846	2.487555555555556	125	G5CAX7	1660	1785	2.5402777777777787	125
Q6P5D8	PF13589	142	276	5.999088888888889	134	G5CAX7	82	216	4.1667407407407415	134
Q5NBU5	PF12937	15	57	10.71158139534884	42	G5B915	16	58	10.630767441860462	42
P59913	PF01135	9	220	3.5455094339622635	211	G5BKS0	10	221	3.5405188679245287	211
Q7TPS5	PF00168	2	110	0.367605504587156	108	G5BEG7	3	111	0.3683394495412845	108
Q8CDU5	PF13499	583	644	0.8033225806451609	61	G5B3I8	401	462	3.934499999999999	61
O09113	PF00046	104	160	0.7467719298245614	56	G5ASU9	105	161	0.7467719298245614	56
O09113	PF03826	302	318	0.0	16	G5ASU9	303	319	0.017882352941176467	16
O55135	PF01912	3	203	6.8351791044776125	200	G5B855	4	204	6.717213930348259	200
Q6ZPL9	PF00270	32	211	3.2663444444444414	179	G5AWT6	33	212	3.377633333333335	179
Q6ZPL9	PF00271	252	362	5.907522522522523	110	G5AWT6	253	363	6.026630630630633	110
Q6ZPL9	PF13959	404	462	7.117322033898311	58	G5AWT6	405	463	0.3150677966101694	58
B1AVD1	PF00557	390	574	0.9352054054054052	184	G5AU68	472	678	2.28124154589372	206
B1AVD1	PF01321	52	182	7.476305343511454	130	G5AU68	163	264	1.2840882352941176	101
B1AVD1	PF16188	584	647	0.06353125	63	G5AU68	688	751	1.0072968750000002	63
B1AVD1	PF16189	194	360	11.432718562874253	166	G5AU68	276	442	8.374574850299403	166
Q9JIW5	PF03165	34	134	0.00920792079207921	100	G5B3N2	35	135	0.00920792079207921	100
Q9JIW5	PF03166	233	405	1.4099826589595363	172	G5B3N2	271	443	1.411549132947976	172
O08601	PF01347	28	573	7.349767399267403	545	G5AP62	29	575	6.812188299817184	546
Q8BR63	PF14774	34	147	6.883692982456142	113	G5B114	9	122	6.8919298245614025	113
P97306	PF00130	108	153	0.05489130434782608	45	G5APQ7	108	153	0.054565217391304335	45
P97306	PF07653	349	397	0.017857142857142856	48	G5APQ7	349	398	0.0176	49
P97306	PF14604	292	340	1.981510204081634	48	G5APQ7	292	340	1.3415102040816322	48
P97306	PF16664	166	257	0.0	91	G5APQ7	166	257	0.0	91
P97499	PF00400	1804	1830	2.6922222222222216	26	G5B5Q5	1755	1781	1.846814814814815	26
P97499	PF00400	2060	2096	0.2633783783783784	36	G5B5Q5	2010	2046	0.2347297297297297	36
P97499	PF00400	2106	2141	4.0568888888888885	35	G5B5Q5	2056	2091	3.946944444444444	35
P97499	PF00400	2145	2181	9.024864864864867	36	G5B5Q5	2095	2131	8.938513513513511	36
P97499	PF00400	2240	2271	0.1134375	31	G5B5Q5	2190	2222	0.5695151515151515	32
P97499	PF05386	0	28	0.0	28	G5B5Q5	1	29	0.0	28
P97499	PF05386	30	58	0.0	28	G5B5Q5	1	29	0.0	28
P97499	PF05386	61	88	0.0	27	G5B5Q5	2	29	0.0	27
P97499	PF05386	90	118	0.0	28	G5B5Q5	1	29	0.0	28
P97499	PF05729	1170	1343	11.0505	173	G5B5Q5	1119	1292	9.507591954022985	173
P97499	PF05731	230	684	2.462817582417585	454	G5B5Q5	187	634	4.045792410714286	447
P97499	PF13271	908	1016	4.966302752293578	108	G5B5Q5	857	965	4.332055045871559	108
Q91W67	PF00240	39	91	0.1986603773584905	52	G5BRG6	40	92	0.14994339622641512	52
Q9ER39	PF06309	44	169	8.478603174603176	125	G5ASB7	45	182	7.695528985507246	137
Q9ES00	PF04564	1098	1168	0.009929577464788732	70	G5C532	1221	1300	0.00875	79
Q9ES00	PF10408	461	1082	9.1659807073955	621	G5C532	586	1205	9.307679032258056	619
Q3MI48	PF15312	119	177	16.462389830508474	58	G5BBC5	113	170	17.238862068965517	57
Q9CZU3	PF00270	140	284	8.48905517241379	144	G5C6W9	141	285	8.487510344827585	144
Q9CZU3	PF00271	420	525	1.3789056603773582	105	G5C6W9	421	526	1.3787264150943397	105
Q9CZU3	PF08148	865	1034	9.086705882352943	169	G5C6W9	866	1035	9.604994117647056	169
Q9CZU3	PF13234	579	838	5.585242307692303	259	G5C6W9	580	839	5.50536923076923	259
B1AR13	PF09360	64	84	0.0	20	G5BK61	65	85	0.0	20
B1AR13	PF09360	99	123	0.0956	24	G5BK61	100	124	0.29316	24
Q7TPD0	PF10189	268	492	9.967706666666661	224	G5BER7	223	447	10.189342222222233	224
Q4VGL6	PF18386	270	325	0.37051785714285707	55	G5ARS5	271	326	0.3704821428571427	55
Q4VGL6	PF00642	418	439	0.0	21	G5ARS5	419	440	0.0	21
Q4VGL6	PF13445	13	42	0.0	29	G5ARS5	14	43	0.0	29
Q78PY7	PF00565	48	165	1.7225677966101691	117	G5BHA6	44	161	1.7248474576271189	117
Q78PY7	PF00565	219	326	7.816370370370372	107	G5BHA6	215	322	8.880888888888894	107
Q78PY7	PF00565	367	494	0.6060546874999998	127	G5BHA6	363	490	0.6070156249999998	127
Q78PY7	PF00565	552	658	7.853158878504673	106	G5BHA6	548	654	7.276112149532712	106
Q78PY7	PF00565	847	893	1.2596808510638295	46	G5BHA6	843	889	1.2616170212765956	46
Q78PY7	PF00567	678	796	3.7433697478991603	118	G5BHA6	674	792	4.273218487394957	118
Q8BUR9	PF12554	18	64	1.087808510638298	46	G5BGJ5	24	70	4.748276595744682	46
Q922S8	PF00225	259	582	3.589228395061732	323	G5ARV5	262	585	3.144836419753083	323
O09161	PF01216	4	372	8.439102981029823	368	G5B093	5	372	6.303845108695646	367
Q9DC28	PF00069	25	223	8.136633165829144	198	G5BJA0	1	199	8.139457286432162	198
Q6ZWX6	PF00575	13	87	10.555639999999999	74	G5C7Y2	14	88	10.555639999999999	74
Q6ZWX6	PF07541	130	242	1.2844424778761068	112	G5C7Y2	131	243	1.2844424778761068	112
Q91YK8	PF00021	34	115	5.590841463414633	81	G5AZP2	35	116	5.385987804878049	81
Q91YK8	PF00021	141	223	0.90944578313253	82	G5AZP2	142	224	0.9459518072289156	82
Q61193	PF00617	245	460	4.58737037037037	215	G5BAZ1	195	406	4.362485849056603	211
Q61193	PF00618	91	178	13.15106818181818	87	G5BAZ1	41	128	16.431681818181815	87
Q61193	PF00788	649	734	1.7052790697674418	85	G5BAZ1	595	680	2.193802325581396	85
P47939	PF14948	36	139	12.390192307692304	103	G5AKJ5	37	139	0.10218446601941747	102
Q9CWU6	PF03981	131	266	15.518397058823542	135	G5B853	138	273	14.984786764705888	135
O88282	PF00096	350	372	0.0	22	G5B663	352	374	0.0	22
O88282	PF00096	406	428	0.0	22	G5B663	408	430	0.0	22
O88282	PF00651	27	133	15.010831775700936	106	G5B663	28	134	15.03170093457943	106
Q5RJB0	PF00010	61	112	1.4825961538461538	51	G5BVQ4	66	117	1.9955192307692309	51
Q9QZD8	PF00153	8	90	2.057783132530121	82	G5BJ73	10	91	2.141048780487804	81
Q9QZD8	PF00153	94	187	1.1744468085106383	93	G5BJ73	96	189	1.058670212765957	93
Q9QZD8	PF00153	196	279	11.825202380952382	83	G5BJ73	198	290	18.734612903225802	92
Q9JIZ9	PF03803	66	284	6.681328767123286	218	G5B5B6	66	284	6.589091324200914	218
Q9JHS4	PF07724	285	502	2.7361284403669717	217	G5AN62	285	502	2.7236192660550453	217
Q9JHS4	PF10431	509	582	2.9165675675675686	73	G5AN62	509	582	2.9170405405405417	73
Q3TZX8	PF16575	321	453	11.146616541353382	132	G5C561	174	306	7.0037593984962365	132
Q922V4	PF00400	194	230	0.6773513513513512	36	G5BML0	138	174	0.6947297297297299	36
Q922V4	PF00400	235	272	0.2851842105263159	37	G5BML0	179	216	0.28610526315789475	37
Q922V4	PF00400	277	314	3.2022631578947367	37	G5BML0	221	258	3.2135	37
Q922V4	PF00400	321	356	0.4588333333333334	35	G5BML0	265	300	0.4961666666666667	35
Q922V4	PF00400	404	438	4.0896	34	G5BML0	348	382	3.1488000000000014	34
Q812A2	PF00018	749	794	0.7136304347826087	45	G5BX94	735	780	0.8835869565217392	45
Q812A2	PF00611	30	114	6.636941176470589	84	G5BX94	9	93	6.63590588235294	84
Q812A2	PF00620	519	668	5.7372466666666675	149	G5BX94	509	654	5.853041095890411	145
A2AJT4	PF15996	222	380	3.461220125786165	158	G5BJP0	223	380	3.4445	157
Q07475	PF11092	1	67	6.513477611940299	66	G5C630	1	66	5.013415384615387	65
Q0VBL3	PF00076	179	243	1.9653846153846155	64	G5BD76	137	201	1.9829692307692308	64
Q0VBL3	PF00076	374	442	0.6780579710144926	68	G5BD76	333	401	0.6293913043478259	68
Q0VBL3	PF07744	781	954	6.347666666666666	173	G5BD76	737	910	6.350954022988505	173
Q8VC03	PF00400	298	343	0.05445652173913043	45	G5AYH5	219	264	0.057282608695652174	45
Q8VC03	PF00400	593	625	0.17806060606060606	32	G5AYH5	514	546	0.2276666666666667	32
Q8VC03	PF00400	724	754	0.1320967741935484	30	G5AYH5	645	674	0.9513	29
Q8VC03	PF00400	851	867	2.6224705882352946	16	G5AYH5	446	462	0.0	16
Q8VC03	PF03451	215	284	19.03878571428572	69	G5AYH5	136	205	19.0561	69
Q9ES30	PF00386	118	241	17.085830645161288	123	G5BQ97	192	315	14.18591935483871	123
Q9ES30	PF01391	53	107	0.0	54	G5BQ97	127	181	0.0	54
Q91WB7	PF00240	150	220	9.715690140845073	70	G5C0C1	151	221	9.715690140845073	70
Q91WB7	PF16455	25	126	0.17405882352941182	101	G5C0C1	26	127	0.20000000000000007	101
O54984	PF02374	37	338	5.5734271523178815	301	G5BYX4	38	347	5.430367741935482	309
Q91W43	PF01212	590	733	1.8366250000000004	143	G5AY62	538	681	1.8478055555555557	143
Q91W43	PF02347	69	492	5.813257075471699	423	G5AY62	17	440	5.071332547169813	423
A2AWT3	PF08209	79	111	0.0	32	G5BIZ4	80	112	0.0	32
A2AWT3	PF08313	206	236	0.06019354838709678	30	G5BIZ4	214	244	0.04951612903225806	30
Q9QZB7	PF00022	11	382	7.113322580645169	371	G5C0A4	12	383	7.1138198924731135	371
Q9CQ71	PF08661	4	94	6.619153846153845	90	G5BRY8	5	94	1.7999888888888889	89
Q0VGM9	PF06733	110	270	3.012217391304348	160	G5C8C4	111	271	2.934863354037267	160
Q0VGM9	PF13307	544	729	2.6648817204301083	185	G5C8C4	539	724	2.794704301075268	185
Q3U5C7	PF00412	125	184	14.341416666666666	59	G5C3N0	126	185	10.556450000000002	59
Q3U5C7	PF00412	190	243	0.0	53	G5C3N0	191	244	0.0	53
Q3U5C7	PF00412	250	303	0.0	53	G5C3N0	251	304	0.0	53
Q3U5C7	PF06297	30	114	0.8491176470588233	84	G5C3N0	31	115	0.8513529411764709	84
Q9WVL2	PF00017	575	646	0.4263333333333333	71	G5BB74	538	609	8.27663888888889	71
Q9WVL2	PF01017	140	306	0.9128622754491014	166	G5BB74	142	306	1.1107151515151517	164
Q9WVL2	PF02864	347	454	10.572777777777775	107	G5BB74	317	418	7.039254901960782	101
Q9WVL2	PF02865	1	120	4.543441666666669	119	G5BB74	2	122	6.2490082644628115	120
Q9WVL2	PF12188	858	907	0.0	49	G5BB74	741	792	0.0	51
Q9WTP2	PF05210	164	276	2.7619469026548686	112	G5AQR8	197	309	1.7962743362831861	112
Q8K1N4	PF07139	80	370	0.3790240549828179	290	G5AU19	91	381	0.4803092783505154	290
Q64700	PF01857	830	1011	7.301637362637362	181	G5BQB8	836	1019	6.746228260869563	183
Q64700	PF01858	413	605	5.983409326424872	192	G5BQB8	419	611	10.022606217616579	192
Q64700	PF11934	101	235	12.690740740740743	134	G5BQB8	107	241	12.696592592592593	134
Q91ZD6	PF09816	16	112	4.334247422680413	96	G5B951	17	113	4.341876288659794	96
Q3U276	PF05347	8	61	1.5780740740740744	53	G5BK16	9	62	1.5031666666666668	53
Q91VH2	PF00018	5	53	1.4014285714285717	48	G5B2S3	2	50	1.331836734693877	48
Q91VH2	PF00787	274	355	0.8354390243902442	81	G5B2S3	270	351	0.8347439024390245	81
Q91VH2	PF10456	357	591	3.1531489361702127	234	G5B2S3	353	587	3.2726510638297874	234
Q3UXZ9	PF00628	294	340	5.7186170212765965	46	G5BWQ1	295	341	4.5012127659574475	46
Q3UXZ9	PF00628	1162	1216	0.0084	54	G5BWQ1	1163	1217	0.0056	54
Q3UXZ9	PF01388	87	169	0.5449518072289157	82	G5BWQ1	88	170	0.5217831325301204	82
Q3UXZ9	PF02373	469	585	9.95118803418803	116	G5BWQ1	470	586	9.264119658119652	116
Q3UXZ9	PF02375	19	52	0.25779411764705884	33	G5BWQ1	20	53	0.25779411764705884	33
Q3UXZ9	PF02928	675	727	5.14022641509434	52	G5BWQ1	676	728	5.221169811320753	52
Q3UXZ9	PF08429	740	1071	0.2672048192771083	331	G5BWQ1	741	1072	0.2965542168674698	331
P59114	PF00397	45	74	0.0	29	G5B7P9	96	125	0.0	29
P59114	PF12237	444	619	5.30502840909091	175	G5B7P9	450	625	5.30125	175
Q9Z1A9	PF00566	507	709	20.20156157635468	202	G5B797	498	722	18.708173333333345	224
Q9Z1A9	PF02893	145	247	17.036398058252423	102	G5B797	136	238	17.367592233009706	102
Q9Z1A9	PF02893	285	394	3.9381	109	G5B797	276	385	3.382	109
Q62189	PF00076	17	87	11.556577464788733	70	G5C9W9	12	82	11.323830985915492	70
Q62189	PF00076	214	276	5.7536507936507935	62	G5C9W9	210	272	4.77	62
P54843	PF03131	270	347	0.001858974358974359	77	G5B1Y2	129	206	0.011794871794871795	77
P54843	PF08383	86	118	0.39596969696969697	32	G5B1Y2	87	119	0.405060606060606	32
P58467	PF00856	172	271	10.04806	99	G5AM14	182	282	13.888663366336644	100
P58467	PF09273	309	423	0.3787826086956523	114	G5AM14	320	434	6.320739130434783	114
Q3UTH8	PF00169	333	421	6.237359550561798	88	G5C641	129	217	6.242067415730338	88
Q3UTH8	PF00621	205	284	4.1243875	79	G5C641	1	80	4.15645	79
Q8BMI4	PF00752	0	92	5.747021505376344	92	G5AZB3	1	93	6.066537634408602	92
Q8BMI4	PF00867	122	207	10.418744186046512	85	G5AZB3	123	208	10.295	85
Q8BMI4	PF18704	396	456	3.6263606557377046	60	G5AZB3	397	455	6.183508474576273	58
Q91XF0	PF01243	76	152	8.582467532467533	76	G5BY20	147	256	5.9699909090909085	109
Q91XF0	PF10590	205	260	0.5974285714285713	55	G5BY20	309	364	1.385363636363636	55
Q5SSF7	PF07984	16	334	4.369341692789969	318	G5B2R5	18	336	4.502347962382443	318
Q9CR30	PF02099	18	166	10.238127516778524	148	G5B8S9	19	167	9.900214765100673	148
P62918	PF00181	12	89	0.6745641025641026	77	G5C5Q8	13	90	0.6771282051282052	77
P62918	PF03947	97	223	3.8025748031496067	126	G5C5Q8	98	224	3.8025748031496067	126
P51807	PF03645	16	110	10.697252631578944	94	G5BCM4	17	111	10.732263157894737	94
Q9QUG9	PF00130	498	549	3.936692307692309	51	G5B6P1	493	544	3.913942307692308	51
Q9QUG9	PF00617	156	333	7.501792134831464	177	G5B6P1	151	328	7.4963932584269655	177
Q9QUG9	PF00618	9	101	0.2873548387096774	92	G5B6P1	10	96	0.4231724137931035	86
Q9QUG9	PF13499	431	483	4.211679245283018	52	G5B6P1	426	478	5.235566037735849	52
Q8CEF1	PF12796	87	177	3.061538461538462	90	G5B458	88	178	3.1622967032967044	90
Q8CEF1	PF12796	180	236	0.5285087719298245	56	G5B458	181	237	0.5285087719298245	56
Q8CEF1	PF13606	39	67	0.1363793103448276	28	G5B458	40	68	0.0	28
Q8CEF1	PF13857	513	565	5.426094339622642	52	G5B458	514	566	4.191490566037737	52
Q8VDN4	PF14916	6	54	0.7920612244897959	48	G5AWU2	43	91	1.1152653061224496	48
Q5XJY5	PF00928	269	495	0.24934361233480176	226	G5BHM2	247	473	0.25045814977973563	226
Q5XJY5	PF01217	23	129	7.834046728971964	106	G5BHM2	1	107	7.834644859813082	106
Q9D7J4	PF12597	17	96	14.612887499999996	79	G5AM32	3	82	14.5057	79
Q8CAY6	PF00108	7	265	4.566436293436292	258	G5BC68	8	266	2.1842162162162158	258
Q8CAY6	PF02803	273	395	6.838430894308939	122	G5BC68	274	396	6.494341463414638	122
Q14BP6	PF13516	102	125	0.0	23	G5C036	104	127	0.0	23
Q14BP6	PF13516	137	153	1.4321764705882354	16	G5C036	139	155	0.07794117647058824	16
Q14BP6	PF13516	187	202	0.0	15	G5C036	189	204	0.044625000000000005	15
Q14BP6	PF13516	215	234	0.013	19	G5C036	189	207	0.037578947368421066	18
Q14BP6	PF13516	243	264	14.42636363636364	21	G5C036	230	251	26.130590909090916	21
Q14BP6	PF13516	271	282	0.0	11	G5C036	258	268	0.0	10
Q14BP6	PF13516	307	320	2.153357142857143	13	G5C036	284	297	0.7417142857142858	13
Q8BL48	PF18384	33	72	0.06930000000000001	39	G5BNA3	34	73	0.066225	39
Q8BL48	PF00642	293	317	0.61092	24	G5BNA3	294	318	0.63468	24
Q8CFJ7	PF00153	2	79	26.103141025641023	77	G5B6K8	3	80	22.8235	77
Q8CFJ7	PF00153	96	189	10.321659574468084	93	G5B6K8	97	190	11.475872340425527	93
Q8CFJ7	PF00153	200	285	23.04806976744186	85	G5B6K8	201	286	13.40518604651163	85
Q6TXD4	PF00018	7	52	7.487434782608695	45	G5AYP2	8	53	8.06795652173913	45
Q6TXD4	PF00018	249	294	0.4855217391304348	45	G5AYP2	250	295	1.5408260869565218	45
Q6TXD4	PF00621	786	967	2.4055604395604395	181	G5AYP2	792	969	2.4793707865168537	177
Q6TXD4	PF03114	1000	1207	3.363745192307692	207	G5AYP2	1031	1238	2.0598894230769242	207
Q6TXD4	PF07653	70	123	6.538111111111111	53	G5AYP2	71	124	4.3000740740740735	53
Q6TXD4	PF14604	157	200	7.083772727272727	43	G5AYP2	158	201	8.94759090909091	43
Q6TXD4	PF14604	1522	1573	8.463884615384616	51	G5AYP2	1541	1592	6.52971153846154	51
Q8R197	PF00975	55	249	7.147784615384617	194	G5C5D9	107	300	4.634386597938144	193
Q9CWW6	PF13616	32	103	0.01729166666666667	71	G5BGW4	33	103	0.017535211267605634	70
Q9JIL5	PF01167	1432	1540	10.182743119266052	108	G5B967	977	1085	10.317477064220185	108
P11416	PF00104	227	398	11.545970930232556	171	G5BRW0	320	491	11.285674418604653	171
P11416	PF00105	86	154	0.00956521739130435	68	G5BRW0	84	152	0.00963768115942029	68
Q9DBU5	PF13639	612	654	0.5827209302325582	42	G5AMX7	622	664	0.4719767441860465	42
Q9D805	PF00648	42	334	4.0962935153583615	292	G5BQI6	43	335	3.595911262798632	292
Q9D805	PF01067	355	485	5.312526717557254	130	G5BQI6	356	486	6.646908396946566	130
Q8VE97	PF00076	3	63	0.05868852459016394	60	G5AP99	4	64	0.05893442622950821	60
Q8VE97	PF00076	105	170	0.018545454545454542	65	G5AP99	106	171	0.012393939393939393	65
A2AQ14	PF03226	70	176	3.5984579439252347	106	G5BM11	76	182	1.367504672897195	106
Q8VCE2	PF03029	23	261	8.975393305439331	238	G5C2Z5	24	239	9.52075925925926	215
Q60829	PF05395	35	172	0.0	137	G5BRW9	127	272	0.0	145
Q06986	PF03145	122	318	8.032446700507613	196	G5C0Z2	64	260	8.06815228426396	196
P97469	PF00096	128	150	0.0	22	G5BHT1	128	150	0.0	22
P97469	PF00096	159	181	0.5543043478260871	22	G5BHT1	159	181	0.5543913043478261	22
P97469	PF00096	186	207	0.0	21	G5BHT1	186	207	0.0	21
P97469	PF00096	213	235	0.0	22	G5BHT1	213	235	0.0	22
P97469	PF00096	241	259	0.0	18	G5BHT1	241	259	0.0	18
Q80YR6	PF08573	822	853	0.0	31	G5BTR4	819	850	0.0	31
Q80YR6	PF10482	19	138	0.017175000000000006	119	G5BTR4	20	139	0.017266666666666666	119
Q8VHQ9	PF01852	385	546	7.701401234567902	161	G5BTW6	393	554	7.103160493827166	161
Q8VHQ9	PF03061	68	134	0.3138656716417912	66	G5BTW6	75	141	0.6266119402985073	66
Q8VHQ9	PF03061	234	303	0.9775857142857138	69	G5BTW6	242	311	0.9677714285714286	69
Q9JI38	PF01416	212	329	6.21327118644068	117	G5BB54	180	297	5.674847457627117	117
Q99MN9	PF01039	59	538	4.898758333333333	479	G5C835	58	565	5.977096456692919	507
Q8R2H9	PF06888	27	217	3.5993560209424107	190	G5C4N9	10	199	3.213710526315789	189
Q9Z268	PF00168	5	100	5.1634166666666665	95	G5AKW2	6	100	5.213736842105263	94
Q9Z268	PF00168	134	232	0.05949494949494949	98	G5AKW2	195	293	0.0691919191919192	98
Q9Z268	PF00169	615	670	0.6732500000000001	55	G5AKW2	613	668	0.34391071428571424	55
Q9Z268	PF00616	320	508	4.3815661375661366	188	G5AKW2	382	570	7.589666666666668	188
Q9Z268	PF00779	679	708	0.04116666666666667	29	G5AKW2	677	706	0.13106666666666664	29
Q9R0M3	PF00084	59	111	0.0	52	G5BMQ4	1	53	0.0	52
Q9R0M3	PF00084	119	173	0.010454545454545456	54	G5BMQ4	61	115	0.0	54
Q9R0M3	PF00084	261	316	0.0	55	G5BMQ4	203	258	0.0	55
Q9R0M3	PF02494	174	256	0.11419277108433736	82	G5BMQ4	116	198	0.3874819277108433	82
Q9R0M3	PF13778	332	450	9.17531932773109	118	G5BMQ4	274	392	11.662915966386562	118
P70339	PF05350	182	232	0.3957647058823529	50	G5C0A7	43	92	0.40796	49
Q8BG87	PF12851	992	1667	0.7285266272189347	675	G5AXG8	1047	1721	0.6747655786350147	674
Q2WG77	PF14998	63	134	0.05018055555555556	71	G5C3Z1	1	52	0.018846153846153846	51
A8C756	PF10350	941	1238	6.631610738255032	297	G5AL89	915	1212	8.024419463087247	297
P02772	PF00273	31	197	6.086970059880241	166	G5B5P1	32	202	7.030432748538009	170
P02772	PF00273	217	388	6.533180232558139	171	G5B5P1	222	393	7.445587209302326	171
P02772	PF00273	409	587	5.037016759776537	178	G5B5P1	414	592	5.852731843575419	178
Q9Z2B9	PF00069	34	300	4.4981310861423225	266	G5B6P5	35	301	4.380670411985017	266
Q9Z2B9	PF00069	415	673	5.2103667953667925	258	G5B6P5	416	674	5.209590733590733	258
Q9Z2B9	PF00433	321	360	0.24535	39	G5B6P5	322	361	0.284325	39
Q6WKZ7	PF00611	13	87	1.00968	74	G5C8R2	14	88	1.476373333333333	74
Q6WKZ7	PF14604	444	492	0.7698979591836733	48	G5C8R2	445	493	0.15944897959183674	48
Q91WN1	PF00226	14	78	7.18163076923077	64	G5C7G3	15	79	6.368323076923076	64
Q91V51	PF03133	58	361	4.726779605263157	303	G5BM79	59	362	4.689105263157893	303
Q9JIY2	PF18408	160	191	6.9030312500000015	31	G5C2C8	277	308	6.908999999999999	31
Q9WUN2	PF00069	12	229	5.4901788990825695	217	G5ARJ7	13	230	5.674247706422019	217
Q9WUN2	PF18394	399	654	2.814535156249999	255	G5ARJ7	400	655	3.718519531250003	255
Q9WUN2	PF18396	307	394	1.9258749999999996	87	G5ARJ7	308	395	9.509818181818183	87
Q9ER88	PF10236	91	386	3.7104155405405423	295	G5ARB4	98	393	3.902790540540544	295
Q3UMF9	PF17171	263	325	0.5948253968253967	62	G5BJN8	264	327	0.5803125	63
Q3UMF9	PF17172	116	210	8.776842105263157	94	G5BJN8	117	211	8.776726315789473	94
Q9D0M1	PF13793	28	125	9.29191836734694	97	G5AQV1	1	98	9.312989795918364	97
Q9D0M1	PF14572	166	349	5.442679347826092	183	G5AQV1	139	322	5.44126086956522	183
Q99JR8	PF02201	309	377	8.790420289855074	68	G5BDI8	321	389	8.799101449275359	68
Q9CRA5	PF05719	92	272	4.225138121546961	180	G5AKD1	1	181	3.8772762430939234	180
Q80UW3	PF02204	411	512	15.555598039215687	101	G5AMA3	436	536	13.574128712871284	100
Q8BGA7	PF14964	1	379	8.53170976253298	378	G5BF45	2	381	8.49446315789473	379
Q8K2V1	PF02985	212	242	0.2611612903225807	30	G5C063	170	200	0.32677419354838705	30
Q8K2V1	PF02985	252	277	0.809923076923077	25	G5C063	210	235	0.904	25
Q99PP6	PF00622	346	468	4.490073170731708	122	G5BS55	307	429	13.988715447154467	122
Q99PP6	PF00643	92	127	16.76302777777778	35	G5BS55	94	129	12.14913888888889	35
Q99PP6	PF13445	14	55	0.01678571428571429	41	G5BS55	15	57	0.4032558139534884	42
P40646	PF00505	79	112	0.0	33	G5AMG5	125	158	0.0	33
P40646	PF12067	174	226	0.0	52	G5AMG5	223	276	0.0	53
P09056	PF01291	43	202	8.2890375	159	G5APV6	41	200	8.419729559748431	159
Q6NXK5	PF00782	80	198	1.5846890756302514	118	G5AXH2	82	200	0.6273613445378152	118
Q923Q2	PF00620	676	819	5.544590277777778	143	G5BB51	609	752	8.554090277777783	143
Q923Q2	PF01852	910	1097	0.8657606382978724	187	G5BB51	843	990	1.0689324324324323	147
Q923Q2	PF07647	71	119	0.06587755102040815	48	G5BB51	5	53	2.165734693877551	48
Q8BZW2	PF12796	586	667	1.2294390243902442	81	G5BJQ2	572	653	1.708524390243902	81
Q5M6W3	PF13838	307	363	9.157649122807015	56	G5B8W3	297	354	9.55589655172414	57
Q5M6W3	PF15739	28	151	6.169508064516128	123	G5B8W3	29	141	8.260743362831862	112
P23249	PF13086	499	568	2.6667	69	G5BNW4	450	519	2.512257142857142	69
P23249	PF13086	610	690	10.383283950617287	80	G5BNW4	561	641	10.408506172839514	80
P23249	PF13087	700	922	4.873515695067264	222	G5BNW4	651	873	4.905713004484305	222
Q9QZN1	PF12937	320	366	0.1419148936170213	46	G5BAR8	90	136	0.1031489361702128	46
Q9QZN1	PF13516	618	638	0.6522857142857142	20	G5BAR8	235	255	17.35380952380952	20
Q9QYB8	PF00596	135	316	1.2573021978021983	181	G5B4Y6	136	317	1.408175824175824	181
Q923D5	PF09429	11	91	0.0032469135802469136	80	G5BV52	12	92	0.006493827160493827	80
P70396	PF00046	137	193	0.07821052631578948	56	G5BLD2	143	199	0.08871929824561399	56
P70396	PF12413	31	94	0.0	63	G5BLD2	32	94	0.0	62
P56183	PF05997	62	218	3.912038216560511	156	G5BG21	1	157	7.097503184713378	156
P56389	PF00383	15	116	2.853715686274509	101	G5C4W6	16	117	3.348960784313725	101
Q9CQX0	PF10275	2	228	6.738726872246692	226	G5AXJ1	3	229	6.0052466960352415	226
Q8CGF7	PF00397	136	161	0.1158846153846154	25	G5BTG3	304	329	0.0	25
Q8CGF7	PF00397	435	461	0.0	26	G5BTG3	303	329	0.0	26
Q8CGF7	PF01846	664	710	0.1874468085106383	46	G5BTG3	532	578	0.1900212765957447	46
Q8CGF7	PF01846	728	777	0.10614	49	G5BTG3	596	645	0.21504	49
Q8CGF7	PF01846	795	844	0.0	49	G5BTG3	663	712	0.0	49
Q8CGF7	PF01846	899	950	0.0	51	G5BTG3	767	818	0.0	51
Q8CGF7	PF01846	957	1008	0.5104615384615384	51	G5BTG3	825	876	0.5172692307692307	51
Q8CGF7	PF01846	1016	1075	8.227116666666667	59	G5BTG3	884	943	9.856983333333334	59
Q80VM7	PF00023	184	214	1.6820967741935484	30	G5BZB1	186	216	1.6963225806451614	30
Q80VM7	PF12796	89	181	1.6430000000000005	92	G5BZB1	91	183	1.21647311827957	92
Q9CZN7	PF00464	48	447	2.7607150000000007	399	G5BEE1	95	494	2.6545825	399
A2RSQ0	PF01477	941	1041	6.394118811881187	100	G5BLL9	911	1011	5.47171287128713	100
A2RSQ0	PF02141	186	373	5.1788351063829765	187	G5BLL9	156	343	5.353234042553191	187
A2RSQ0	PF02759	779	923	0.6770896551724138	144	G5BLL9	749	893	1.1952827586206896	144
A2RSQ0	PF02759	1126	1261	6.5877573529411775	135	G5BLL9	1096	1231	5.4378088235294095	135
A2RSQ0	PF03455	540	591	4.355673076923076	51	G5BLL9	510	561	4.356653846153846	51
A2RSQ0	PF03456	77	118	17.125047619047617	41	G5BLL9	47	88	19.561380952380947	41
P70348	PF03615	29	166	2.3715217391304333	137	G5C1F4	30	167	2.3307536231884063	137
Q9Z130	PF00076	31	98	8.238073529411768	67	G5ALN7	71	138	8.203367647058826	67
Q9Z130	PF00076	115	175	8.463606557377048	60	G5ALN7	155	215	8.426819672131149	60
Q64737	PF00551	808	987	7.47261111111112	179	G5BE86	809	988	7.3673555555555525	179
Q64737	PF00586	489	591	1.7705533980582526	102	G5BE86	490	591	0.7439411764705883	101
Q64737	PF01071	104	297	3.5604432989690733	193	G5BE86	105	298	3.649948453608248	193
Q64737	PF02769	606	775	4.512423529411765	169	G5BE86	607	776	5.943247058823526	169
Q64737	PF02843	333	423	11.121813186813188	90	G5BE86	334	424	9.889494505494502	90
Q64737	PF02844	3	103	1.3964455445544546	100	G5BE86	4	104	7.081633663366338	100
Q9WV30	PF00554	281	436	4.35996153846154	155	G5AK40	300	455	4.357551282051282	155
Q9WV30	PF16179	445	543	8.879262626262625	98	G5AK40	464	562	8.880202020202024	98
Q9DC70	PF01058	98	207	9.803609090909095	109	G5AZK8	92	201	9.790609090909092	109
P98064	PF00084	305	366	0.8617903225806448	61	G5BTD5	301	395	1.8757368421052631	94
P98064	PF00084	371	436	0.2870151515151516	65	G5BTD5	400	465	0.7628181818181822	65
P98064	PF00089	453	695	5.344078189300412	242	G5BTD5	483	744	4.2137862595419815	261
P98064	PF00431	28	139	2.103008928571428	111	G5BTD5	24	135	1.884723214285714	111
P98064	PF00431	189	298	0.6509363636363635	109	G5BTD5	185	294	1.1460454545454548	109
Q61012	PF00631	9	72	0.012109375	63	G5ANK5	10	73	0.025859375	63
Q8K1N1	PF01734	438	632	7.312117948717949	194	G5C0C9	447	641	6.5890615384615385	194
Q61508	PF05782	0	558	1.9311860465116275	558	G5BH40	1	584	2.7004511149228128	583
Q8R3F5	PF00698	63	332	5.4847518518518505	269	G5BM81	63	321	6.418884169884168	258
A2APC3	PF03133	73	389	2.2003880126182978	316	G5BR03	71	348	3.0631690647482013	277
Q9D7S7	PF01776	10	115	0.40452830188679256	105	G5BT61	20	125	0.4163679245283021	105
Q6PKN7	PF15142	11	186	0.006818181818181818	175	G5BW93	1	178	0.003932584269662922	177
Q7TPY9	PF16297	24	131	6.962759259259259	107	G5AS24	25	131	10.245056074766357	106
Q9JMA2	PF01702	27	379	3.360716713881025	352	G5BUH7	29	381	3.8827762039660016	352
Q9DB94	PF00400	236	268	0.20163636363636364	32	G5ALC2	237	269	2.4613636363636355	32
G3X912	PF10263	46	153	5.1346481481481465	107	G5BQJ4	35	142	5.409111111111108	107
A2A7Y5	PF15734	51	378	1.9573749999999992	327	G5C500	51	375	0.11420000000000002	324
P21619	PF00038	89	378	0.023737931034482747	289	G5BZC1	291	577	0.020536585365853656	286
P21619	PF00932	445	548	3.2680000000000002	103	G5BZC1	651	754	3.114721153846156	103
Q6PDH0	PF00169	1262	1358	10.122072164948452	96	G5BHM3	1255	1362	15.755129629629634	107
Q9D868	PF00160	17	155	2.0586187050359714	138	G5AQI4	18	155	2.082797101449276	137
Q8CH18	PF02037	633	664	0.0	31	G5B800	637	668	0.0	31
Q8CH18	PF14443	475	597	3.0300406504065034	122	G5B800	479	601	3.0287479674796747	122
Q8CH18	PF14444	143	200	6.489086206896551	57	G5B800	147	204	7.392344827586207	57
O88888	PF00595	393	473	5.3289382716049385	80	G5BBD8	397	464	6.404073529411763	67
O88888	PF00595	500	550	6.199725490196079	50	G5BBD8	491	542	1.0874038461538462	51
O88888	PF00640	217	354	4.047478260869565	137	G5BBD8	218	355	10.350014492753619	137
Q80X66	PF16017	167	272	4.441424528301887	105	G5C7T0	168	273	4.440867924528302	105
Q922H1	PF06325	251	325	6.5608266666666655	74	G5AR24	278	352	6.9274133333333365	74
Q9D0W5	PF00160	13	161	7.477778523489934	148	G5B538	14	162	6.979973154362417	148
Q9CQA8	PF14933	33	155	3.984048780487805	122	G5ALC6	1	122	2.2459426229508197	121
Q01730	PF13855	40	97	1.9814137931034488	57	G5BFE7	7	64	1.3147241379310342	57
Q01730	PF13855	134	191	1.7995862068965516	57	G5BFE7	101	158	0.9114827586206902	57
Q8VHI6	PF02205	436	461	5.073653846153847	25	G5AMX5	470	495	5.139038461538462	25
E9Q634	PF00018	1055	1099	0.9408888888888891	44	G5AWC9	1057	1101	0.9414444444444444	44
E9Q634	PF00063	20	678	4.7694385432473485	658	G5AWC9	21	679	4.770274658573596	658
E9Q634	PF06017	718	919	2.121772277227723	201	G5AWC9	719	920	1.8204108910891084	201
Q9ESX5	PF01472	296	369	21.70816216216216	73	G5C0D3	478	551	21.69229729729729	73
Q9ESX5	PF01509	109	225	9.875794871794877	116	G5C0D3	291	407	9.912264957264952	116
Q9ESX5	PF08068	48	105	2.6854310344827583	57	G5C0D3	230	287	3.99951724137931	57
Q9ESX5	PF16198	226	292	2.8886716417910447	66	G5C0D3	408	474	2.8504925373134333	66
Q684R7	PF00059	2126	2188	0.18406349206349207	62	G5AP58	1805	1867	6.103142857142857	62
Q684R7	PF03160	1760	1846	2.6559195402298847	86	G5AP58	1501	1587	3.694172413793104	86
Q684R7	PF16184	305	381	10.813532467532472	76	G5AP58	1	77	12.032051948051945	76
Q684R7	PF16184	402	507	8.568896226415097	105	G5AP58	98	203	13.075905660377359	105
Q684R7	PF16184	509	621	15.284106194690269	112	G5AP58	205	317	11.080486725663722	112
Q684R7	PF16184	789	893	0.9254285714285718	104	G5AP58	466	570	0.6369238095238094	104
Q684R7	PF16184	897	1008	11.31525	111	G5AP58	574	684	8.639090090090093	110
Q684R7	PF16184	1035	1152	0.4311525423728813	117	G5AP58	712	829	8.149059322033896	117
Q684R7	PF16184	1156	1274	5.439159663865545	118	G5AP58	833	957	9.098736	124
Q684R7	PF16184	1280	1391	4.099892857142858	111	G5AP58	963	1074	9.219535714285714	111
Q684R7	PF16184	1399	1505	10.747121495327097	106	G5AP58	1082	1184	13.335262135922324	102
Q684R7	PF16184	1508	1614	6.2849439252336445	106	G5AP58	1187	1294	4.442055555555556	107
Q684R7	PF16184	1637	1742	5.6704528301886805	105	G5AP58	1378	1483	6.89088679245283	105
Q3TIR1	PF06159	64	297	3.1443418803418792	233	G5B0E8	50	277	3.2901754385964916	227
Q8CHR9	PF08190	34	159	5.346309523809521	125	G5CAZ7	35	160	5.90724603174603	125
Q8CHR9	PF18201	234	313	0.9728750000000002	79	G5CAZ7	235	314	1.4653	79
P20918	PF00024	26	95	0.3251857142857144	69	G5BC53	27	96	1.1362714285714284	69
P20918	PF00051	102	180	0.013924050632911394	78	G5BC53	103	181	0.03367088607594937	78
P20918	PF00051	184	261	0.2925641025641026	77	G5BC53	185	262	0.2744230769230769	77
P20918	PF00051	274	351	0.7472820512820514	77	G5BC53	275	352	1.3769230769230765	77
P20918	PF00051	376	453	0.015897435897435898	77	G5BC53	377	454	0.02730769230769231	77
P20918	PF00051	480	559	0.04425	79	G5BC53	513	603	0.3344175824175824	90
P20918	PF00089	581	804	1.9569464285714275	223	G5BC53	624	821	2.080616161616161	197
Q9D289	PF04051	7	151	6.051462068965515	144	G5C813	8	123	7.211655172413794	115
P49722	PF00227	30	211	6.788236263736263	181	G5BJZ6	31	212	6.7854010989011	181
P49722	PF10584	5	27	3.9245217391304346	22	G5BJZ6	6	28	4.447652173913044	22
Q8VCB3	PF05693	31	659	6.628166931637518	628	G5BEG0	32	659	6.561673566878982	627
Q06649	PF00017	463	535	9.292931506849316	72	G5BCH2	635	707	9.275616438356169	72
Q06649	PF00169	28	126	0.7007070707070706	98	G5BCH2	92	190	0.5514444444444445	98
Q91WA1	PF07962	62	141	0.0	79	G5AN83	65	144	0.0	79
Q63871	PF03604	16	47	0.65946875	31	G5ANZ3	17	48	0.44009375	31
P61979	PF00013	44	102	0.17967796610169492	58	G5ARM9	45	103	0.17169491525423727	58
P61979	PF00013	146	209	8.695093750000002	63	G5ARM9	147	210	8.810953125	63
P61979	PF00013	388	451	4.219093750000001	63	G5ARM9	389	452	4.1680937500000015	63
P61979	PF08067	0	42	0.014023255813953488	42	G5ARM9	1	43	0.02444186046511628	42
P19426	PF00076	272	326	3.5804	54	G5C3H2	231	285	3.513927272727273	54
Q6P566	PF14954	10	257	5.125233870967743	247	G5C339	11	258	5.508423387096777	247
P57725	PF07647	244	301	0.2681551724137931	57	G5B4Q1	313	370	2.8610862068965512	57
P57725	PF07653	166	218	11.676886792452832	52	G5B4Q1	235	287	12.176584905660373	52
P57725	PF12485	19	163	0.0	144	G5B4Q1	88	232	0.0	144
Q8BHN1	PF09728	137	443	2.2475309446254084	306	G5B0F3	101	407	2.232260586319217	306
P56375	PF00708	17	103	0.7400229885057472	86	G5BK48	11	97	1.1294482758620692	86
Q5SUV2	PF14646	184	600	3.2360263788968817	416	G5C4K0	140	576	4.994405034324948	436
Q64261	PF00069	12	299	6.499590277777778	287	G5C9J5	13	300	6.502854166666666	287
Q8BKI2	PF10427	957	1094	0.0	137	G5AYW3	922	1059	0.0	137
Q8BKI2	PF16608	1342	1621	0.0	279	G5AYW3	1360	1639	0.0002	279
P50543	PF00036	54	78	2.2050400000000003	24	G5B8K6	57	81	1.91152	24
P50543	PF01023	4	46	12.269674418604653	42	G5B8K6	7	49	14.379209302325576	42
P11152	PF00151	29	337	3.7756116504854407	308	G5ARE8	30	338	3.4792880258899666	308
P11152	PF01477	342	462	5.8598760330578505	120	G5ARE8	343	463	5.4541652892562045	120
Q8BMF3	PF00390	113	294	5.057230769230772	181	G5B521	57	238	5.0228131868131864	181
Q8BMF3	PF03949	304	556	11.861999999999995	252	G5B521	248	500	11.465675889328065	252
Q9JL25	PF00615	84	198	2.9787913043478262	114	G5ASG9	85	199	4.818878260869563	114
Q9JL10	PF06031	44	78	14.777114285714285	34	G5C9X8	49	83	14.185085714285714	34
Q5SX79	PF08687	518	794	3.1134548736462118	276	G5ASQ3	346	624	3.210806451612904	278
Q5SX79	PF08688	203	238	0.0	35	G5ASQ3	16	50	0.0	34
Q925I1	PF00004	346	470	7.6839439999999986	124	G5ATP4	409	533	7.639559999999999	124
Q925I1	PF12037	39	284	5.541284552845529	245	G5ATP4	41	286	5.5498414634146345	245
Q9CWG9	PF10046	43	137	0.3667473684210527	94	G5B0S9	43	137	0.3775157894736842	94
Q7M759	PF12146	89	195	4.913242990654204	106	G5AVG6	106	212	4.903429906542057	106
A2AQP0	PF00063	86	772	8.027314410480358	686	G5C6I8	87	773	8.265299854439592	686
A2AQP0	PF01576	851	1929	0.05619925857275256	1078	G5C6I8	852	1930	0.07714828544949026	1078
A2AQP0	PF02736	31	71	0.0	40	G5C6I8	32	72	0.0	40
P28650	PF00709	63	453	1.7574936061381108	390	G5AWI5	1	391	1.80353452685422	390
P63034	PF00169	260	374	2.9797130434782617	114	G5B887	269	382	3.0232894736842097	113
P63034	PF01369	61	242	6.718565934065933	181	G5B887	70	251	6.91204945054945	181
A2AE20	PF00062	21	142	0.6371639344262292	121	G5AXP3	22	141	0.5065798319327729	119
O08537	PF00104	283	480	8.140893939393939	197	G5BCZ8	284	486	9.271305418719207	202
O08537	PF00105	147	215	0.08015942028985504	68	G5BCZ8	148	216	0.06843478260869566	68
O08537	PF12497	11	124	0.15099122807017545	113	G5BCZ8	12	125	0.1087280701754386	113
Q9CYK2	PF04389	122	354	4.193180257510731	232	G5BZ86	81	313	5.772618025751072	232
Q9DBT9	PF01266	44	406	2.4325950413223145	362	G5ASU2	18	380	4.216887052341598	362
Q9DBT9	PF01571	473	736	1.1245757575757585	263	G5ASU2	447	710	1.1017916666666672	263
Q9DBT9	PF08669	762	839	7.521448717948718	77	G5ASU2	736	813	6.079743589743591	77
Q9DBT9	PF16350	409	462	0.01768518518518519	53	G5ASU2	383	436	0.017499999999999998	53
A1L3T7	PF15903	18	362	2.6182695652173913	344	G5AZ01	22	366	2.074553623188406	344
Q9Z0H3	PF04855	179	247	0.0746231884057971	68	G5B642	180	248	0.0746231884057971	68
Q9Z0H3	PF04855	254	372	6.228848739495798	118	G5B642	255	373	6.228848739495798	118
Q9R1P0	PF00227	29	214	4.757602150537634	185	G5AUK3	30	215	4.736747311827958	185
Q9R1P0	PF10584	4	26	0.0	22	G5AUK3	5	27	0.0	22
Q8BJQ4	PF13676	78	185	7.134388888888887	107	G5B459	231	338	7.739870370370372	107
Q8R5F7	PF18119	522	691	0.7923176470588237	169	G5AKB3	523	693	3.877421052631578	170
Q8R5F7	PF00271	706	824	4.104218487394959	118	G5AKB3	708	826	5.956638655462187	118
Q8R5F7	PF04851	306	491	7.1280967741935495	185	G5AKB3	307	492	7.604500000000005	185
Q8R5F7	PF11648	903	1017	2.2292173913043483	114	G5AKB3	905	1019	4.863182608695652	114
Q8R5F7	PF16739	10	96	6.645413793103446	86	G5AKB3	11	98	0.4872840909090909	87
Q8R5F7	PF16739	110	198	2.1233258426966297	88	G5AKB3	112	200	3.800134831460675	88
Q9D8T2	PF17708	287	458	6.596918604651163	171	G5AWF6	288	459	5.120988372093024	171
Q9D8T2	PF04598	3	242	1.244508333333333	239	G5AWF6	4	242	6.045096234309622	238
P47930	PF00170	121	180	0.11785	59	G5C2Y9	122	181	0.4948166666666667	59
P08074	PF13561	13	236	4.917401785714284	223	G5BJ93	14	231	5.963954128440367	217
Q99L13	PF03446	40	198	1.9803899371069185	158	G5BD58	7	165	2.0467924528301884	158
Q99L13	PF14833	201	327	4.580133858267716	126	G5BD58	168	294	8.375188976377956	126
P70195	PF00227	40	220	5.648524861878452	180	G5B6W7	41	221	4.995977900552483	180
P70195	PF12465	234	270	1.0598108108108106	36	G5B6W7	235	271	1.0632162162162162	36
Q60847	PF00041	25	101	6.5349740259740265	76	G5ALL2	232	308	5.114350649350649	76
Q60847	PF00041	335	414	1.761775	79	G5ALL2	542	621	1.6921500000000005	79
Q60847	PF00041	633	708	4.466592105263158	75	G5ALL2	840	915	4.65821052631579	75
Q60847	PF00041	725	800	0.12835526315789472	75	G5ALL2	932	1007	0.0	75
Q60847	PF00041	815	892	2.5016794871794867	77	G5ALL2	1022	1099	4.109820512820511	77
Q60847	PF00041	906	985	2.5979625000000004	79	G5ALL2	1113	1192	2.4346250000000005	79
Q60847	PF00041	1001	1073	0.0738904109589041	72	G5ALL2	1208	1280	0.07395890410958904	72
Q60847	PF00041	1088	1162	1.7679866666666666	74	G5ALL2	1295	1369	1.76752	74
Q60847	PF00041	1386	1459	7.1858918918918935	73	G5ALL2	1593	1666	7.075378378378378	73
Q60847	PF00041	1478	1547	1.743485714285714	69	G5ALL2	1685	1754	0.7662142857142857	69
Q60847	PF00041	1566	1644	0.9958354430379748	78	G5ALL2	1773	1851	4.745354430379746	78
Q60847	PF00041	1655	1727	0.2568904109589041	72	G5ALL2	1862	1934	0.26357534246575337	72
Q60847	PF00041	1756	1834	3.364556962025316	78	G5ALL2	1963	2041	1.1239620253164555	78
Q60847	PF00041	1848	1925	0.9064743589743588	77	G5ALL2	2055	2132	3.6034615384615387	77
Q60847	PF00041	1939	2017	5.233835443037975	78	G5ALL2	2146	2224	10.182797468354432	78
Q60847	PF00041	2028	2106	8.104721518987343	78	G5ALL2	2235	2313	10.660696202531645	78
Q60847	PF00041	2119	2193	0.14578666666666665	74	G5ALL2	2326	2400	0.07325333333333335	74
Q60847	PF00041	2208	2282	6.839586666666667	74	G5ALL2	2415	2489	6.577333333333333	74
Q60847	PF00092	139	309	15.183596491228073	170	G5ALL2	346	516	14.963093567251455	170
Q60847	PF00092	439	607	8.516881656804737	168	G5ALL2	646	814	8.510313609467461	168
Q60847	PF00092	1198	1368	7.688485380116964	170	G5ALL2	1405	1575	7.968187134502928	170
Q60847	PF00092	2324	2495	12.325558139534891	171	G5ALL2	2531	2702	12.323680232558145	171
Q60847	PF01391	2748	2799	0.0	51	G5ALL2	2955	3006	0.0	51
Q60847	PF01391	2803	2853	0.0	50	G5ALL2	3010	3060	0.0	50
Q60847	PF01391	2846	2898	0.0	52	G5ALL2	3053	3105	0.0	52
Q60847	PF01391	2948	2991	0.0	43	G5ALL2	3155	3198	0.0	43
Q00422	PF00178	320	399	2.0082125	79	G5BQQ3	370	449	1.938925	79
Q00422	PF02198	170	249	7.798724999999997	79	G5BQQ3	220	299	7.817474999999996	79
Q00422	PF11620	36	117	1.2280975609756095	81	G5BQQ3	86	167	1.2258780487804881	81
Q64133	PF01593	23	459	6.716624713958813	436	G5BPF6	1	437	5.354993135011443	436
Q8K2I4	PF02836	342	566	4.7353200000000015	224	G5BXA5	285	509	5.140782222222222	224
Q8K2I4	PF17753	800	877	5.322410256410256	77	G5BXA5	743	819	0.23870129870129875	76
Q8K2I4	PF17786	700	794	19.387378947368415	94	G5BXA5	643	737	5.206084210526316	94
O35626	PF00071	25	191	3.9558742514970064	166	G5BMW3	26	192	3.9680598802395206	166
Q8R216	PF02146	58	263	1.3703689320388357	205	G5B780	62	267	2.1484271844660188	205
Q80U19	PF02181	595	1015	4.137247030878859	420	G5B9E6	596	968	4.6416836461125985	372
Q80U19	PF06367	230	433	4.462627450980391	203	G5B9E6	231	434	4.725357843137254	203
Q80U19	PF06371	42	227	2.4886827956989253	185	G5B9E6	43	228	2.2323010752688184	185
Q9CUL5	PF00004	593	707	5.002930434782608	114	G5AY47	573	687	5.108347826086957	114
O70370	PF00112	122	337	3.721541666666666	215	G5BH45	115	329	1.6495906976744192	214
O70370	PF08246	35	94	0.025133333333333337	59	G5BH45	28	87	0.0	59
P17426	PF01602	30	587	8.061894265232981	557	G5B8Q7	31	588	8.047695340501804	557
P17426	PF02296	863	971	0.6134495412844037	108	G5B8Q7	859	967	0.6090275229357797	108
P17426	PF02883	750	851	1.4690980392156856	101	G5B8Q7	738	847	10.76087272727273	109
Q8BKF1	PF00940	801	1206	3.2581650246305407	405	G5C5W3	813	1213	5.1111749999999985	400
Q8BKF1	PF14700	386	674	3.7467785467128016	288	G5C5W3	403	688	4.231653846153846	285
Q9CW79	PF01465	682	723	6.6371190476190485	41	G5B6W1	680	721	6.611619047619048	41
Q8C8N2	PF12070	64	556	9.396405679513194	492	G5B6W0	55	513	8.647324618736372	458
O55225	PF00094	138	287	6.8116266666666645	149	G5BNQ2	129	278	7.504506666666666	149
O55225	PF00094	500	654	3.0426967741935487	154	G5BNQ2	491	645	3.0467935483870945	154
O55225	PF00094	972	1117	5.007972602739724	145	G5BNQ2	948	1093	13.48168493150685	145
O55225	PF00094	2097	2250	7.966623376623372	153	G5BNQ2	2024	2177	5.675876623376622	153
O55225	PF01826	766	830	0.022692307692307692	64	G5BNQ2	757	821	0.03192307692307692	64
O55225	PF05270	1291	1380	0.14953333333333332	89	G5BNQ2	1292	1381	7.576722222222228	89
O55225	PF08742	336	399	0.0	63	G5BNQ2	327	390	0.0	63
O55225	PF08742	699	758	0.06916666666666668	59	G5BNQ2	690	748	0.09144067796610167	58
O55225	PF08742	1159	1221	4.646666666666665	62	G5BNQ2	1135	1196	4.479741935483872	61
O55225	PF08742	2294	2354	13.16395081967213	60	G5BNQ2	2221	2281	13.041163934426224	60
Q8C5D8	PF02891	341	389	0.2695714285714285	48	G5C616	334	382	0.2648163265306123	48
Q8C5D8	PF14324	145	296	4.8944868421052625	151	G5C616	138	289	4.881434210526316	151
Q01320	PF00204	264	424	6.668254658385093	160	G5AX78	230	390	8.286111801242235	160
Q01320	PF00521	711	1167	2.446824945295404	456	G5AX78	677	1135	2.8561002178649217	458
Q01320	PF01751	454	556	4.040854368932038	102	G5AX78	420	522	4.017165048543689	102
Q01320	PF02518	77	222	2.577767123287672	145	G5AX78	78	188	2.66918018018018	110
Q01320	PF08070	1430	1517	0.0	87	G5AX78	1395	1482	0.0	87
Q01320	PF16898	571	709	2.7546618705035977	138	G5AX78	537	675	2.7659856115107915	138
Q8C0L6	PF01593	54	488	4.831600000000002	434	G5AVA5	1	434	5.153914746543783	433
Q91UZ4	PF13640	120	211	15.977250000000002	91	G5BG39	121	212	16.972130434782613	91
Q8R0K9	PF02319	18	82	4.055923076923077	64	G5C650	19	83	4.047153846153845	64
Q8R0K9	PF16421	99	194	2.120375	95	G5C650	100	201	2.338490196078431	101
P52760	PF01042	12	127	2.2819655172413777	115	G5B8Y4	13	128	5.125275862068966	115
Q9D7R7	PF00026	74	389	9.643895569620254	315	G5BNI3	74	389	8.190047468354432	315
Q9D7R7	PF07966	18	45	0.030214285714285718	27	G5BNI3	19	46	0.0	27
P08414	PF00069	49	295	5.076566801619434	246	G5C627	1	247	5.044202429149799	246
Q9CYH6	PF04939	31	192	0.10851851851851853	161	G5AQP2	32	193	0.14970987654320986	161
Q9D5S7	PF00625	416	597	3.490170329670331	181	G5BFL7	396	577	2.886686813186813	181
Q9D5S7	PF14580	232	373	7.061422535211268	141	G5BFL7	212	353	6.936915492957747	141
Q9DCM7	PF00651	19	115	16.530577319587632	96	G5B6C0	20	116	16.522845360824746	96
Q9DCM7	PF10523	373	429	5.318789473684212	56	G5B6C0	379	435	5.317192982456142	56
P33215	PF00400	43	59	8.265117647058824	16	G5C0S1	71	87	5.6734117647058815	16
P33215	PF00400	80	104	0.17740000000000006	24	G5C0S1	108	132	2.05872	24
P33215	PF00400	112	140	0.9952068965517241	28	G5C0S1	140	168	0.3772413793103448	28
P48025	PF00017	13	90	4.220282051282052	77	G5C2H4	14	91	1.8486025641025636	77
P48025	PF00017	166	242	1.3099740259740265	76	G5C2H4	167	243	4.9266233766233745	76
P48025	PF07714	368	616	2.646610441767066	248	G5C2H4	368	616	2.8268554216867483	248
Q8CEE7	PF00106	38	238	7.3938009950248755	200	G5CBH2	27	227	7.158149253731347	200
Q9D565	PF00400	492	527	2.55236111111111	35	G5BL25	490	525	4.553916666666665	35
Q8VC23	PF15464	0	114	0.0	114	G5B035	1	106	0.0	105
P53668	PF00412	24	78	0.026272727272727267	54	G5BG88	7	60	0.0	53
P53668	PF00412	83	139	7.363263157894738	56	G5BG88	66	122	10.026596491228073	56
P53668	PF00595	165	253	0.7416741573033708	88	G5BG88	148	236	0.8092696629213482	88
P53668	PF07714	340	601	5.190889312977099	261	G5BG88	322	578	5.311583657587551	256
Q8K1S6	PF16474	85	210	0.6518730158730162	125	G5APH4	84	210	0.6408976377952751	126
Q810V0	PF04006	20	653	0.135776025236593	633	G5B6I1	21	654	0.10453943217665614	633
Q3THK3	PF05793	4	507	1.0895297619047617	503	G5C4F6	5	513	0.787496062992126	508
Q9QYK7	PF13639	97	138	0.4284523809523811	41	G5C861	98	139	0.4284523809523811	41
B2RWW0	PF00620	100	246	11.269306122448974	146	G5BCL9	135	281	7.988748299319727	146
Q8VDM4	PF01851	442	477	3.3905000000000003	35	G5BTC4	443	478	4.015944444444443	35
Q8VDM4	PF01851	479	511	7.48551515151515	32	G5BTC4	480	512	7.4635454545454545	32
Q8VDM4	PF17781	55	353	3.7027692307692317	298	G5BTC4	56	354	3.7133645484949858	298
Q8VDM4	PF18051	852	905	3.6152407407407416	53	G5BTC4	855	908	3.614314814814815	53
P35584	PF00250	118	203	8.529279069767442	85	G5AUY3	118	203	8.530023255813957	85
P35584	PF08430	15	117	0.00616504854368932	102	G5AUY3	16	117	0.006176470588235295	101
P18181	PF07686	30	114	0.0	84	G5BWJ6	11	94	1.579797619047619	83
P18181	PF13895	132	200	0.03998550724637681	68	G5BWJ6	114	182	0.2943333333333334	68
Q9CPY6	PF09783	38	205	6.2563154761904745	167	G5BMX0	19	186	6.174005952380954	167
P81117	PF13499	246	321	0.0	75	G5B0I6	247	322	0.0	75
Q99MR0	PF00022	7	424	1.869468899521532	417	G5BBZ7	8	425	1.869468899521532	417
Q8C0Q9	PF00610	83	115	22.18351515151515	32	G5AMI5	1	33	23.62633333333333	32
Q8C0Q9	PF00617	581	756	8.066261363636364	175	G5AMI5	503	678	8.117318181818185	175
Q8C0Q9	PF00618	304	398	11.904536842105268	94	G5AMI5	222	320	13.751717171717171	98
P60605	PF00179	12	157	5.33259589041096	145	G5BMF6	1	146	5.325773972602738	145
Q07079	PF00086	190	261	1.2245972222222226	71	G5C2K5	191	262	1.2214444444444446	71
Q07079	PF00219	25	78	0.011944444444444443	53	G5C2K5	26	79	0.011666666666666669	53
P61148	PF00167	27	147	0.19705785123966946	120	G5AQR9	28	148	0.21181818181818188	120
Q8BX32	PF01541	10	81	20.595166666666678	71	G5BRC5	14	84	20.118774647887324	70
Q9CSN1	PF02731	174	334	0.3455527950310559	160	G5AW38	198	358	0.3452981366459627	160
P13705	PF00488	845	1047	10.25063546798029	202	G5BK74	829	1030	11.641371287128715	201
P13705	PF01624	187	298	0.6510803571428573	111	G5BK74	161	272	0.1702142857142857	111
P13705	PF05188	323	479	6.4343248407643285	156	G5BK74	303	459	8.711496815286626	156
P13705	PF05192	497	792	4.257645270270273	295	G5BK74	477	775	3.68216722408027	298
Q4G0F8	PF08729	117	166	0.09976000000000003	49	G5B2M1	118	167	0.09966	49
Q4G0F8	PF14075	353	572	2.80785909090909	219	G5B2M1	354	573	2.2139999999999995	219
Q3TQB2	PF01266	75	455	5.627700787401578	380	G5AXW7	76	455	5.91514736842105	379
Q8BW10	PF08772	250	322	0.9720684931506848	72	G5AK38	262	334	3.6671095890410954	72
Q8BW10	PF15017	153	202	3.88828	49	G5AK38	154	214	7.195967213114753	60
Q8BW10	PF17146	6	92	4.035252873563218	86	G5AK38	7	93	4.232264367816092	86
Q3UP24	PF05729	163	309	10.161176870748298	146	G5B3Y4	150	295	12.063760273972607	145
Q3UP24	PF17889	464	578	2.2498434782608707	114	G5B3Y4	451	565	2.1791130434782606	114
Q3UP24	PF00619	14	86	1.6962739726027405	72	G5B3Y4	1	73	6.95528767123288	72
P49290	PF03098	145	689	3.3461321100917427	544	G5BJT2	145	687	3.044068139963168	542
B8ZXI1	PF01702	12	413	4.2691393034825875	401	G5AL37	13	366	4.5584039548022615	353
Q9D3A8	PF00640	31	168	5.588021739130436	137	G5BU44	32	169	5.604398550724637	137
Q9CQJ2	PF08190	30	184	4.550090322580647	154	G5B8N8	31	185	4.482851612903227	154
Q9CQJ2	PF18201	215	284	0.0021142857142857144	69	G5B8N8	216	285	0.0	69
Q60953	PF00643	132	169	0.0	37	G5BRF9	127	164	0.0	37
Q60953	PF12126	243	578	1.5140833333333332	335	G5BRF9	239	565	1.356605504587156	326
Q9Z184	PF03068	282	660	1.4466068601583113	378	G5BZN3	284	667	2.272239583333333	383
Q9Z184	PF08526	0	112	11.1199203539823	112	G5BZN3	1	114	11.315912280701756	113
Q9Z184	PF08527	114	272	3.806427672955974	158	G5BZN3	116	274	3.3255597484276738	158
Q24JP3	PF14816	30	324	11.578145762711866	294	G5BMU5	150	441	8.549708904109586	291
Q64205	PF00046	129	185	0.009912280701754386	56	G5C4I4	279	335	0.009912280701754386	56
Q64205	PF12413	26	94	0.0	68	G5C4I4	157	224	0.0	67
Q9D4V0	PF01633	73	274	0.3596188118811881	201	G5BEH0	162	363	0.2606831683168316	201
Q91ZT5	PF00169	423	519	6.874195876288662	96	G5BSI2	422	518	6.8741546391752575	96
Q91ZT5	PF00169	657	735	10.943481012658227	78	G5BSI2	656	734	11.995240506329115	78
Q91ZT5	PF00621	209	390	0.08399450549450553	181	G5BSI2	208	389	0.0781978021978022	181
Q91ZT5	PF01363	554	617	0.21634375	63	G5BSI2	553	616	0.22671875	63
Q8JZM0	PF00398	29	277	0.387281124497992	248	G5BQ74	66	366	2.27779069767442	300
Q62181	PF01403	56	492	4.6335125858123565	436	G5BVU4	57	493	4.723121281464533	436
Q62181	PF07679	589	660	0.22431944444444446	71	G5BVU4	590	661	0.02933333333333335	71
Q9D9W1	PF07004	144	160	0.0	16	G5BNY0	120	136	0.0	16
Q6PDS3	PF07647	409	473	0.07627692307692309	64	G5BVN9	410	474	0.016307692307692308	64
Q6PDS3	PF07647	480	544	0.32072307692307683	64	G5BVN9	481	545	0.3115076923076923	64
Q6PDS3	PF13676	563	686	11.681798387096775	123	G5BVN9	564	687	11.237629032258072	123
A2AMT1	PF00038	81	187	4.592121495327104	106	G5CBA0	47	153	1.8169719626168224	106
Q3MI99	PF01391	247	291	0.0	44	G5AMR5	396	440	0.0	44
Q3MI99	PF14670	138	174	0.09945945945945947	36	G5AMR5	287	323	0.2803243243243243	36
Q9D6J6	PF01257	61	207	5.588306122448978	146	G5C059	45	191	5.5949659863945564	146
Q9Z2V6	PF00850	694	1012	6.403498432601881	318	G5BN73	1170	1500	6.877694864048336	330
Q9Z2V6	PF12203	66	131	0.1931515151515152	65	G5BN73	419	483	0.17215384615384616	64
Q9DCJ9	PF00701	7	300	5.285738095238092	293	G5BE43	8	270	4.803342205323196	262
Q9D8Y8	PF12998	10	106	0.37473195876288656	96	G5C3S4	46	142	0.3519896907216495	96
P47876	PF00086	188	263	0.6871315789473684	75	G5BIM4	187	262	0.6840921052631578	75
P47876	PF00219	31	82	0.0	51	G5BIM4	32	82	0.0	50
Q8BKX1	PF07653	378	431	3.0387777777777782	53	G5BJ57	644	723	5.088487500000001	79
Q8BKX1	PF08397	16	236	1.5471719457013575	220	G5BJ57	257	477	1.6482398190045249	220
P49222	PF00868	4	122	2.222025210084034	118	G5BM42	48	166	8.584142857142858	118
P49222	PF00927	474	571	4.620785714285713	97	G5BM42	622	718	7.103546391752579	96
P49222	PF00927	587	684	4.617846938775512	97	G5BM42	735	832	1.3500204081632652	97
P49222	PF01841	254	348	13.131578947368428	94	G5BM42	402	496	14.046189473684215	94
Q8BGU2	PF00386	93	220	7.980312500000001	127	G5BGS6	94	221	8.028875000000001	127
P28654	PF01462	47	74	0.0	27	G5BSJ6	54	81	0.0	27
P28654	PF13855	78	135	5.3632586206896535	57	G5BSJ6	85	142	5.992965517241379	57
P28654	PF13855	144	206	1.0166825396825396	62	G5BSJ6	151	213	0.4963809523809524	62
P28654	PF13855	216	275	0.20986666666666665	59	G5BSJ6	223	282	0.3092833333333333	59
Q6IR34	PF02188	493	514	0.09236363636363636	21	G5B6B7	506	527	0.09236363636363636	21
Q6IR34	PF02188	546	566	0.0	20	G5B6B7	559	579	0.0	20
Q6IR34	PF02188	594	614	8.566238095238095	20	G5B6B7	607	627	8.581380952380952	20
Q6IR34	PF02188	628	649	10.809	21	G5B6B7	641	662	10.823681818181818	21
Q6IR34	PF13424	105	160	0.10875	55	G5B6B7	133	188	0.11330357142857145	55
Q6IR34	PF13424	183	237	0.11307272727272732	54	G5B6B7	211	265	0.11338181818181815	54
Q6IR34	PF13424	246	307	0.1647741935483871	61	G5B6B7	274	334	0.6533442622950819	60
E9PV24	PF00147	551	784	2.0247222222222234	233	G5BML2	574	807	1.882017094017095	233
E9PV24	PF08702	49	189	0.008475177304964537	140	G5BML2	42	180	0.008525179856115108	138
E9PV24	PF12160	391	456	0.584060606060606	65	G5BML2	385	452	0.011323529411764706	67
O88513	PF07412	0	178	0.0	178	G5BJZ0	116	298	0.0	182
Q2VPA6	PF00270	307	463	9.86836942675159	156	G5AT13	314	470	9.158216560509553	156
Q2VPA6	PF00271	525	670	6.126602739726028	145	G5AT13	532	677	5.7972602739726025	145
Q7TSD4	PF15256	131	315	4.5427513513513516	184	G5B1A2	95	273	5.232871508379887	178
Q9D5L7	PF00622	97	219	7.220341463414634	122	G5C541	98	220	7.227398373983742	122
Q8BVW0	PF01055	317	752	4.11884633027523	435	G5BM27	346	780	4.470735632183909	434
Q8BVW0	PF13802	206	275	6.827857142857144	69	G5BM27	235	304	8.174214285714287	69
Q9D483	PF05645	145	343	2.4364170854271365	198	G5BBM2	146	345	1.7827449999999994	199
Q9D483	PF08221	6	66	4.9047540983606535	60	G5BBM2	7	67	7.961901639344263	60
Q91VX5	PF06312	59	251	6.9482124352331605	192	G5C4P4	94	287	6.728585492227979	193
P98084	PF00595	569	651	9.562542168674696	82	G5B6I3	572	654	9.559060240963856	82
P98084	PF00595	663	731	0.7199275362318842	68	G5B6I3	666	734	0.7179710144927535	68
P98084	PF00640	372	530	5.578924528301886	158	G5B6I3	375	533	5.27194968553459	158
Q6NZA9	PF02291	9	129	6.703256198347107	120	G5BKT7	10	130	6.701363636363636	120
Q8VEH8	PF07915	110	198	0.05489887640449438	88	G5B8U7	73	154	0.031646341463414634	81
Q8VEH8	PF07915	341	420	2.6795250000000004	79	G5B8U7	297	376	2.7218375	79
O08532	PF00092	252	417	7.85119277108434	165	G5B0R2	61	226	7.84969277108434	165
O08532	PF08473	644	1071	4.074983644859811	427	G5B0R2	457	884	4.041427570093456	427
Q91ZQ1	PF00233	560	805	11.065800813008131	245	G5BE84	526	742	9.940207373271896	216
Q91ZQ1	PF01590	76	223	11.833094594594591	147	G5BE84	77	224	11.39140540540541	147
Q91ZQ1	PF01590	275	431	11.44335031847133	156	G5BE84	239	397	6.1943647798742125	158
Q80YQ8	PF10607	153	295	8.609657342657346	142	G5AQ08	107	249	8.614370629370624	142
P70325	PF00907	73	254	3.1219670329670315	181	G5BAX4	72	253	3.123675824175823	181
Q8K3A4	PF15319	0	232	1.0821888412017169	232	G5AS15	1	236	0.15969067796610162	235
Q9R0X2	PF01421	216	410	7.263661538461544	194	G5BYB2	189	384	7.311438775510203	195
Q9R0X2	PF01562	43	169	0.7694094488188976	126	G5BYB2	15	141	0.7164409448818899	126
Q9DBJ6	PF02099	30	174	9.838848275862073	144	G5AYT6	31	175	9.8388	144
Q641K5	PF00069	79	306	7.923298245614034	227	G5C462	135	362	7.92877192982456	227
P04370	PF01669	146	236	0.14184615384615387	90	G5C0K7	326	444	0.1112941176470588	118
Q8VC57	PF02214	45	133	2.2314269662921347	88	G5AQC6	46	134	2.420696629213483	88
Q61555	PF00683	230	255	0.4066538461538461	25	G5AJK4	1281	1305	0.28312	24
Q61555	PF00683	373	417	0.0	44	G5AJK4	57	101	0.0	44
Q61555	PF00683	707	751	0.0044888888888888895	44	G5AJK4	398	442	0.06184444444444445	44
Q61555	PF00683	898	929	0.0	31	G5AJK4	589	620	0.0	31
Q61555	PF00683	1003	1047	0.08742222222222222	44	G5AJK4	694	738	0.08715555555555557	44
Q61555	PF00683	1585	1628	0.2787954545454545	43	G5AJK4	1276	1319	0.2642727272727273	43
Q61555	PF00683	1740	1784	0.0	44	G5AJK4	1431	1475	0.0	44
Q61555	PF00683	2104	2149	0.0	45	G5AJK4	1795	1840	0.0	45
Q61555	PF00683	2390	2432	0.0	42	G5AJK4	2079	2121	0.0	42
Q61555	PF07645	275	315	0.0	40	G5AJK4	1333	1373	0.0	40
Q61555	PF07645	317	357	0.5488048780487804	40	G5AJK4	1	41	0.7759999999999999	40
Q61555	PF07645	527	565	0.0	38	G5AJK4	218	256	0.0	38
Q61555	PF07645	567	607	0.0	40	G5AJK4	258	298	0.0	40
Q61555	PF07645	760	800	0.0	40	G5AJK4	451	491	0.0	40
Q61555	PF07645	802	842	0.0	40	G5AJK4	493	533	0.0	40
Q61555	PF07645	844	874	0.0	30	G5AJK4	535	565	0.0057419354838709686	30
Q61555	PF07645	947	985	0.0	38	G5AJK4	638	676	0.0	38
Q61555	PF07645	1065	1105	0.0	40	G5AJK4	756	796	0.0	40
Q61555	PF07645	1107	1140	0.0	33	G5AJK4	798	831	0.009558823529411764	33
Q61555	PF07645	1150	1190	0.0	40	G5AJK4	841	881	0.0	40
Q61555	PF07645	1192	1232	0.02207317073170732	40	G5AJK4	883	923	0.02207317073170732	40
Q61555	PF07645	1317	1357	0.01707317073170732	40	G5AJK4	1008	1048	0.016829268292682928	40
Q61555	PF07645	1359	1394	0.0	35	G5AJK4	1050	1085	0.0	35
Q61555	PF07645	1400	1439	0.0	39	G5AJK4	1091	1130	0.0	39
Q61555	PF07645	1441	1481	0.0	40	G5AJK4	1132	1172	0.0	40
Q61555	PF07645	1483	1522	1.141175	39	G5AJK4	1174	1213	1.137825	39
Q61555	PF07645	1524	1563	0.0	39	G5AJK4	1215	1254	0.0	39
Q61555	PF07645	1642	1679	0.0	37	G5AJK4	1333	1370	0.0	37
Q61555	PF07645	1684	1724	0.0	40	G5AJK4	1375	1415	0.0	40
Q61555	PF07645	1800	1835	0.0	35	G5AJK4	1491	1526	0.09705555555555556	35
Q61555	PF07645	1842	1879	0.0	37	G5AJK4	1533	1570	0.0	37
Q61555	PF07645	1884	1924	0.0	40	G5AJK4	1575	1615	0.0	40
Q61555	PF07645	1926	1962	0.0	36	G5AJK4	1617	1653	0.0	36
Q61555	PF07645	1965	2006	0.024285714285714285	41	G5AJK4	1656	1697	0.02416666666666667	41
Q61555	PF07645	2008	2046	0.0	38	G5AJK4	1699	1737	0.0	38
Q61555	PF07645	2048	2088	0.27517073170731704	40	G5AJK4	1739	1779	0.2741951219512196	40
Q61555	PF07645	2163	2198	0.0	35	G5AJK4	1854	1889	0.0	35
Q61555	PF07645	2205	2239	0.07528571428571429	34	G5AJK4	1896	1930	0.075	34
Q61555	PF07645	2246	2284	0.7862820512820512	38	G5AJK4	1935	1973	0.7667948717948717	38
Q61555	PF07645	2286	2328	2.0702790697674422	42	G5AJK4	1975	2017	2.066093023255814	42
Q61555	PF07645	2330	2370	0.10243902439024392	40	G5AJK4	2019	2059	0.1021219512195122	40
Q61555	PF07645	2441	2481	0.027195121951219512	40	G5AJK4	2130	2170	0.02707317073170732	40
Q61555	PF07645	2483	2522	0.0	39	G5AJK4	2172	2211	0.0	39
Q61555	PF07645	2524	2561	0.8941052631578945	37	G5AJK4	2213	2250	0.8915000000000001	37
Q61555	PF07645	2563	2604	0.0	41	G5AJK4	2252	2293	0.0	41
Q61555	PF07645	2606	2644	0.0	38	G5AJK4	2295	2333	0.0	38
Q61555	PF07645	2646	2685	0.0	39	G5AJK4	2335	2374	0.0	39
Q61555	PF07645	2687	2718	0.0	31	G5AJK4	2376	2407	0.0	31
Q61555	PF12661	497	517	0.0	20	G5AJK4	188	208	0.0	20
Q61555	PF12662	630	653	0.07979166666666666	23	G5AJK4	321	344	0.07958333333333334	23
Q61555	PF12662	1255	1278	0.0	23	G5AJK4	946	969	0.0	23
Q8CIS0	PF00619	22	107	5.8430930232558165	85	G5BPW3	16	101	5.843034883720933	85
Q3UHC2	PF00069	1245	1517	4.583340659340657	272	G5ARZ1	1251	1523	4.2636776556776566	272
Q3UHC2	PF08477	639	760	14.251401639344266	121	G5ARZ1	645	766	15.375065573770495	121
Q3UHC2	PF12796	90	180	11.276956043956046	90	G5ARZ1	92	186	6.245136842105262	94
Q3UHC2	PF13855	379	420	0.0	41	G5ARZ1	385	426	0.066	41
Q3UHC2	PF16095	843	1035	2.80178238341969	192	G5ARZ1	849	1041	2.1439015544041458	192
Q8VIG1	PF13909	298	322	0.0	24	G5BW68	282	305	0.0	23
Q8BIQ3	PF00096	169	190	0.0	21	G5APT3	176	197	0.0	21
Q8BIQ3	PF00096	196	218	0.0	22	G5APT3	203	225	0.0	22
Q8BIQ3	PF00096	224	246	0.0	22	G5APT3	231	253	0.0	22
Q8BIQ3	PF00096	252	274	0.0	22	G5APT3	259	281	0.0	22
Q8BIQ3	PF00096	280	302	0.0	22	G5APT3	287	309	0.0	22
Q8BIQ3	PF00096	308	330	0.8079999999999998	22	G5APT3	315	337	0.35269565217391297	22
Q8BIQ3	PF00096	336	358	0.0	22	G5APT3	343	365	0.0	22
Q8BIQ3	PF00096	364	386	0.0	22	G5APT3	371	393	0.0	22
Q8BIQ3	PF00096	392	413	0.0	21	G5APT3	399	420	0.0	21
Q8BIQ3	PF01352	13	53	1.270048780487805	40	G5APT3	4	44	10.299804878048779	40
Q9R109	PF02100	145	231	8.467252873563218	86	G5B8L1	86	172	7.0922413793103445	86
Q99PP7	PF00439	980	1063	12.639892857142858	83	G5ATE4	819	902	12.658357142857149	83
Q99PP7	PF00628	904	946	6.0432093023255815	42	G5ATE4	743	785	6.053976744186048	42
Q99PP7	PF00643	288	325	0.0	37	G5ATE4	114	151	0.0	37
O89114	PF00226	3	64	0.0	61	G5BXB7	76	137	0.0	61
O89114	PF01556	171	329	8.701490566037739	158	G5BXB7	244	402	8.675641509433964	158
Q9CXV9	PF03556	120	229	6.56361818181818	109	G5BUD0	93	202	6.530436363636361	109
Q99P25	PF15739	97	206	0.03969090909090909	109	G5C673	52	161	0.014272727272727275	109
Q99JY0	PF00108	86	324	4.618029288702928	238	G5CBK6	4	242	4.5457112970711275	238
Q99JY0	PF02803	331	470	2.84965	139	G5CBK6	249	363	2.612452173913044	114
Q8VEJ1	PF03029	13	259	3.404607287449392	246	G5AUS3	14	260	3.322967611336033	246
Q8R1Q9	PF00294	46	312	13.870089887640448	266	G5C2Z1	180	440	12.296409961685825	260
Q8VEH6	PF02492	41	205	11.420272727272724	164	G5APB7	44	207	13.380121951219516	163
Q8VEH6	PF07683	270	371	13.158862745098036	101	G5APB7	221	322	10.588147058823527	101
P53996	PF00098	4	19	0.0	15	G5AMJ3	5	20	0.0	15
P53996	PF00098	52	67	0.0	15	G5AMJ3	53	68	0.0	15
P53996	PF00098	73	89	0.0	16	G5AMJ3	73	89	0.0	16
P53996	PF00098	97	113	0.0	16	G5AMJ3	97	113	0.0	16
P53996	PF00098	117	134	0.0	17	G5AMJ3	117	134	0.0	17
P53996	PF00098	136	152	0.0	16	G5AMJ3	136	152	0.0	16
P53996	PF00098	157	172	0.0	15	G5AMJ3	157	172	0.0	15
Q3TN34	PF00307	4	106	11.016660194174754	102	G5BUG1	5	107	11.47887378640777	102
Q3TN34	PF00412	187	241	2.011709090909091	54	G5BUG1	188	243	1.983517857142857	55
Q3TN34	PF12130	847	976	0.15673846153846158	129	G5BUG1	754	883	6.005799999999998	129
Q9D240	PF00169	27	106	11.454587499999995	79	G5BBC2	28	95	12.400514705882351	67
Q6NXL6	PF02902	574	745	6.722831395348837	171	G5ALC9	576	747	6.709005813953488	171
Q9D198	PF08231	89	236	0.029554054054054056	147	G5BHW6	81	228	0.030040540540540537	147
Q8BYI9	PF00041	327	399	10.726835616438358	72	G5ARR9	329	401	4.124890410958904	72
Q8BYI9	PF00041	415	494	8.1959375	79	G5ARR9	417	496	8.195675	79
Q8BYI9	PF00041	506	585	7.106087499999999	79	G5ARR9	508	587	5.170087499999998	79
Q8BYI9	PF00041	594	670	3.0489740259740263	76	G5ARR9	596	672	3.0600259740259736	76
Q8BYI9	PF00041	686	762	5.522896103896104	76	G5ARR9	688	764	5.523285714285716	76
Q8BYI9	PF00041	775	849	9.447120000000002	74	G5ARR9	777	851	10.356626666666664	74
Q8BYI9	PF00041	864	941	0.08903846153846154	77	G5ARR9	866	943	0.4446025641025642	77
Q8BYI9	PF00041	954	1025	10.641736111111118	71	G5ARR9	956	1027	10.646388888888893	71
Q8BYI9	PF00041	1041	1115	4.9516133333333325	74	G5ARR9	1043	1116	4.918337837837837	73
Q8BYI9	PF00147	1134	1342	5.310033492822964	208	G5ARR9	1136	1344	3.4434976076555013	208
Q8BYI9	PF18720	202	230	0.0	28	G5ARR9	204	232	0.0	28
Q8BYI9	PF18720	234	260	0.0	26	G5ARR9	236	262	0.0	26
Q8BYI9	PF18720	265	292	0.0	27	G5ARR9	267	293	0.0	26
Q8BYI9	PF18720	299	323	0.0	24	G5ARR9	301	325	0.0	24
A3KFX0	PF06189	77	348	1.006852941176471	271	G5C4Y7	78	349	1.0206911764705884	271
Q5BJ29	PF12937	114	158	3.2943111111111096	44	G5B0Y3	68	112	1.213133333333333	44
Q5BJ29	PF13516	295	318	6.711666666666666	23	G5B0Y3	249	272	10.419375	23
Q5BJ29	PF13516	350	368	0.1913157894736842	18	G5B0Y3	304	322	0.19078947368421054	18
Q5BJ29	PF13516	373	397	0.0	24	G5B0Y3	327	351	0.0	24
Q5BJ29	PF13516	399	423	0.01032	24	G5B0Y3	353	377	0.015	24
Q5BJ29	PF13516	426	445	0.22185	19	G5B0Y3	380	399	0.41205	19
Q9JHU9	PF01658	306	418	3.0151238938053115	112	G5B070	279	390	4.482750000000001	111
Q9JHU9	PF07994	58	305	5.956798387096773	247	G5B070	59	278	4.379350000000001	219
Q8R4E9	PF16679	502	527	13.482692307692306	25	G5C2T9	445	470	2.7120769230769235	25
Q8R4E9	PF08839	198	360	1.4766809815950919	162	G5C2T9	237	400	0.2611036585365853	163
Q9QZD9	PF00400	5	36	24.4894375	31	G5BU91	47	78	26.736031250000003	31
Q9QZD9	PF00400	42	79	3.0052631578947366	37	G5BU91	84	121	3.0226842105263163	37
Q9QZD9	PF00400	279	310	0.08887500000000001	31	G5BU91	321	352	0.08962499999999997	31
E9QAT4	PF12931	1636	1870	2.3332382978723407	234	G5B6B0	1368	1601	3.026572649572649	233
E9QAT4	PF12932	1463	1563	5.035732673267328	100	G5B6B0	1194	1294	9.696188118811882	100
Q9D9B4	PF14580	43	158	0.12445689655172415	115	G5BUT2	1	123	1.3905934959349602	122
Q99M87	PF00226	115	154	0.0	39	G5C0J4	1	40	0.0	39
Q99M87	PF00684	235	295	0.0	60	G5C0J4	122	182	0.0	60
Q99M87	PF01556	209	234	1.2899615384615386	25	G5C0J4	96	121	1.314230769230769	25
O70293	PF00069	186	447	8.975557251908398	261	G5BQ10	213	474	8.953301526717555	261
O70293	PF00615	52	169	0.11995762711864408	117	G5BQ10	79	196	1.196449152542373	117
Q3UG98	PF13302	23	160	5.4701014492753615	137	G5BNE2	42	179	6.2036739130434775	137
Q30KP6	PF13841	33	63	0.12693548387096773	30	G5B147	34	64	0.4491935483870968	30
P56213	PF04777	96	188	0.6034301075268815	92	G5BY53	105	197	0.3112795698924731	92
Q9CPU0	PF00903	32	173	5.694704225352112	141	G5B9F4	33	174	8.113823943661972	141
Q9JK23	PF16094	1	287	9.23136933797909	286	G5AM04	23	310	7.723086805555552	287
P28651	PF00194	28	287	5.719799999999998	259	G5BSI4	28	287	5.720130769230769	259
Q8R0S2	PF01369	521	709	7.417941798941798	188	G5BAI1	629	817	6.198894179894179	188
Q8R0S2	PF16453	741	871	14.13208396946564	130	G5BAI1	849	978	24.58075384615385	129
Q8R2N0	PF08524	142	237	0.0	95	G5APZ9	141	236	0.01225	95
P19973	PF02029	181	275	0.0	94	G5C2F8	211	299	0.07107865168539325	88
Q9WVL1	PF01217	0	140	8.758851063829793	140	G5CAM1	1	160	7.731281249999998	159
Q8BS03	PF00188	70	210	2.718382978723405	140	G5BN27	71	211	2.654822695035461	140
Q9ESC8	PF05110	3	473	0.0	470	G5BFF8	4	475	0.0	471
Q9ESC8	PF18875	708	722	5.032466666666667	14	G5BFF8	710	724	4.539666666666666	14
Q9ESC8	PF18876	895	1157	2.3285741444866925	262	G5BFF8	895	1156	2.3397480916030524	261
P23204	PF00104	272	447	11.411880681818182	175	G5BVA9	273	448	10.981431818181813	175
P23204	PF00105	100	166	0.0	66	G5BVA9	101	167	0.0	66
Q8C0R7	PF01753	306	352	0.5478510638297873	46	G5BWA8	307	353	0.4574468085106383	46
P63276	PF00833	0	121	0.17648360655737716	121	G5B1R5	1	122	0.17648360655737716	121
Q6P9P0	PF14816	765	1134	7.257686486486485	369	G5CAE6	656	970	5.643368253968254	314
Q02111	PF00069	382	633	6.414103174603175	251	G5BP89	382	633	5.981313492063494	251
Q02111	PF00130	159	209	3.449490196078432	50	G5BP89	159	209	3.456254901960784	50
Q02111	PF00130	231	282	1.0244615384615383	51	G5BP89	231	282	1.0270192307692307	51
Q02111	PF00433	654	695	0.40895238095238107	41	G5BP89	654	695	0.034166666666666665	41
Q6PE55	PF13927	270	360	4.770791208791211	90	G5AP80	215	305	2.8247802197802194	90
Q3U6N9	PF15393	101	207	0.8900000000000005	106	G5C5Q5	109	214	2.610443396226414	105
A2AMM0	PF15237	26	262	4.046805907172995	236	G5CAN1	27	267	4.61782987551867	240
Q9CR00	PF17820	137	192	0.80425	55	G5AWN9	139	194	0.3076607142857143	55
Q9CR00	PF18265	22	101	0.0424875	79	G5AWN9	23	102	0.0424375	79
Q8BUI3	PF00400	385	422	1.8612894736842098	37	G5AXA5	386	423	1.8511578947368417	37
Q8BUI3	PF12799	47	86	0.0	39	G5AXA5	48	87	0.0	39
P60122	PF06068	13	367	3.0897408450704233	354	G5BII2	14	368	3.089585915492959	354
P60122	PF17856	373	438	0.02	65	G5BII2	374	439	0.02	65
Q8BMB0	PF03735	16	81	1.4736969696969695	65	G5BEM0	17	81	4.304738461538461	64
Q7M742	PF01099	0	86	17.776425287356325	86	G5AUC4	1	85	13.172226190476186	84
Q6NXJ0	PF00397	11	40	0.08066666666666666	29	G5CB42	16	45	8.160066666666667	29
P70236	PF00069	55	309	4.8956313725490235	254	G5BEL4	65	292	5.258605263157901	227
A2AQH4	PF12796	1497	1568	8.904180555555557	71	G5B2Q6	1451	1523	9.055246575342467	72
A2AQH4	PF16553	1663	1778	0.9315862068965516	115	G5B2Q6	1686	1801	2.0724913793103448	115
Q9WUC3	PF00021	27	109	1.2406746987951809	82	G5AWG2	28	111	1.2188928571428572	83
Q9DBR4	PF00640	418	555	2.434173913043478	137	G5C3T5	138	273	4.355250000000003	135
Q9DBR4	PF00640	591	711	4.637669421487604	120	G5C3T5	309	429	4.666694214876034	120
Q9DBR4	PF00397	291	319	1.2551724137931035	28	G5C3T5	14	42	1.262206896551724	28
Q9D4K5	PF10629	18	44	0.0	26	G5BFZ2	18	44	0.0	26
Q9QZQ8	PF00125	4	84	9.345740740740741	80	G5BQ26	5	85	10.19975308641975	80
Q9QZQ8	PF01661	215	328	0.07713157894736844	113	G5BQ26	216	329	0.08356140350877198	113
Q9QZQ8	PF16211	88	121	0.05529411764705882	33	G5BQ26	89	122	0.05529411764705882	33
P49183	PF03372	43	247	8.670648780487808	204	G5B1G8	63	267	7.166009756097558	204
Q9DBB5	PF01652	41	178	10.59065942028986	137	G5AVP9	1	138	8.236485507246384	137
P36916	PF01926	366	415	1.85324	49	G5C3B3	399	447	1.8341020408163264	48
Q8VD65	PF00069	26	309	8.179802816901418	283	G5AM65	27	310	8.167904929577457	283
Q8VD65	PF00400	985	1020	1.772222222222222	35	G5AM65	986	1021	0.2011666666666667	35
Q8VD65	PF00400	1326	1357	6.212999999999999	31	G5AM65	1327	1358	2.0088387096774194	31
Q9Z1L4	PF00754	79	215	4.063372262773723	136	G5BDT5	72	208	2.9727956204379558	136
P35761	PF00069	523	789	7.951400749063673	266	G5BC06	522	788	7.453419475655428	266
Q80Y83	PF00778	627	705	8.797341772151901	78	G5CAZ9	600	678	8.786582278481012	78
Q80Y83	PF00307	21	152	13.565742424242432	131	G5CAZ9	22	127	16.918113207547172	105
Q9JKP8	PF00808	17	78	10.873612903225807	61	G5C8Y6	18	79	15.612451612903225	61
Q14A28	PF06607	0	95	9.777802083333334	95	G5BD79	1	148	7.951804054054053	147
Q61584	PF00013	220	275	0.10312500000000004	55	G5C6J8	210	265	0.10633928571428576	55
Q61584	PF00013	284	350	6.972373134328357	66	G5C6J8	274	340	6.974507462686567	66
Q61584	PF05641	61	115	1.8223454545454545	54	G5C6J8	51	105	1.8086000000000009	54
Q61584	PF12235	353	484	0.06421969696969695	131	G5C6J8	343	474	0.053174242424242416	131
Q61584	PF16096	488	562	0.12013333333333333	74	G5C6J8	478	552	0.11993333333333335	74
Q61584	PF16097	609	675	0.015970149253731344	66	G5C6J8	599	665	0.015970149253731344	66
Q61584	PF17904	122	206	0.4613882352941176	84	G5C6J8	112	196	0.4607882352941178	84
Q61584	PF18336	13	51	6.017512820512822	38	G5C6J8	3	41	10.722923076923076	38
P42232	PF00017	594	668	11.002239999999999	74	G5B0K1	483	557	10.407506666666668	74
P42232	PF01017	141	183	2.4201395348837207	42	G5B0K1	139	180	2.2701904761904763	41
P42232	PF02864	335	468	7.648917910447762	133	G5B0K1	224	357	8.387380597014925	133
P42232	PF02865	1	122	0.09427868852459016	121	G5B0K1	2	120	0.2267142857142856	118
Q9QXY6	PF00350	60	220	6.5401677018633615	160	G5B8M4	61	221	6.106565217391303	160
Q9QXY6	PF12763	446	532	1.1271149425287352	86	G5B8M4	447	533	1.1263678160919541	86
Q9QXY6	PF16880	23	55	0.0	32	G5B8M4	24	56	0.0	32
Q9QXY6	PF18150	287	393	3.4277196261682237	106	G5B8M4	288	394	4.214579439252336	106
Q8CJ53	PF00018	547	594	1.1737083333333334	47	G5C0N7	547	594	0.9100208333333332	47
Q8CJ53	PF00611	9	86	0.5512820512820513	77	G5C0N7	10	87	0.4708589743589744	77
Q62225	PF00017	81	162	6.230487804878048	81	G5BZT5	49	130	6.126353658536584	81
Q62225	PF07525	219	250	0.4022500000000001	31	G5BZT5	187	218	0.2886875	31
Q9D0F6	PF00004	54	171	1.147618644067797	117	G5AKT1	56	173	1.1554406779661015	117
Q9D0F6	PF08542	240	326	3.2795287356321836	86	G5AKT1	242	328	3.8815632183908053	86
O54865	PF00211	411	602	8.112947916666666	191	G5BLV4	387	587	7.710905472636808	200
O54865	PF07700	25	165	9.148382978723404	140	G5BLV4	1	141	9.150808510638297	140
O54865	PF07701	207	405	6.789874371859297	198	G5BLV4	183	381	7.209120603015072	198
Q9JJC6	PF09744	26	174	2.8482550335570465	148	G5AWS9	27	175	2.8571879194630867	148
Q9JJC6	PF11461	297	348	1.2361538461538462	51	G5AWS9	296	347	1.2267307692307692	51
Q3U108	PF01388	52	136	6.497670588235295	84	G5BMV4	79	163	6.499670588235293	84
Q6ZQH8	PF10487	30	939	9.474027472527471	909	G5ASC9	24	934	9.57008891328211	910
P27699	PF00170	296	352	0.014982456140350875	56	G5BI24	278	334	0.01424561403508772	56
P27699	PF02173	117	152	0.0	35	G5BI24	99	134	0.0	35
P57110	PF00090	547	595	0.0	48	G5B4B9	399	447	0.046632653061224494	48
P57110	PF01421	248	443	8.143306122448971	195	G5B4B9	104	296	7.950808290155439	192
P57110	PF01562	51	107	0.1031578947368421	56	G5B4B9	52	107	0.0	55
P57110	PF05986	706	824	1.9133361344537816	118	G5B4B9	558	676	2.233067226890756	118
P57110	PF17771	458	528	0.11159154929577464	70	G5B4B9	311	380	0.03521428571428571	69
P57110	PF19030	854	881	0.0	27	G5B4B9	400	426	0.08462962962962964	26
Q9DAZ9	PF01363	19	56	0.08228947368421052	37	G5BM00	19	56	0.012921052631578948	37
Q8BM54	PF00373	85	189	2.521723809523809	104	G5C847	57	161	1.922028571428572	104
Q8BM54	PF09379	29	66	0.8466315789473683	37	G5C847	1	38	0.8407368421052631	37
Q8BM54	PF09380	193	277	9.986282352941178	84	G5C847	165	250	9.866313953488369	85
Q8BM54	PF13920	384	427	0.057363636363636374	43	G5C847	357	400	0.41727272727272735	43
Q8VE18	PF10220	41	984	5.1306048728813565	943	G5C891	42	984	5.188587486744429	942
Q9Z110	PF00171	363	626	3.9069053030303023	263	G5C152	364	627	4.107791666666663	263
Q9Z110	PF00696	70	328	4.45314285714286	258	G5C152	71	329	4.449100386100388	258
Q9CQC8	PF00561	86	158	0.5721095890410959	72	G5AN68	87	159	0.2312465753424657	72
O88532	PF07528	789	1035	3.9022348178137656	246	G5AKD4	737	983	3.9023036437246965	246
O88532	PF12874	331	354	0.0	23	G5AKD4	294	317	0.0	23
O88532	PF12874	382	405	0.0	23	G5AKD4	345	368	0.0	23
O88532	PF12874	581	605	0.0	24	G5AKD4	529	553	0.0	24
Q8R3H9	PF18972	271	355	1.3504	84	G5BXH4	132	215	2.059440476190476	83
A3KGF9	PF15266	204	356	0.0	152	G5BLY5	107	260	0.0	153
Q91Z38	PF13181	189	219	0.0	30	G5BEM9	185	215	0.0	30
P22437	PF03098	225	523	6.285391304347825	298	G5AJM0	290	588	6.354458193979927	298
Q9R020	PF00641	9	34	0.0	25	G5C4U0	10	35	0.0	25
Q9R020	PF00641	65	92	0.003999999999999999	27	G5C4U0	66	93	0.0	27
Q0P557	PF16026	295	398	6.509625000000002	103	G5AX57	273	375	6.579601941747577	102
Q9D1J1	PF07933	5	161	1.1592229299363055	156	G5BRV0	6	162	1.6262165605095544	156
Q9DA42	PF14945	15	133	0.13926050420168065	118	G5AUM4	16	134	0.16171428571428567	118
Q91V41	PF00071	12	172	6.574465838509318	160	G5AXS2	13	173	6.338813664596272	160
Q60644	PF00104	249	428	6.262238888888892	179	G5B8S5	259	438	6.2621388888888925	179
Q60644	PF00105	76	145	0.0	69	G5B8S5	86	155	0.0	69
Q8CIH5	PF00017	531	616	7.404	85	G5B1W9	654	739	1.778255813953488	85
Q8CIH5	PF00017	684	719	7.567388888888887	35	G5B1W9	797	832	7.724944444444442	35
Q8CIH5	PF00018	774	820	0.0	46	G5B1W9	887	933	0.0	46
Q8CIH5	PF00168	1061	1160	2.3273300000000003	99	G5B1W9	1099	1198	1.8138700000000003	99
Q8CIH5	PF00387	929	1040	3.2157857142857162	111	G5B1W9	967	1078	3.2168035714285708	111
Q8CIH5	PF00388	313	456	0.6539861111111112	143	G5B1W9	436	579	0.5391458333333335	143
Q8R1X6	PF06911	430	614	1.2969459459459467	184	G5B3M4	431	615	1.717324324324324	184
Q64355	PF12026	370	554	5.097567567567567	184	G5ASL6	425	609	3.545486486486486	184
Q64355	PF14604	11	62	0.02780769230769231	51	G5ASL6	93	144	0.027576923076923072	51
Q9R0H5	PF00038	129	438	0.3747129032258065	309	G5ALS4	127	435	0.33217475728155355	308
Q9R0H5	PF16208	62	126	1.2459076923076922	64	G5ALS4	60	124	1.262923076923077	64
Q8BT51	PF06747	33	65	0.0	32	G5ASA0	35	67	0.0	32
P61028	PF00071	9	169	7.99286956521739	160	G5AWA9	10	170	7.473260869565222	160
P49025	PF00069	97	358	4.2250496183206065	261	G5B786	98	360	3.578695817490495	262
P49025	PF00169	1470	1587	3.1764576271186433	117	G5B786	1472	1589	3.1721779661016933	117
P49025	PF00780	1626	1880	7.9344235294117595	254	G5B786	1628	1882	8.094533333333327	254
Q9CR50	PF05495	19	91	0.22184931506849312	72	G5B1B2	11	83	0.2590958904109588	72
Q9CR50	PF13639	143	185	0.01453488372093023	42	G5B1B2	135	177	0.01441860465116279	42
Q9CR50	PF14599	190	247	0.0	57	G5B1B2	182	239	1.3017241379310345	57
Q8K2Q7	PF03097	85	356	6.670841911764707	271	G5C187	86	357	6.6751654411764685	271
Q69Z28	PF00090	587	637	0.0	50	G5BJC6	684	734	0.0	50
Q69Z28	PF01421	289	492	14.761980392156875	203	G5BJC6	384	587	15.037176470588227	203
Q69Z28	PF01562	57	129	0.10328767123287673	72	G5BJC6	50	119	0.061828571428571434	69
Q69Z28	PF05986	744	855	0.07525892857142857	111	G5BJC6	841	952	0.09726785714285716	111
Q69Z28	PF08686	1187	1217	10.548612903225807	30	G5BJC6	1281	1311	0.08774193548387096	30
Q69Z28	PF17771	505	572	0.0	67	G5BJC6	600	669	0.0	69
Q69Z28	PF19030	928	983	0.0	55	G5BJC6	1025	1080	0.0	55
Q69Z28	PF19030	987	1044	0.0	57	G5BJC6	1084	1141	0.0	57
Q69Z28	PF19030	1052	1111	1.446983333333333	59	G5BJC6	1149	1208	1.1933333333333338	59
Q69Z28	PF19030	1127	1177	0.0	50	G5BJC6	1221	1271	0.0	50
P43247	PF00488	665	851	6.3541925133689885	186	G5ANB1	666	852	5.8947112299465285	186
P43247	PF01624	17	130	6.396438596491229	113	G5ANB1	18	131	6.008350877192981	113
P43247	PF05188	151	288	4.677304347826088	137	G5ANB1	152	289	4.858688405797103	137
P43247	PF05190	473	565	0.3481505376344086	92	G5ANB1	474	566	0.3330967741935484	92
P43247	PF05192	305	472	4.536339285714285	167	G5ANB1	306	473	4.533166666666666	167
Q5U4C9	PF00069	219	532	0.8094554140127388	313	G5BGB4	211	524	0.8040668789808922	313
P26039	PF00373	205	312	5.944712962962963	107	G5BKZ8	206	313	6.845777777777778	107
P26039	PF09141	490	651	2.0153271604938268	161	G5BKZ8	491	652	2.014666666666667	161
P26039	PF16511	3	82	0.4219500000000001	79	G5BKZ8	4	83	0.4059125	79
P26039	PF01608	2385	2530	0.4799315068493151	145	G5BKZ8	2374	2519	0.4796986301369863	145
P26039	PF08913	1848	1972	3.798296000000001	124	G5BKZ8	1837	1961	3.813672	124
Q9QYI5	PF00226	3	65	0.0	62	G5AKJ7	4	66	0.0	62
Q8K136	PF15803	43	68	1.4258076923076923	25	G5AJZ4	44	69	1.4086923076923077	25
Q8K136	PF15805	181	226	0.0	45	G5AJZ4	183	228	0.0	45
Q9D1X0	PF00619	9	94	3.0984767441860463	85	G5C647	10	95	3.0108023255813943	85
Q8VEJ4	PF00400	104	141	9.706263157894737	37	G5B754	105	142	9.713289473684213	37
Q8VEJ4	PF00400	149	183	2.9376571428571423	34	G5B754	150	184	2.9175428571428577	34
Q8VEJ4	PF00400	190	231	0.35019047619047616	41	G5B754	191	232	0.35019047619047616	41
Q8VEJ4	PF00400	235	271	0.04864864864864864	36	G5B754	236	272	0.04864864864864864	36
Q8VEJ4	PF00400	362	399	2.4565	37	G5B754	363	400	2.459631578947369	37
Q8VEJ4	PF00400	403	441	13.01648717948718	38	G5B754	404	442	15.64282051282051	38
Q8VEJ4	PF00400	450	482	0.0	32	G5B754	451	483	0.0	32
Q8VEJ4	PF08154	17	76	6.264899999999999	59	G5B754	18	77	5.847266666666666	59
Q8R035	PF00472	71	198	0.0241796875	127	G5BND3	72	199	0.15217968749999994	127
Q91XD4	PF02971	180	323	4.283118055555558	143	G5C7V7	181	324	3.9821597222222214	143
Q91XD4	PF04961	339	513	8.781777142857148	174	G5C7V7	339	512	4.0263045977011505	173
Q91XD4	PF07837	3	178	2.2317727272727264	175	G5C7V7	4	179	0.34090340909090905	175
Q61658	PF00046	108	164	2.9134210526315787	56	G5ATN1	109	165	2.9219824561403502	56
Q60749	PF00013	157	213	0.0	56	G5BU98	151	207	0.0	56
Q60749	PF16274	101	152	0.0	51	G5BU98	95	146	0.0	51
Q60749	PF16568	365	414	0.0	49	G5BU98	359	408	0.0	49
P06537	PF00104	561	736	8.769551136363644	175	G5AQS2	553	728	9.294482954545458	175
P06537	PF00105	426	493	0.6236764705882353	67	G5AQS2	417	485	0.4762463768115942	68
P06537	PF02155	26	408	0.024558746736292436	382	G5AQS2	27	400	0.033024064171123	373
Q9Z1T2	PF02412	497	532	0.0	35	G5AN00	469	504	0.0	35
Q9Z1T2	PF02412	556	591	0.0	35	G5AN00	528	563	0.0	35
Q9Z1T2	PF02412	616	651	0.0	35	G5AN00	588	623	0.0	35
Q9Z1T2	PF02412	654	692	0.0	38	G5AN00	626	664	0.0	38
Q9Z1T2	PF02412	693	727	0.0	34	G5AN00	665	699	0.0	34
Q9Z1T2	PF05735	746	943	5.070070707070706	197	G5AN00	718	915	5.0732474747474745	197
Q9Z1T2	PF07645	327	359	0.0	32	G5AN00	299	331	0.0	32
Q9Z1T2	PF07645	380	419	0.41225	39	G5AN00	352	391	0.0588	39
Q9Z1T2	PF11598	219	263	0.0	44	G5AN00	188	232	0.0	44
Q8CFH6	PF00069	44	270	6.924929515418503	226	G5CB06	1	227	6.7434933920704845	226
O35942	PF00069	7	269	3.44916349809886	262	G5AM46	8	270	3.7271787072243363	262
Q3V1V3	PF08159	752	780	0.0	28	G5ALV3	730	758	0.0	28
Q6PD19	PF08427	440	667	11.632074561403508	227	G5CAG4	441	668	11.570986842105274	227
O54916	PF12763	281	369	8.893539325842696	88	G5AUD4	282	370	8.895617977528088	88
Q5SYL1	PF00069	105	263	7.607452830188676	158	G5BVH7	99	234	8.21355882352941	135
P11725	PF00185	186	339	6.029019480519478	153	G5BMQ9	187	340	6.126142857142857	153
P11725	PF02729	39	180	2.3302464788732387	141	G5BMQ9	40	181	2.3174225352112683	141
Q9EST8	PF12796	600	691	0.4466630434782609	91	G5C023	514	605	0.3992934782608695	91
Q9EST8	PF13637	492	539	2.848229166666668	47	G5C023	406	453	2.6983125	47
Q9CRC6	PF16088	1	101	2.0596633663366344	100	G5CAI4	3	103	2.0638514851485144	100
Q7TMC8	PF00288	827	887	1.0117049180327868	60	G5C1P8	828	888	1.6046393442622944	60
Q7TMC8	PF07959	96	494	3.77248120300752	398	G5C1P8	97	495	3.0215338345864637	398
Q7TMC8	PF08544	970	1048	7.208101265822783	78	G5C1P8	971	1049	13.091594936708866	78
Q8C1D8	PF08711	585	635	2.5333333333333337	50	G5B9V4	664	714	2.551	50
Q8BKK5	PF00096	176	198	0.03739130434782608	22	G5BYK9	177	199	0.037173913043478266	22
Q8BKK5	PF00096	204	226	0.0	22	G5BYK9	205	227	0.0	22
Q8BKK5	PF00096	232	254	0.0	22	G5BYK9	233	255	0.0	22
Q8BKK5	PF00096	260	282	0.5423913043478261	22	G5BYK9	261	283	0.5397826086956522	22
Q8BKK5	PF00096	288	310	2.1852173913043482	22	G5BYK9	289	311	2.1789130434782606	22
Q8BKK5	PF00096	316	338	0.0	22	G5BYK9	317	339	0.0	22
Q8BKK5	PF00096	372	394	0.0	22	G5BYK9	373	395	0.0	22
Q8BKK5	PF00096	400	422	0.0	22	G5BYK9	401	423	0.0	22
Q8BKK5	PF00096	428	450	0.0	22	G5BYK9	429	451	0.0	22
Q8BKK5	PF01352	28	68	19.892170731707317	40	G5BYK9	29	69	9.259317073170733	40
P31362	PF00046	274	330	1.5417192982456138	56	G5BHQ2	272	328	1.5235789473684211	56
P31362	PF00157	179	249	0.12950704225352114	70	G5BHQ2	177	247	0.12780281690140838	70
Q80XS6	PF00536	299	356	0.5113103448275864	57	G5BJE2	300	357	0.5121206896551723	57
Q2MHE5	PF02174	135	229	1.8562315789473691	94	G5B7W9	114	208	1.898357894736843	94
Q4LFA9	PF00047	591	667	3.910597402597402	76	G5BUM1	969	1045	5.0695844155844165	76
Q4LFA9	PF01403	60	499	6.1473499999999985	439	G5BUM1	55	473	6.160088305489255	418
Q9D593	PF01991	17	215	0.746356783919598	198	G5C9T2	18	216	5.208572864321612	198
Q8C1Y8	PF19031	22	147	11.151277777777775	125	G5BF32	24	149	10.380706349206351	125
Q8C1Y8	PF19032	217	343	7.53164566929134	126	G5BF32	219	345	4.996133858267717	126
Q8C1Y8	PF19033	369	467	11.953141414141415	98	G5BF32	371	469	11.964898989898991	98
P61358	PF00467	6	34	17.525517241379312	28	G5BN91	7	35	17.525517241379312	28
P61358	PF01777	51	135	0.018823529411764704	84	G5BN91	52	136	0.019047619047619046	84
Q9D7A8	PF00514	27	66	8.7779	39	G5C169	28	67	8.854674999999997	39
Q9JKY5	PF01608	863	1008	0.17200000000000007	145	G5AWR7	931	1076	0.25793150684931515	145
Q9JKY5	PF07651	30	294	3.225943396226417	264	G5AWR7	4	268	3.2577509433962244	264
Q9JKY5	PF16515	474	558	0.028905882352941174	84	G5AWR7	400	484	0.3044588235294117	84
Q3TZI6	PF00134	23	142	14.188250000000002	119	G5BBF9	24	143	14.18365	119
Q3TZI6	PF02984	144	259	2.560422413793105	115	G5BBF9	145	260	2.618387931034481	115
P97452	PF00400	393	425	0.14542424242424246	32	G5C5T4	342	374	0.008424242424242423	32
P97452	PF00400	562	590	10.379655172413793	28	G5C5T4	511	539	10.416034482758619	28
P97452	PF00400	640	673	0.5345	33	G5C5T4	589	622	1.700764705882353	33
P97452	PF00400	691	730	0.085875	39	G5C5T4	640	679	0.08175	39
P97452	PF08145	129	387	0.04324324324324325	258	G5C5T4	78	336	0.1127220077220077	258
Q8K4G5	PF00412	98	152	0.1328181818181818	54	G5BKA9	94	148	0.13047272727272724	54
Q8K4G5	PF00412	157	208	4.253269230769228	51	G5BKA9	153	204	4.2490576923076935	51
Q8K4G5	PF00412	225	278	1.6277777777777775	53	G5BKA9	221	273	1.6427169811320754	52
Q8K4G5	PF00412	284	326	0.0	42	G5BKA9	280	322	0.13716279069767442	42
Q8K4G5	PF02209	825	860	0.04666666666666667	35	G5BKA9	814	849	0.3645428571428571	35
Q8K4G5	PF16182	392	824	0.1465011547344111	432	G5BKA9	372	813	0.14174208144796382	441
O35486	PF00030	6	85	1.6799250000000003	79	G5BT93	7	86	2.2375250000000007	79
O35486	PF00030	94	175	2.2118536585365853	81	G5BT93	95	176	5.913134146341465	81
Q9R0H0	PF01756	480	656	3.803271186440677	176	G5AQW3	481	658	8.113960674157301	177
Q9R0H0	PF02770	135	243	4.292871559633029	108	G5AQW3	136	244	5.4474495412844055	108
Q9R0H0	PF14749	14	132	0.2590756302521008	118	G5AQW3	15	133	3.9354033613445383	118
Q9ERF3	PF00400	148	175	15.568857142857144	27	G5AUK7	193	220	15.622785714285715	27
Q9ERF3	PF00400	179	217	0.8777179487179486	38	G5AUK7	224	262	0.8948461538461538	38
Q9ERF3	PF00400	225	259	12.33137142857143	34	G5AUK7	270	304	12.363542857142852	34
Q9ERF3	PF00400	264	301	0.7691842105263159	37	G5AUK7	309	346	0.7682631578947369	37
Q9ERF3	PF08662	16	129	1.0900526315789474	113	G5AUK7	61	174	1.7894736842105263	113
Q8K3C3	PF06384	112	187	4.029302631578949	75	G5C534	113	188	3.008592105263158	75
Q99N48	PF00168	321	431	0.02317117117117117	110	G5BCM3	250	360	0.09989189189189196	110
Q99N48	PF00168	502	571	0.4721571428571426	69	G5BCM3	449	518	0.30791428571428586	69
Q99N48	PF02318	11	40	4.814466666666666	29	G5BCM3	12	40	15.924655172413793	28
Q6PCQ0	PF00612	554	571	1.8967777777777772	17	G5BF55	562	579	21.345611111111108	17
Q6PCQ0	PF00612	616	634	38.78	18	G5BF55	562	579	21.345611111111108	17
Q99KJ5	PF00498	37	104	0.04330882352941176	67	G5C3D4	38	105	0.043529411764705886	67
P00536	PF00069	66	328	3.834087452471484	262	G5B334	20	288	4.960591078066914	268
Q5SSM3	PF00620	270	415	1.6045273972602743	145	G5BRA6	271	416	1.6045273972602743	145
Q5SSM3	PF03114	0	240	1.0272033195020749	240	G5BRA6	1	241	1.0140248962655605	240
Q8K1J5	PF13019	67	140	0.04945945945945946	73	G5BAP3	68	141	0.037729729729729725	73
Q8K1J5	PF13297	381	440	3.08875	59	G5BAP3	380	439	7.8525500000000035	59
Q61419	PF13483	146	219	1.2776081081081079	73	G5BJZ3	1	74	1.275648648648649	73
Q66JY2	PF13891	17	77	0.35311475409836063	60	G5C5L9	18	77	0.3568833333333334	59
Q66JY2	PF13891	441	505	0.0	64	G5C5L9	452	516	0.0	64
Q921I1	PF00405	24	344	3.890457943925232	320	G5BQA9	25	344	4.0756624999999955	319
Q921I1	PF00405	359	681	1.6593808049535608	322	G5BQA9	361	680	2.703278125	319
B1AX39	PF00098	236	251	0.0	15	G5C1E2	38	53	0.0	15
B1AX39	PF00098	343	359	5.928	16	G5C1E2	145	161	3.781117647058824	16
P55065	PF01273	29	197	7.425065088757394	168	G5B7P8	30	198	9.002159763313609	168
P55065	PF02886	228	463	7.460233050847457	235	G5B7P8	229	484	6.98959375	255
A2A6H3	PF00646	46	60	11.911066666666667	14	G5BK69	47	60	73.09542857142857	13
O70566	PF02181	625	903	5.411562724014334	278	G5AR47	590	867	5.151098181818182	277
O70566	PF06367	291	478	6.298175531914895	187	G5AR47	249	440	6.491572916666668	191
O70566	PF06371	93	282	5.682315789473681	189	G5AR47	58	240	6.363092896174863	182
Q922Y1	PF00627	5	38	0.3708823529411765	33	G5AYI4	6	39	0.3702941176470588	33
Q922Y1	PF00789	208	284	0.872142857142857	76	G5AYI4	211	286	0.9357600000000004	75
Q91VZ6	PF01412	19	130	6.274821428571428	111	G5ALU6	20	131	6.284410714285714	111
P70321	PF00046	218	274	5.515105263157895	56	G5C4M7	217	273	5.540684210526315	56
P70321	PF12284	12	123	0.012089285714285716	111	G5C4M7	13	123	0.0	110
Q60967	PF01583	50	207	4.804860759493672	157	G5AQK6	51	212	4.845086419753087	161
Q60967	PF01747	393	616	6.240919642857144	223	G5AQK6	398	621	7.164200892857145	223
Q60967	PF14306	232	384	3.80657516339869	152	G5AQK6	237	389	3.087973856209151	152
Q9Z2L6	PF00328	81	432	5.27441761363636	351	G5B5S7	86	443	5.033558659217875	357
P97298	PF00079	55	413	6.98408635097493	358	G5BCV0	56	414	7.2886211699164365	358
Q60980	PF00096	258	282	0.0	24	G5C3V9	260	284	0.0	24
Q60980	PF00096	288	312	0.0	24	G5C3V9	290	314	0.0	24
Q60980	PF00096	318	340	0.0	22	G5C3V9	320	342	0.0	22
Q9DAA4	PF00089	18	227	4.4702714285714285	209	G5AVR8	43	252	7.693642857142856	209
Q6PAL8	PF01477	955	1061	6.278728971962618	106	G5BUX2	921	1027	10.323457943925233	106
Q6PAL8	PF02141	201	388	4.075590425531915	187	G5BUX2	166	353	4.068994680851062	187
Q6PAL8	PF02759	794	941	0.7083445945945946	147	G5BUX2	760	907	1.1088243243243243	147
Q6PAL8	PF02759	1142	1278	9.226080291970797	136	G5BUX2	1108	1244	9.184948905109485	136
Q6PAL8	PF03455	554	606	1.3144905660377355	52	G5BUX2	519	571	1.3146037735849052	52
Q6PAL8	PF03456	75	136	13.794709677419355	61	G5BUX2	40	101	14.593580645161293	61
Q3UGP9	PF13855	41	97	0.20250877192982453	56	G5AU93	47	103	0.2744035087719299	56
Q3UGP9	PF13855	114	170	0.08103508771929824	56	G5AU93	120	176	0.0927719298245614	56
Q3UGP9	PF13855	183	241	4.292135593220338	58	G5AU93	189	247	4.2829661016949165	58
Q8C5H8	PF01513	104	330	1.871784140969163	226	G5C9G3	17	221	0.2258487804878049	204
Q8CHY3	PF09742	165	645	15.16338045738045	480	G5B878	1	481	15.278582120582126	480
P04117	PF00061	5	130	1.80618253968254	125	G5BAK6	6	131	1.4521746031746026	125
Q9D0Q7	PF04280	118	263	0.3366780821917808	145	G5BY31	119	264	0.30897260273972604	145
Q62018	PF13181	344	373	0.8613333333333333	29	G5BFG7	345	374	0.7628	29
Q62018	PF13181	451	481	1.4698387096774193	30	G5BFG7	452	482	1.4716129032258063	30
Q62018	PF13181	681	707	2.7461851851851837	26	G5BFG7	682	708	2.7497407407407404	26
Q62018	PF13432	500	564	0.007153846153846155	64	G5BFG7	501	565	0.0	64
Q62018	PF14559	176	227	0.02932692307692308	51	G5BFG7	177	228	0.02932692307692308	51
P52792	PF00349	15	214	1.768385	199	G5BIK4	15	214	1.7959200000000006	199
P52792	PF03727	220	454	1.8957787234042558	234	G5BIK4	220	454	1.5809446808510632	234
Q91W86	PF00637	417	535	0.6259075630252098	118	G5BHN4	392	510	0.6256134453781511	118
Q91W86	PF12451	863	907	0.4828222222222222	44	G5BHN4	838	882	0.4828444444444444	44
Q91W86	PF13923	820	859	0.08875	39	G5BHN4	795	834	0.08875	39
Q8CH25	PF00076	385	454	0.5347571428571429	69	G5AQ65	341	410	0.5246571428571429	69
Q91VW3	PF04908	2	92	0.03138461538461538	90	G5AUR1	3	93	0.0316	90
P47791	PF02852	388	498	2.1284864864864863	110	G5C9Y5	302	412	2.1433153153153155	110
P47791	PF07992	87	367	5.662975088967969	280	G5C9Y5	1	281	5.838911032028467	280
Q8CA72	PF00651	20	125	2.598103773584904	105	G5B1X1	21	126	2.6068018867924514	105
Q8CA72	PF01344	314	359	10.759847826086958	45	G5B1X1	315	360	11.016717391304347	45
Q8CA72	PF01344	362	406	4.3612	44	G5B1X1	363	407	4.497355555555556	44
Q8CA72	PF01344	416	449	0.0	33	G5B1X1	417	450	0.0	33
Q8CA72	PF07707	133	234	12.729245098039215	101	G5B1X1	134	235	12.723176470588234	101
Q61586	PF01553	215	354	11.211957142857141	139	G5BKC8	216	355	11.240899999999995	139
Q9QYF1	PF00106	38	239	1.8160148514851464	201	G5C7X4	18	229	4.1319103773584915	211
O08863	PF00619	441	521	2.387296296296295	80	G5BUB6	445	526	3.675170731707317	81
O08863	PF00653	29	94	0.3434090909090909	65	G5BUB6	32	97	1.275651515151515	65
O08863	PF00653	169	232	0.9981562500000002	63	G5BUB6	172	235	1.2612031250000002	63
O08863	PF00653	255	319	0.2766615384615385	64	G5BUB6	258	322	2.8998461538461537	64
O08863	PF13920	548	591	9.960659090909088	43	G5BUB6	553	596	9.966659090909092	43
Q3TL26	PF00398	81	348	7.455014925373132	267	G5ALQ0	82	352	4.705712177121773	270
Q8CG85	PF00629	47	166	1.4624166666666665	119	G5AVH3	97	216	2.1130000000000004	119
Q8CG85	PF00629	169	327	3.491748427672956	158	G5AVH3	219	377	5.756798742138367	158
Q8CG85	PF00629	379	496	12.800542372881365	117	G5AVH3	501	617	11.208205128205119	116
Q8CG85	PF00629	508	664	4.39595541401274	156	G5AVH3	630	786	4.313687898089168	156
Q01147	PF00170	280	335	0.0	55	G5C183	281	336	0.0	55
Q01147	PF02173	112	152	0.0	40	G5C183	113	153	0.0	40
Q8K4S1	PF00168	1851	1943	10.212860215053764	92	G5AJU2	1256	1348	11.23241935483871	92
Q8K4S1	PF00387	1732	1822	5.5666813186813195	90	G5AJU2	1137	1227	6.329483516483517	90
Q8K4S1	PF00388	1375	1521	2.772455782312925	146	G5AJU2	779	925	2.9686394557823124	146
Q8K4S1	PF00617	614	712	8.106848484848486	98	G5AJU2	1	99	8.124555555555553	98
Q8K4S1	PF00788	2115	2217	0.5941941747572813	102	G5AJU2	1477	1579	0.6028058252427182	102
Q8K4S1	PF09279	1307	1358	5.473942307692312	51	G5AJU2	711	762	4.4234807692307685	51
Q8C863	PF00397	288	317	0.0	29	G5BPT5	325	354	0.0	29
Q8C863	PF00397	320	349	0.0	29	G5BPT5	357	386	0.0	29
Q8C863	PF00397	400	429	1.1313333333333333	29	G5BPT5	437	466	1.1303333333333332	29
Q8C863	PF00168	18	107	5.87087777777778	89	G5BPT5	19	108	5.501533333333335	89
Q8C863	PF00632	559	861	7.558046204620456	302	G5BPT5	596	898	7.234247524752472	302
Q50L43	PF00168	31	134	2.1639615384615385	103	G5BM23	9	112	3.198923076923077	103
Q50L43	PF01735	331	543	1.3510093896713615	212	G5BM23	309	521	1.7495305164319257	212
Q50L43	PF18695	172	276	0.9748380952380952	104	G5BM23	150	254	0.04234285714285714	104
Q99KR6	PF13920	325	366	0.0	41	G5AWN1	326	367	0.0	41
P62484	PF07815	92	159	0.58175	67	G5B877	54	127	0.5266081081081081	73
P41242	PF00017	119	193	7.796719999999996	74	G5BBD6	81	155	7.779386666666665	74
P41242	PF00018	61	96	1.36275	35	G5BBD6	23	58	5.532166666666668	35
P41242	PF07714	232	426	6.690548717948714	194	G5BBD6	194	387	6.8738659793814465	193
Q64105	PF00106	71	212	2.48994366197183	141	G5CBQ9	1	142	1.995619718309859	141
P70397	PF00046	49	105	0.010087719298245616	56	G5BLD1	29	85	0.0	56
Q8BHT7	PF08737	113	158	3.2771086956521738	45	G5BKZ5	86	131	4.961630434782609	45
Q8BHT7	PF08737	209	329	1.84804958677686	120	G5BKZ5	182	302	2.6362561983471067	120
Q922B2	PF00152	175	494	4.42239375	319	G5B1T3	176	495	5.442053125000001	319
Q922B2	PF01336	59	144	7.441918604651162	85	G5B1T3	60	145	8.533093023255812	85
Q69ZA1	PF00069	706	997	3.7454178082191767	291	G5B6U5	317	567	4.406374501992032	250
Q91ZR4	PF00069	3	255	8.38194466403162	252	G5BVI5	4	256	8.379300395256912	252
Q91ZR4	PF00415	419	463	1.9467777777777773	44	G5BVI5	426	470	1.4419555555555557	44
Q91ZR4	PF00415	468	514	1.1471063829787231	46	G5BVI5	475	521	5.021978723404254	46
Q91ZR4	PF00415	584	633	6.24426	49	G5BVI5	591	640	3.91402	49
Q91ZR4	PF00415	636	684	0.8097959183673468	48	G5BVI5	643	691	0.6397142857142857	48
Q9Z2I9	PF00549	320	440	9.152000000000001	120	G5BTQ7	321	441	10.902561983471069	120
Q9Z2I9	PF08442	54	261	3.383067307692309	207	G5BTQ7	55	262	3.035677884615386	207
Q69Z69	PF13878	606	645	0.344175	39	G5BTS0	602	641	0.49225	39
Q69Z69	PF13880	765	833	9.01176811594203	68	G5BTS0	713	781	10.181478260869564	68
Q6P2L6	PF00855	267	378	0.043607142857142865	111	G5B0A9	268	379	0.05210714285714285	111
Q6P2L6	PF00855	959	1050	3.7366847826086964	91	G5B0A9	961	1050	3.7522888888888883	89
Q6P2L6	PF00856	1158	1264	8.556373831775705	106	G5B0A9	1158	1264	8.557747663551401	106
Q6P2L6	PF17907	1106	1144	0.0	38	G5B0A9	1106	1144	0.0	38
Q6P2L6	PF17982	1365	1414	0.8411399999999999	49	G5B0A9	1366	1415	1.0026	49
P16951	PF00170	335	392	0.06958620689655172	57	G5C944	205	262	0.06810344827586208	57
Q9CX66	PF15370	67	128	0.0	61	G5B1G9	195	255	1.9651803278688518	60
Q9CWV0	PF02410	90	187	3.858051020408165	97	G5BHC2	94	191	6.657622448979592	97
Q9WUK4	PF00004	66	183	0.3389237288135594	117	G5BG91	70	187	0.3115084745762713	117
Q9WUK4	PF08542	252	337	0.6995116279069765	85	G5BG91	256	341	0.7017558139534887	85
P97864	PF00656	67	300	6.242474358974357	233	G5BKD7	70	303	7.71507725321888	233
Q7TPD2	PF13349	136	265	0.10776153846153848	129	G5AJU4	149	278	0.3365692307692308	129
P58501	PF07842	596	808	3.9474647887323933	212	G5BE95	550	762	4.208732394366199	212
Q8VC12	PF01175	213	436	5.723950892857142	223	G5B0V5	214	437	7.195808035714289	223
Q8VC12	PF17391	84	210	5.35792125984252	126	G5B0V5	85	211	12.09484251968504	126
Q8VC12	PF17392	439	646	3.4093125000000017	207	G5B0V5	440	647	3.0712548076923096	207
O55060	PF05724	21	239	7.054671232876716	218	G5AXT8	27	244	6.972612903225808	217
Q04899	PF00069	120	401	5.758322695035461	281	G5BX43	170	451	6.189609929078017	281
Q9D720	PF07574	14	175	2.744388888888889	161	G5AJV7	38	199	2.619598765432099	161
Q9D720	PF08746	190	230	0.052585365853658535	40	G5AJV7	214	254	0.052585365853658535	40
Q8R5C8	PF00439	182	240	7.1512711864406775	58	G5BUT1	183	241	7.151338983050848	58
Q8R5C8	PF00855	280	348	0.502927536231884	68	G5BUT1	281	349	0.4811884057971014	68
Q3V3A7	PF00097	24	62	0.0	38	G5C568	25	63	0.0	38
Q3V3A7	PF00643	94	143	0.46743999999999997	49	G5C568	95	154	0.8139000000000001	59
Q3V3A7	PF12126	251	322	6.4621944444444415	71	G5C568	243	314	1.6858611111111117	71
P62192	PF00004	221	354	1.1905895522388066	133	G5AZZ0	222	355	1.1357313432835827	133
P62192	PF16450	108	162	18.137400000000003	54	G5AZZ0	109	163	18.47409090909091	54
P62192	PF17862	376	420	0.04426666666666667	44	G5AZZ0	377	421	0.044155555555555545	44
P14824	PF00191	32	88	2.018929824561404	56	G5BCB4	1	57	3.7846842105263163	56
P14824	PF00191	96	160	8.343892307692307	64	G5BCB4	65	129	9.688246153846151	64
P14824	PF00191	178	244	13.377074626865676	66	G5BCB4	307	373	14.472373134328356	66
P14824	PF00191	254	319	0.1023939393939394	65	G5BCB4	383	448	0.0976818181818182	65
P14824	PF00191	367	431	0.7572307692307693	64	G5BCB4	496	560	0.10352307692307693	64
P14824	PF00191	438	503	1.1521060606060607	65	G5BCB4	567	632	1.3820454545454546	65
P14824	PF00191	526	592	8.505955223880598	66	G5BCB4	655	721	9.781970149253732	66
P14824	PF00191	602	661	0.0946	59	G5BCB4	731	789	0.07471186440677967	58
O08543	PF00812	28	157	9.349792307692308	129	G5B3G9	29	158	9.323823076923077	129
Q61382	PF00097	17	54	0.0	37	G5BVI6	18	51	0.04205882352941177	33
Q61382	PF02176	101	155	0.0	54	G5BVI6	98	152	0.0	54
Q61382	PF02176	209	268	2.2734	59	G5BVI6	206	265	1.2088	59
Q66JQ7	PF19221	114	136	0.4992608695652173	22	G5BLZ4	154	176	7.888565217391305	22
Q66JQ7	PF19221	244	268	0.0	24	G5BLZ4	282	306	0.0	24
Q66JQ7	PF19221	404	421	0.0	17	G5BLZ4	438	455	2.1773888888888893	17
Q66JQ7	PF19221	451	471	0.0	20	G5BLZ4	486	506	0.037714285714285714	20
Q66JQ7	PF19221	540	559	0.0	19	G5BLZ4	808	829	3.7458636363636364	21
Q66JQ7	PF19221	624	642	11.185315789473686	18	G5BLZ4	717	735	13.540947368421055	18
Q66JQ7	PF19221	721	745	1.1030799999999998	24	G5BLZ4	807	831	3.32144	24
Q66JQ7	PF19221	803	825	0.1067391304347826	22	G5BLZ4	889	911	20.112086956521736	22
Q66JQ7	PF19221	1001	1025	9.7976	24	G5BLZ4	1105	1128	11.606249999999998	23
P23298	PF00069	354	613	6.669823076923077	259	G5C5I2	344	603	6.845161538461538	259
P23298	PF00130	171	224	12.948814814814822	53	G5C5I2	161	214	12.949962962962962	53
P23298	PF00130	245	296	1.1916346153846151	51	G5C5I2	235	286	1.1919807692307691	51
P23298	PF00168	11	117	0.2606074766355139	106	G5C5I2	1	107	0.26072897196261685	106
P23298	PF00433	634	675	0.0	41	G5C5I2	624	665	0.0	41
Q924Y0	PF02668	115	365	3.464537848605575	250	G5BA68	203	453	3.676254980079679	250
Q924Y0	PF06155	13	90	0.9365384615384608	77	G5BA68	14	91	1.8356025641025644	77
Q9DD03	PF00071	9	169	4.8420310559006206	160	G5BES5	10	174	5.377781818181819	164
Q922R8	PF00085	26	125	0.09418	99	G5B591	21	120	0.20164	99
Q922R8	PF00085	161	262	0.0	101	G5B591	156	257	0.0	101
Q04892	PF00505	7	75	1.5449565217391308	68	G5BC40	8	76	1.5449565217391308	68
Q04892	PF12336	76	191	0.0	115	G5BC40	77	192	0.0	115
Q5SXY1	PF00307	962	1065	5.153317307692307	103	G5BEU6	955	1058	6.109230769230769	103
Q60668	PF00076	99	166	8.228176470588236	67	G5ALN8	22	89	8.188397058823531	67
Q60668	PF00076	183	244	7.775548387096772	61	G5ALN8	106	167	7.742645161290323	61
Q8CA95	PF00233	517	748	4.941116379310344	231	G5BDY7	501	732	5.000047413793106	231
Q8CA95	PF01590	96	218	5.736292682926831	122	G5BDY7	80	202	6.569715447154473	122
Q8CA95	PF01590	270	415	9.637	145	G5BDY7	254	399	9.663075342465756	145
P53702	PF01265	8	263	0.33480859375	255	G5BRL4	9	263	0.4642745098039216	254
Q63850	PF05064	324	432	0.09073394495412848	108	G5B8R5	317	425	0.1753302752293578	108
Q9ES70	PF00069	44	295	3.631222222222224	251	G5B6W8	179	467	3.1928339100346026	288
Q9D0P7	PF15259	8	96	2.2969775280898874	88	G5BQV9	3	91	0.16819101123595498	88
Q3TVW5	PF13868	142	480	0.1148407079646018	338	G5B652	146	484	0.1274985250737463	338
Q64104	PF00104	181	365	4.7750108108108105	184	G5B6T0	242	426	4.774459459459454	184
Q64104	PF00105	14	84	0.1642957746478873	70	G5B6T0	75	145	0.1644507042253521	70
Q9WTR5	PF00028	145	234	1.3352555555555554	89	G5BFX4	94	183	9.035288888888887	89
Q9WTR5	PF00028	250	352	5.090621359223302	102	G5BFX4	199	301	5.1538834951456325	102
Q9WTR5	PF00028	368	468	6.761049504950492	100	G5BFX4	317	417	6.661930693069304	100
Q9WTR5	PF00028	486	574	15.793112359550562	88	G5BFX4	435	523	16.442337078651676	88
Q9WTR5	PF00028	588	679	7.016989130434786	91	G5BFX4	537	628	7.02575	91
Q9WTR5	PF08758	52	109	4.275	57	G5BFX4	1	58	3.03048275862069	57
O35284	PF00170	26	80	0.16087272727272725	54	G5B695	27	81	0.35890909090909096	54
Q9DBE0	PF00282	48	415	3.3483125000000014	367	G5BIH1	49	416	3.7424836956521736	367
Q8VCK5	PF00651	53	158	5.575735849056604	105	G5ART2	144	249	5.477207547169812	105
Q8VCK5	PF01344	314	346	10.100969696969694	32	G5ART2	294	326	0.6272424242424242	32
Q8VCK5	PF01344	352	387	2.6923888888888885	35	G5ART2	285	319	3.7182000000000013	34
Q8VCK5	PF01344	400	441	26.31633333333333	41	G5ART2	285	326	3.0985000000000005	41
Q8VCK5	PF01344	447	488	28.964547619047615	41	G5ART2	285	325	3.174073170731708	40
Q8VCK5	PF01344	492	529	3.2965526315789475	37	G5ART2	283	319	4.009216216216217	36
Q8VCK5	PF01344	541	579	6.486846153846158	38	G5ART2	285	323	3.3368461538461545	38
Q8VCK5	PF07707	164	195	0.0	31	G5ART2	255	285	1.2171935483870968	30
Q60760	PF00017	519	600	6.034317073170732	81	G5B3T7	568	649	8.485719512195121	81
Q60760	PF00169	319	423	5.432942857142859	104	G5B3T7	367	471	6.727133333333333	104
Q60760	PF00788	196	275	1.9246125	79	G5B3T7	244	323	1.1729749999999994	79
Q60760	PF08947	451	497	0.0	46	G5B3T7	500	546	0.0	46
P80315	PF00118	43	537	4.251589898989894	494	G5C1Y4	44	537	4.548860323886636	493
Q61016	PF00631	5	67	0.0	62	G5BZC3	6	68	0.0	62
Q9D992	PF15077	0	239	4.073283333333333	239	G5B6N0	1	239	9.457589958158998	238
Q9Z0Y7	PF02174	232	332	13.604207920792087	100	G5BZE0	180	280	13.516435643564366	100
Q5U4F6	PF00400	383	418	0.8578611111111111	35	G5ASE3	361	396	0.44552777777777774	35
Q5U4F6	PF00400	481	508	0.1816428571428572	27	G5ASE3	459	486	0.26475	27
Q09014	PF00018	161	206	1.271217391304348	45	G5C6B1	162	207	1.225217391304348	45
Q09014	PF00018	233	276	1.8558636363636367	43	G5C6B1	234	277	1.8030909090909093	43
Q09014	PF00787	30	119	0.2318777777777777	89	G5C6B1	31	120	0.2064777777777778	89
Q09014	PF08944	359	389	0.0	30	G5C6B1	355	385	0.08480645161290322	30
Q09014	PF16621	281	330	0.0	49	G5C6B1	282	331	0.0	49
Q811B3	PF00090	551	599	0.0	48	G5BJ34	425	473	0.0	48
Q811B3	PF01421	249	459	11.05854502369668	210	G5BJ34	78	333	9.133624999999997	255
Q811B3	PF05986	705	815	7.529972972972972	110	G5BJ34	579	689	7.753333333333331	110
Q811B3	PF17771	471	535	0.35504615384615384	64	G5BJ34	345	409	0.5394307692307693	64
Q811B3	PF19030	831	885	2.5699272727272717	54	G5BJ34	705	759	2.8394545454545463	54
Q811B3	PF19030	889	943	0.2415272727272727	54	G5BJ34	763	817	0.2423090909090909	54
Q811B3	PF19030	951	999	0.0	48	G5BJ34	825	873	0.0	48
Q811B3	PF19030	1321	1369	5.1212857142857136	48	G5BJ34	1204	1252	3.5470000000000006	48
Q811B3	PF19030	1372	1429	0.0	57	G5BJ34	1255	1312	0.0	57
Q811B3	PF19030	1432	1477	0.0	45	G5BJ34	1315	1360	0.0	45
Q811B3	PF19030	1480	1536	0.0	56	G5BJ34	1363	1419	0.0	56
Q80VJ3	PF05014	11	108	1.0983673469387754	97	G5BNL8	20	117	3.907346938775512	97
Q99LG0	PF00443	195	820	2.4677284345047923	625	G5B1C4	197	820	2.74352564102564	623
Q99LG0	PF02148	47	123	11.527298701298704	76	G5B1C4	48	125	6.981692307692309	77
Q80Z64	PF00046	97	152	0.04617857142857144	55	G5BPN0	92	147	0.20380357142857147	55
Q64429	PF00067	50	517	11.994519230769226	467	G5BZ89	75	478	9.746623762376236	403
Q9CQG1	PF04752	0	172	11.09952023121387	172	G5B8U6	1	173	10.600664739884387	172
Q8BKH7	PF05422	17	127	0.07144144144144142	110	G5B6V5	18	128	0.07547747747747748	110
Q8BKH7	PF16978	138	266	6.948511627906978	128	G5B6V5	139	267	6.949333333333334	128
Q8BKH7	PF16979	381	486	3.805301886792453	105	G5B6V5	382	487	4.590292452830188	105
Q9D4C1	PF00932	174	283	3.2035909090909103	109	G5BQA2	132	241	3.2388000000000003	109
Q3UAW9	PF08271	6	36	0.0	30	G5B099	7	37	0.006516129032258064	30
Q60899	PF00076	40	110	1.7880845070422542	70	G5BA28	69	139	1.6677323943661981	70
Q60899	PF00076	126	192	0.121865671641791	66	G5BA28	155	221	0.09637313432835816	66
Q60899	PF00076	278	347	7.845971428571428	69	G5BA28	306	375	6.498500000000003	69
D3YUB6	PF00651	51	136	4.712279069767441	85	G5ASI1	52	137	9.778	85
D3YUB6	PF00651	197	296	5.54815	99	G5ASI1	198	297	7.8751000000000015	99
P08775	PF00623	355	520	1.7457409638554218	165	G5B5C5	356	521	1.7457409638554218	165
P08775	PF04983	524	690	10.165862275449095	166	G5B5C5	525	691	10.165862275449095	166
P08775	PF04990	1163	1298	1.0561323529411766	135	G5B5C5	1164	1299	1.0561323529411766	135
P08775	PF04992	895	1078	1.5126684782608697	183	G5B5C5	896	1079	1.5126684782608697	183
P08775	PF04997	15	353	1.828203539823008	338	G5B5C5	16	354	1.827867256637168	338
P08775	PF04998	829	894	0.15378787878787878	65	G5B5C5	830	895	0.14425757575757575	65
P08775	PF05000	717	822	4.722754716981132	105	G5B5C5	718	823	4.722754716981132	105
P08775	PF05001	1615	1628	0.0	13	G5B5C5	1616	1629	0.0	13
P08775	PF05001	1629	1642	0.0	13	G5B5C5	1630	1643	0.0	13
P08775	PF05001	1615	1628	0.0	13	G5B5C5	1616	1629	0.0	13
P08775	PF05001	1615	1628	0.0	13	G5B5C5	1616	1629	0.0	13
P08775	PF05001	1615	1628	0.0	13	G5B5C5	1616	1629	0.0	13
P08775	PF05001	1615	1628	0.0	13	G5B5C5	1616	1629	0.0	13
P08775	PF05001	1615	1628	0.0	13	G5B5C5	1616	1629	0.0	13
P08775	PF05001	1615	1628	0.0	13	G5B5C5	1616	1629	0.0	13
P08775	PF05001	1615	1628	0.0	13	G5B5C5	1616	1629	0.0	13
P08775	PF05001	1741	1754	0.0	13	G5B5C5	1742	1755	0.0	13
P08775	PF05001	1616	1628	0.0	12	G5B5C5	1617	1629	0.0	12
P08775	PF05001	1769	1782	0.0	13	G5B5C5	1770	1783	0.0	13
P08775	PF05001	1615	1628	0.0	13	G5B5C5	1616	1629	0.0	13
P08775	PF05001	1797	1810	0.0	13	G5B5C5	1798	1811	0.0	13
P08775	PF05001	1804	1817	0.0	13	G5B5C5	1805	1818	0.0	13
P08775	PF05001	1825	1838	0.0	13	G5B5C5	1826	1839	0.0	13
P08775	PF05001	1840	1852	0.0	12	G5B5C5	1841	1853	0.0	12
P08775	PF05001	1854	1866	0.0	12	G5B5C5	1855	1867	0.0	12
P08775	PF05001	1860	1873	0.0	13	G5B5C5	1861	1874	0.0	13
P08775	PF05001	1867	1880	0.0	13	G5B5C5	1868	1881	0.0	13
P08775	PF05001	1888	1901	0.0	13	G5B5C5	1889	1902	0.0	13
P08775	PF05001	1895	1908	0.0	13	G5B5C5	1896	1909	0.0	13
P08775	PF05001	1909	1922	0.0	13	G5B5C5	1910	1923	0.0	13
P08775	PF05001	1867	1880	0.0	13	G5B5C5	1868	1881	0.0	13
P08775	PF05001	1909	1921	0.0	12	G5B5C5	1910	1922	0.0	12
P08775	PF05001	1940	1953	0.0	13	G5B5C5	1941	1954	0.0	13
P08775	PF05001	1947	1959	0.0	12	G5B5C5	1948	1960	0.0	12
Q920R0	PF00415	109	164	6.373571428571425	55	G5BW40	77	132	1.6867321428571436	55
Q920R0	PF00415	170	215	6.7081304347826105	45	G5BW40	138	183	6.642673913043478	45
Q920R0	PF00415	520	567	0.21197916666666672	47	G5BW40	799	846	0.19010416666666666	47
Q920R0	PF00415	572	618	3.7776382978723406	46	G5BW40	851	897	4.256808510638298	46
Q920R0	PF00621	688	867	4.628727777777779	179	G5BW40	967	1135	3.295224852071007	168
Q920R0	PF02204	1547	1646	7.87355	99	G5BW40	1710	1809	8.12847	99
Q920R0	PF02493	1042	1063	0.0	21	G5BW40	1264	1285	0.0	21
Q920R0	PF02493	1065	1084	0.0	19	G5BW40	1287	1306	0.0	19
Q920R0	PF02493	1093	1114	0.3038636363636363	21	G5BW40	1315	1336	0.3285454545454545	21
Q920R0	PF02493	1116	1132	0.0	16	G5BW40	1338	1354	0.0	16
Q920R0	PF02493	1144	1159	6.277000000000001	15	G5BW40	1366	1381	6.755374999999999	15
Q920R0	PF02493	1168	1182	5.0112	14	G5BW40	1390	1404	9.629666666666667	14
Q920R0	PF02493	1191	1210	1.96915	19	G5BW40	1413	1432	0.0	19
Q8BIZ6	PF00498	267	295	0.14255172413793105	28	G5B4G2	251	278	9.075607142857145	27
Q80W15	PF00050	103	142	0.0	39	G5C1D1	12	51	0.0	39
Q80W15	PF07679	146	251	2.55004716981132	105	G5C1D1	55	160	5.800924528301886	105
Q91WJ0	PF02174	19	106	0.31929545454545444	87	G5BNI4	20	107	0.4849886363636365	87
Q8VBV4	PF00400	376	409	2.201970588235294	33	G5BMJ4	375	408	2.2690882352941166	33
Q8VBV4	PF00400	413	449	0.2191891891891892	36	G5BMJ4	412	448	0.2191891891891892	36
Q8VBV4	PF00400	453	489	0.0	36	G5BMJ4	452	488	0.0	36
Q8VBV4	PF00400	493	529	4.2741891891891886	36	G5BMJ4	492	528	4.274486486486486	36
Q8VBV4	PF00400	534	569	0.513611111111111	35	G5BMJ4	533	568	0.513611111111111	35
Q8VBV4	PF00400	573	609	0.24597297297297305	36	G5BMJ4	572	608	0.2687297297297298	36
Q8VBV4	PF00400	613	652	2.5370250000000003	39	G5BMJ4	612	651	2.5407750000000004	39
Q8VBV4	PF12937	284	327	18.31834090909091	43	G5BMJ4	283	326	18.27809090909091	43
Q9D7M1	PF08513	27	52	19.79765384615385	25	G5C8E0	28	53	19.79765384615385	25
Q9D7M1	PF10607	64	205	4.233330985915494	141	G5C8E0	65	206	4.233330985915494	141
Q4U2R1	PF00173	1212	1282	4.764408450704223	70	G5AZH7	1213	1283	4.292000000000002	70
Q4U2R1	PF00415	514	566	0.6145471698113208	52	G5AZH7	515	567	0.6330566037735847	52
Q4U2R1	PF00415	569	612	0.5244090909090908	43	G5AZH7	570	613	0.5241590909090909	43
Q4U2R1	PF00415	623	672	1.2737800000000004	49	G5AZH7	624	673	1.63752	49
Q4U2R1	PF00415	675	724	0.045700000000000005	49	G5AZH7	676	725	0.0456	49
Q4U2R1	PF00415	3010	3062	0.7241886792452831	52	G5AZH7	3013	3065	0.8243207547169809	52
Q4U2R1	PF00415	3065	3114	0.1118	49	G5AZH7	3068	3117	0.1117	49
Q4U2R1	PF00415	3117	3160	0.3647045454545455	43	G5AZH7	3120	3163	0.3644545454545455	43
Q4U2R1	PF00415	3171	3220	0.8311599999999999	49	G5AZH7	3174	3223	0.8454	49
Q4U2R1	PF00415	3223	3272	6.096680000000001	49	G5AZH7	3226	3275	6.152380000000001	49
Q4U2R1	PF00415	3275	3323	0.5498775510204081	48	G5AZH7	3278	3326	0.7443877551020408	48
Q4U2R1	PF00415	4004	4055	0.03019230769230769	51	G5AZH7	4007	4058	0.03298076923076923	51
Q4U2R1	PF00415	4058	4107	0.0	49	G5AZH7	4061	4110	0.0	49
Q4U2R1	PF00415	4111	4153	0.19116279069767445	42	G5AZH7	4114	4156	0.2211860465116278	42
Q4U2R1	PF00415	4164	4213	1.0559999999999998	49	G5AZH7	4167	4216	1.08972	49
Q4U2R1	PF00415	4216	4264	3.047489795918368	48	G5AZH7	4219	4267	3.0568775510204094	48
Q4U2R1	PF00415	4268	4316	0.7929387755102041	48	G5AZH7	4271	4319	0.7925306122448978	48
Q4U2R1	PF00569	2702	2742	0.0	40	G5AZH7	2705	2745	0.0	40
Q4U2R1	PF00632	4517	4790	8.194332116788322	273	G5AZH7	4520	4788	7.382747211895911	268
Q4U2R1	PF03256	2803	2873	4.762549295774647	70	G5AZH7	2806	2876	4.761338028169017	70
Q4U2R1	PF06701	1870	1929	0.024600000000000004	59	G5AZH7	1873	1931	0.0	58
Q4U2R1	PF11515	2554	2630	3.334636363636362	76	G5AZH7	2557	2633	3.233454545454546	76
Q80US4	PF00022	31	569	0.8249165120593691	538	G5B808	30	567	1.0367825278810412	537
Q9D168	PF00628	160	212	3.9189999999999996	52	G5AT22	162	214	3.622792452830188	52
B2RY04	PF00018	13	59	1.2961063829787234	46	G5BYA9	172	260	4.277011235955055	88
B2RY04	PF06920	1133	1633	3.490411177644713	500	G5BYA9	1416	1876	3.1149240780911005	460
B2RY04	PF14429	438	634	9.220913705583756	196	G5BYA9	721	917	7.927390862944166	196
B2RY04	PF16172	107	433	3.4766911314984683	326	G5BYA9	390	716	1.8792752293577983	326
Q9ERR1	PF04880	134	291	2.1061898734177227	157	G5B5G1	135	292	2.015696202531646	157
A6H619	PF00628	186	232	0.0	46	G5C484	117	162	0.0	45
A6H619	PF13639	107	149	0.22253488372093025	42	G5C484	37	79	2.6458604651162787	42
Q9D952	PF00681	1688	1717	0.0	29	G5AQW0	1688	1717	0.0	29
Q9D952	PF00681	1857	1897	0.0	40	G5AQW0	1981	2021	0.0	40
Q9D952	PF00681	1895	1929	0.052714285714285714	34	G5AQW0	2019	2053	0.051857142857142866	34
Q9D952	PF00681	1937	1973	0.32602702702702696	36	G5AQW0	2061	2097	0.09897297297297301	36
Q9D952	PF17902	403	467	2.411153846153846	64	G5AQW0	404	468	0.06653846153846155	64
Q8BGK2	PF03747	5	214	2.6163142857142856	209	G5AVV5	6	214	3.233186602870814	208
Q9WUM3	PF00400	78	109	3.168	31	G5BSA5	79	110	3.23546875	31
Q9WUM3	PF00400	123	160	14.836342105263155	37	G5BSA5	124	161	15.755184210526314	37
Q9WUM3	PF00400	174	203	1.643233333333333	29	G5BSA5	175	204	1.8189	29
Q9WUM3	PF08953	4	69	9.076772727272733	65	G5BSA5	5	70	9.732484848484848	65
Q9WUM3	PF16300	344	386	0.2141627906976744	42	G5BSA5	345	387	0.8175581395348838	42
Q8CAF4	PF15273	261	883	0.1478057784911718	622	G5AUD0	261	872	0.4863660130718952	611
Q9DA57	PF15218	0	223	3.913540178571429	223	G5B7P5	1	215	4.169372093023256	214
Q8BZN6	PF00169	182	288	6.357429906542057	106	G5AYD5	137	243	6.352728971962618	106
Q8BZN6	PF06920	1591	2143	3.041696202531645	552	G5AYD5	1514	2064	2.6674718693284944	550
Q8BZN6	PF11878	45	154	2.6958454545454544	109	G5AYD5	30	109	0.02	79
Q8BZN6	PF14429	669	858	6.778136842105262	189	G5AYD5	592	781	11.443857894736846	189
Q9D074	PF13920	274	319	0.17273913043478262	45	G5C0K1	275	320	0.17252173913043478	45
P09450	PF00170	262	325	0.024765625	63	G5BYX1	224	287	0.017812500000000002	63
P09450	PF03957	4	253	0.05523599999999998	249	G5BYX1	5	215	0.018582938388625597	210
P58137	PF13622	47	308	1.6301755725190838	261	G5B7P2	48	309	2.3207251908396946	261
Q9D7A6	PF01922	17	113	7.294731958762887	96	G5BA33	18	114	3.1712061855670104	96
Q3SXB8	PF00059	160	266	6.141579439252339	106	G5C7L1	164	270	9.723616822429909	106
Q3SXB8	PF01391	41	86	0.0	45	G5C7L1	45	90	0.0	45
Q3SXB8	PF01391	59	101	0.0	42	G5C7L1	63	104	0.0	41
Q6PAC3	PF00400	58	94	0.9249189189189191	36	G5C0G4	59	97	1.4916666666666667	38
Q6PAC3	PF00400	98	136	2.2504102564102557	38	G5C0G4	101	139	2.250410256410257	38
Q6PAC3	PF00400	279	308	2.0920333333333336	29	G5C0G4	282	311	2.091333333333333	29
Q6PAC3	PF00400	326	352	0.0425925925925926	26	G5C0G4	329	355	19.835333333333335	26
Q6PAC3	PF04158	353	439	1.2553678160919541	86	G5C0G4	356	442	2.341367816091954	86
Q7TN89	PF00071	60	199	4.915392857142859	139	G5BJI1	1	140	4.226978571428573	139
Q80ZM7	PF02268	2	47	8.682956521739133	45	G5AWC6	3	48	8.683978260869567	45
Q80ZM7	PF02751	58	99	12.15983333333334	41	G5AWC6	59	100	12.155738095238096	41
Q5DU37	PF01363	1797	1860	0.3620468749999999	63	G5C7X2	1804	1867	0.26696875	63
Q80SY6	PF00962	16	339	3.3615061728395053	323	G5BM46	18	341	3.826537037037037	323
Q8BM75	PF01388	321	406	8.368232558139534	85	G5BQL0	154	239	8.368058139534883	85
Q64092	PF00010	345	398	0.0	53	G5BJJ2	283	336	0.0	53
Q64092	PF11851	454	570	0.007435897435897435	116	G5BJJ2	342	453	0.0078125	111
Q64092	PF15951	111	219	1.918045871559632	108	G5BJJ2	90	196	2.0276355140186912	106
Q8CCE9	PF00096	220	242	0.0	22	G5AQD8	215	237	0.0	22
Q8CCE9	PF00096	248	268	0.0	20	G5AQD8	243	263	0.0	20
Q8CCE9	PF00096	433	455	0.0	22	G5AQD8	428	450	0.0	22
Q8CCE9	PF00096	461	483	0.0	22	G5AQD8	456	478	0.0	22
Q8CCE9	PF00096	517	539	0.0	22	G5AQD8	512	534	0.0	22
Q8CCE9	PF13912	191	216	0.6736153846153847	25	G5AQD8	186	211	4.978538461538459	25
Q9D084	PF15630	15	90	0.7808289473684207	75	G5C529	17	92	0.7585	75
Q60610	PF00169	446	545	9.73725	99	G5BEA7	446	545	9.59381	99
Q60610	PF00169	1283	1393	11.197675675675674	110	G5BEA7	1283	1393	11.536027027027028	110
Q60610	PF00621	1043	1231	3.3622222222222207	188	G5BEA7	1043	1231	3.598137566137567	188
Q60610	PF00595	855	917	0.5455079365079366	62	G5BEA7	855	917	0.06782539682539683	62
Q60610	PF02196	766	837	0.7718472222222222	71	G5BEA7	766	837	0.7711527777777779	71
Q60610	PF18385	571	668	1.1917551020408166	97	G5BEA7	571	668	1.1904897959183671	97
Q6NS69	PF09422	220	439	0.0	219	G5B9X3	102	322	0.008416289592760182	220
Q570Y9	PF00610	49	116	0.07602941176470589	67	G5C9R0	19	86	0.07420588235294116	67
Q570Y9	PF00610	158	216	0.18506779661016948	58	G5C9R0	175	233	0.1846271186440678	58
Q9Z265	PF00069	225	489	8.261932075471696	264	G5APY6	239	475	9.28985232067511	236
Q9Z265	PF00498	116	194	6.6606962025316445	78	G5APY6	130	208	2.159924050632912	78
Q9D0M2	PF10497	272	370	5.310202020202022	98	G5ALR3	333	431	5.308262626262628	98
P45878	PF00254	40	131	3.753260869565219	91	G5B6Q7	39	130	3.7610326086956514	91
S4R1M9	PF00169	96	171	8.854605263157891	75	G5BIW2	29	134	12.655528301886802	105
S4R1M9	PF01237	403	762	2.24465	359	G5BIW2	366	725	2.4972333333333343	359
Q9Z309	PF13499	106	172	3.978761194029852	66	G5AUL1	107	173	3.9203880597014935	66
Q8R574	PF13793	27	137	11.717450450450453	110	G5BKM8	28	138	11.752045045045044	110
Q8R574	PF14572	178	362	5.265794594594592	184	G5BKM8	179	363	5.284994594594592	184
O09172	PF00248	76	211	1.6097941176470587	135	G5AW25	36	171	1.8230808823529407	135
Q63844	PF00069	55	330	4.216134057971016	275	G5BRC2	1	276	4.228217391304345	275
Q3TDN2	PF00789	358	439	3.046658536585365	81	G5BPZ0	289	370	3.0652439024390237	81
Q3TDN2	PF14555	14	54	0.0	40	G5BPZ0	15	55	0.0	40
Q8BGE6	PF03416	39	333	4.452149152542375	294	G5C3S2	118	416	5.39092642140468	298
Q9CWW7	PF00628	27	74	0.1818125	47	G5BVS6	91	138	0.1678125	47
Q9CWW7	PF02008	166	211	0.0	45	G5BVS6	225	270	0.0	45
Q9CWW7	PF12269	403	639	1.3597468354430382	236	G5BVS6	462	698	1.5441054852320677	236
Q9CZW6	PF02825	104	168	12.479830769230773	64	G5C4S4	116	180	12.320984615384614	64
Q8BYR5	PF00169	492	591	16.038939999999993	99	G5AZD9	491	590	13.935510000000004	99
Q8BYR5	PF06292	801	894	6.648414893617022	93	G5AZD9	803	893	6.867923076923074	90
O88935	PF02078	114	211	5.908591836734695	97	G5B0C4	14	111	4.805061224489795	97
O88935	PF02750	213	415	3.1526699507389173	202	G5B0C4	113	315	3.177965517241377	202
Q9CQE3	PF00366	14	81	0.6900588235294117	67	G5ASS0	15	82	1.1147205882352942	67
Q99JI4	PF01399	253	276	49.503875	23	G5B0Q4	205	227	22.199652173913044	22
Q99JI4	PF10602	65	238	15.456247126436786	173	G5B0Q4	17	190	15.466310344827587	173
Q9Z280	PF00169	221	326	10.943216981132073	105	G5BT75	223	328	10.958226415094336	105
Q9Z280	PF00614	458	485	14.000821428571431	27	G5BT75	460	487	11.635142857142856	27
Q9Z280	PF00787	107	207	0.05735643564356439	100	G5BT75	108	209	0.011549019607843136	101
Q9Z280	PF13091	767	935	2.8881301775147934	168	G5BT75	769	936	4.0955833333333365	167
A1IGU4	PF00621	34	210	5.487570621468927	176	G5C3A2	33	209	9.420847457627124	176
A1IGU4	PF03114	330	436	11.788177570093456	106	G5C3A2	333	439	1.6140654205607474	106
A1IGU4	PF07653	510	561	6.994538461538463	51	G5C3A2	513	564	6.968115384615384	51
A1IGU4	PF14604	609	660	0.4890384615384615	51	G5C3A2	610	661	0.09394230769230767	51
O08749	PF02852	388	496	0.4755504587155961	108	G5C2C6	389	497	0.4626146788990825	108
O08749	PF07992	42	369	4.973771341463414	327	G5C2C6	43	370	4.802637195121948	327
P53798	PF00494	47	318	8.138514705882349	271	G5AMF4	45	316	8.484599264705881	271
Q3TXS7	PF01851	440	472	7.835848484848482	32	G5ASV5	404	436	7.851393939393941	32
Q3TXS7	PF01851	475	507	0.0523030303030303	32	G5ASV5	439	471	0.05248484848484848	32
Q3TXS7	PF01851	510	543	13.909117647058823	33	G5ASV5	474	507	13.883852941176468	33
Q3TXS7	PF13646	600	689	10.505599999999996	89	G5ASV5	564	653	11.463122222222225	89
Q3TXS7	PF18004	785	921	5.220620437956204	136	G5ASV5	749	885	5.187547445255475	136
Q91XI1	PF01207	295	530	2.6144449152542384	235	G5C0Q2	304	539	1.0744491525423732	235
Q91XI1	PF18044	110	134	0.0	24	G5C0Q2	117	141	0.0	24
P20108	PF00578	65	197	8.319428571428569	132	G5BVX3	54	186	8.19887218045113	132
P20108	PF10417	218	253	1.19425	35	G5BVX3	207	242	0.9629444444444444	35
Q8BZB2	PF02441	18	192	4.530582857142859	174	G5AL72	19	192	4.852068965517243	173
Q66T02	PF00621	410	595	8.469129032258065	185	G5C562	576	755	8.44692777777778	179
Q64527	PF00110	37	335	1.3770635451505018	298	G5BA36	38	336	0.7679632107023412	298
Q7TNC6	PF00225	494	752	4.506038610038608	258	G5ALQ3	129	386	4.540476744186047	257
Q810I2	PF00622	389	451	1.2391746031746032	62	G5BG71	355	417	4.599968253968253	62
Q810I2	PF00643	85	124	0.7414499999999998	39	G5BG71	86	125	0.5511749999999999	39
Q810I2	PF13445	15	53	0.028358974358974363	38	G5BG71	16	54	0.1591025641025641	38
Q810I2	PF13765	294	342	0.30506122448979595	48	G5BG71	296	344	0.4591836734693878	48
E9PYL2	PF13926	1818	1943	0.057142857142857134	125	G5B8P8	1591	1716	0.05745238095238096	125
P70271	PF00412	254	304	4.4612156862745085	50	G5BJ29	233	283	4.468372549019607	50
P70271	PF00595	31	79	0.5987346938775511	48	G5BJ29	10	58	0.6026326530612245	48
P70271	PF15936	151	220	0.0	69	G5BJ29	130	198	0.0	68
Q91WC0	PF00856	224	313	6.100422222222222	89	G5B4A5	334	423	6.27748888888889	89
Q91WC0	PF09273	345	474	3.8685692307692303	129	G5B4A5	455	587	8.332969924812026	132
Q78YZ6	PF10224	54	118	0.17875384615384607	64	G5BQF2	35	99	0.18084615384615374	64
D3Z6P0	PF00085	53	150	4.446326530612245	97	G5BXX5	55	152	0.4684183673469387	97
D3Z6P0	PF00085	392	494	0.14925242718446602	102	G5BXX5	394	496	0.0	102
D3Z6P0	PF13848	181	367	16.57535828877005	186	G5BXX5	183	369	11.341759358288776	186
Q8C0I1	PF01565	192	333	0.4917464788732398	141	G5BU00	120	261	0.4692535211267603	141
Q8C0I1	PF02913	370	641	8.670058823529411	271	G5BU00	298	569	8.257647058823528	271
Q9JME5	PF01602	37	588	10.602260869565216	551	G5B1R3	5	556	10.603663043478251	551
Q9JME5	PF14796	803	946	0.4837291666666666	143	G5B1R3	772	915	0.736625	143
Q9D2H9	PF14580	166	292	0.2968897637795274	126	G5BFY2	173	299	0.8338897637795273	126
Q8C0I4	PF06752	578	807	0.4379652173913045	229	G5B7T5	504	733	0.450816593886463	229
Q8C0I4	PF10513	71	147	0.0	76	G5B7T5	1	77	0.0	76
Q9CQL2	PF15482	3	217	1.3599813953488369	214	G5BSJ2	2	213	0.013042452830188678	211
Q5U3K5	PF08477	44	101	0.13824137931034486	57	G5BQQ6	45	102	0.1448448275862069	57
Q8VDG3	PF08675	429	506	1.6494230769230762	77	G5B4F1	433	510	1.5130641025641025	77
Q8VDG3	PF01424	171	235	0.08236923076923075	64	G5B4F1	175	239	2.5695538461538456	64
Q8VDG3	PF04857	5	170	6.1685120481927695	165	G5B4F1	1	174	7.758045977011496	173
Q8C1S0	PF10278	62	232	0.025309941520467838	170	G5BLJ9	63	232	0.02504705882352941	169
E9Q6W4	PF00096	213	233	0.0	20	G5CBL9	230	250	0.14328571428571427	20
E9Q6W4	PF00096	361	381	0.0	20	G5CBL9	386	406	0.0	20
E9Q6W4	PF00096	387	409	0.0	22	G5CBL9	256	278	0.0	22
P01326	PF00049	27	108	2.2247195121951218	81	G5C2F2	28	109	2.038963414634146	81
Q9QYY7	PF00219	27	82	0.0	55	G5C6X7	28	83	0.0	55
Q80XC2	PF08704	63	286	3.7966919642857127	223	G5AWH1	64	286	3.2145919282511204	222
Q8BPM2	PF00069	19	276	4.463453488372096	257	G5BLN0	20	277	4.656949612403103	257
Q8BPM2	PF00780	516	815	8.877093333333336	299	G5BLN0	517	815	8.78962876254181	298
Q8R554	PF02338	206	370	6.588793939393941	164	G5B6H7	215	417	5.466339901477834	202
Q9ES03	PF00907	100	286	4.939240641711232	186	G5BZ14	6	192	4.922866310160426	186
Q501P1	PF00008	139	169	0.0	30	G5BQY5	140	170	0.0	30
Q501P1	PF00084	80	133	2.088518518518519	53	G5BQY5	81	134	1.7244814814814813	53
Q501P1	PF07645	270	318	0.0	48	G5BQY5	267	315	0.0	48
Q501P1	PF14670	240	268	0.0	28	G5BQY5	237	265	0.0	28
Q9EQF6	PF01979	56	445	2.8417051282051267	389	G5CBJ9	57	446	3.75120256410256	389
Q61456	PF00134	169	294	13.135444444444447	125	G5B3M3	197	322	13.433960317460306	125
Q61456	PF02984	297	413	8.27428205128205	116	G5B3M3	325	441	8.619837606837606	116
Q9CXJ1	PF00749	40	350	1.142681672025723	310	G5BV73	10	320	1.5182733118971063	310
P12787	PF02284	41	141	3.2505940594059415	100	G5AL69	13	113	3.2596534653465334	100
Q8K4T5	PF00782	73	199	11.619787401574804	126	G5AVJ7	75	201	10.148519685039368	126
P23927	PF00011	67	160	0.2529255319148936	93	E3VX52	68	161	0.2529787234042553	93
P23927	PF00525	0	55	0.012232142857142856	55	E3VX52	1	56	0.0	55
Q8VHJ7	PF00076	903	957	0.16590909090909087	54	G5C3A1	905	959	0.03963636363636363	54
Q91YI6	PF03828	385	439	7.6997454545454564	54	G5AST7	386	440	7.695981818181819	54
Q91YI6	PF19088	160	361	7.676183168316832	201	G5AST7	161	362	8.940975247524747	201
P62317	PF01423	36	108	5.745602739726027	72	G5AUX4	27	99	7.083356164383559	72
Q04863	PF16179	281	377	12.183701030927837	96	G5CBM1	302	398	12.227577319587624	96
Q04863	PF00554	104	272	4.622976331360947	168	G5CBM1	125	293	2.9456863905325443	168
Q04863	PF16180	18	75	0.15353448275862064	57	G5CBM1	28	93	0.1760151515151515	65
Q04863	PF16181	380	493	0.8633508771929825	113	G5CBM1	401	514	0.07092105263157895	113
Q9CZ13	PF00675	57	203	2.542591836734692	146	G5AVL7	58	204	2.9004761904761898	146
Q9CZ13	PF05193	210	394	3.4999405405405413	184	G5AVL7	211	395	1.7211675675675668	184
D3YYU8	PF07679	17	100	4.138261904761905	83	G5AKI7	83	167	0.7598235294117648	84
D3YYU8	PF07679	165	225	0.19278688524590165	60	G5AKI7	1	57	0.5529824561403509	56
D3YYU8	PF07679	250	335	0.4837558139534885	85	G5AKI7	82	167	0.7509883720930234	85
D3YYU8	PF07679	341	417	0.8896233766233765	76	G5AKI7	173	249	0.05628571428571428	76
D3YYU8	PF07679	726	789	1.560484375	63	G5AKI7	558	621	0.50040625	63
D3YYU8	PF07679	915	978	1.2917656249999998	63	G5AKI7	747	810	1.661	63
D3YYU8	PF07679	1097	1157	0.0	60	G5AKI7	929	989	0.01163934426229508	60
D3YYU8	PF07679	1179	1261	0.2566385542168674	82	G5AKI7	1011	1093	0.649421686746988	82
D3YYU8	PF07679	1270	1348	0.26003797468354434	78	G5AKI7	1194	1272	0.4425696202531645	78
D3YYU8	PF07679	1358	1430	0.06920547945205477	72	G5AKI7	1282	1354	4.0452876712328765	72
D3YYU8	PF07679	1537	1610	0.35143243243243244	73	G5AKI7	1461	1533	0.05391780821917809	72
D3YYU8	PF07679	1628	1695	3.162485294117648	67	G5AKI7	1552	1619	7.136499999999999	67
D3YYU8	PF07679	1720	1791	0.06527777777777778	71	G5AKI7	1644	1715	5.263	71
D3YYU8	PF13927	803	880	0.2472179487179487	77	G5AKI7	635	712	0.28252564102564115	77
O35205	PF00089	25	252	3.535692982456141	227	G5C6X6	27	250	6.327183035714278	223
Q924A2	PF00505	1107	1174	4.559235294117649	67	G5AZR3	201	268	4.524	67
P11798	PF08332	345	472	0.9455546875000002	127	G5C394	463	590	0.93065625	127
P11798	PF00069	12	270	4.471247104247103	258	G5C394	119	377	4.464637065637065	258
Q3U1T3	PF08598	61	188	0.11321093750000005	127	G5B121	62	189	0.11340625000000007	127
Q8C726	PF00651	32	134	8.294650485436893	102	G5B9F6	45	147	9.110184466019415	102
Q8C726	PF00754	291	391	1.6471188118811881	100	G5B9F6	304	403	5.90091	99
Q8C726	PF00754	443	539	4.371577319587629	96	G5B9F6	304	399	4.339145833333333	95
Q8C726	PF07707	142	238	12.540381443298967	96	G5B9F6	155	251	12.560824742268041	96
Q9QYF9	PF03096	31	316	3.8602657342657385	285	G5B832	32	317	3.5609510489510465	285
Q00420	PF12796	10	100	0.4384835164835165	90	G5CA49	11	101	0.484043956043956	90
Q00420	PF13637	104	155	1.7701346153846156	51	G5CA49	105	156	1.797326923076923	51
P08046	PF00096	335	359	0.0	24	G5BA46	332	356	0.0	24
P08046	PF00096	365	387	0.0	22	G5BA46	362	384	0.0	22
P08046	PF00096	393	415	0.0	22	G5BA46	390	412	0.0	22
P08046	PF11914	437	519	0.4311686746987952	82	G5BA46	442	524	0.10766265060240966	82
P08046	PF11928	131	216	3.076755813953488	85	G5BA46	127	212	2.9356627906976738	85
Q8VHX6	PF00307	37	142	9.934358490566039	105	G5BH96	28	133	9.965160377358496	105
Q8VHX6	PF00307	160	259	1.2471199999999998	99	G5BH96	151	250	1.24655	99
Q8VHX6	PF00630	274	365	8.243760869565218	91	G5BH96	265	356	8.240347826086955	91
Q8VHX6	PF00630	374	464	6.291571428571428	90	G5BH96	365	455	6.290703296703295	90
Q8VHX6	PF00630	472	562	7.166681318681319	90	G5BH96	463	553	7.166219780219781	90
Q8VHX6	PF00630	570	654	0.10861176470588237	84	G5BH96	561	645	0.11181176470588236	84
Q8VHX6	PF00630	665	755	2.5603846153846157	90	G5BH96	656	746	2.5579230769230765	90
Q8VHX6	PF00630	762	858	7.043268041237114	96	G5BH96	753	849	7.043123711340207	96
Q8VHX6	PF00630	866	956	3.1407912087912084	90	G5BH96	857	940	3.8290952380952383	83
Q8VHX6	PF00630	965	1052	0.0	87	G5BH96	949	1036	0.0	87
Q8VHX6	PF00630	1060	1146	2.39235632183908	86	G5BH96	1044	1130	2.3914827586206897	86
Q8VHX6	PF00630	1153	1239	0.6180344827586207	86	G5BH96	1137	1223	0.6179540229885058	86
Q8VHX6	PF00630	1248	1341	0.023670212765957446	93	G5BH96	1232	1325	0.060755319148936164	93
Q8VHX6	PF00630	1348	1434	0.11229885057471263	86	G5BH96	1332	1418	0.11316091954022987	86
Q8VHX6	PF00630	1441	1530	1.2752666666666663	89	G5BH96	1425	1514	1.274666666666667	89
Q8VHX6	PF00630	1538	1627	1.7987222222222232	89	G5BH96	1522	1611	1.0807555555555552	89
Q8VHX6	PF00630	1634	1731	3.5673673469387746	97	G5BH96	1618	1715	3.5686632653061223	97
Q8VHX6	PF00630	1793	1850	0.08927586206896551	57	G5BH96	1777	1834	0.1792586206896552	57
Q8VHX6	PF00630	1859	1943	7.66367058823529	84	G5BH96	1843	1927	7.662176470588234	84
Q8VHX6	PF00630	2040	2125	0.7841162790697674	85	G5BH96	2024	2109	0.7917790697674421	85
Q8VHX6	PF00630	2238	2303	0.09712121212121212	65	G5BH96	2222	2287	0.1455909090909091	65
Q8VHX6	PF00630	2314	2397	1.6439285714285714	83	G5BH96	2298	2381	1.6432023809523808	83
Q8VHX6	PF00630	2418	2493	0.22794736842105265	75	G5BH96	2402	2477	0.2278421052631579	75
Q8VHX6	PF00630	2503	2589	2.7637816091954015	86	G5BH96	2487	2573	3.261919540229885	86
Q8VHX6	PF00630	2633	2721	8.451966292134832	88	G5BH96	2617	2714	7.706153061224486	97
P61082	PF00179	36	166	13.060488549618318	130	G5B3G2	1	131	13.030641221374044	130
Q80T85	PF00400	48	80	0.08606060606060606	32	G5APV7	49	81	0.10712121212121213	32
Q80T85	PF00400	138	170	0.8017575757575757	32	G5APV7	139	171	0.6175757575757577	32
Q80T85	PF00400	327	360	1.6119999999999999	33	G5APV7	328	361	0.8387941176470591	33
O70145	PF00018	245	290	16.043652173913046	45	G5B446	246	291	16.027478260869568	45
O70145	PF00018	461	506	19.52510869565217	45	G5B446	463	508	16.665717391304348	45
O70145	PF00515	70	98	1.7770344827586204	28	G5B446	71	99	3.9756896551724146	28
O70145	PF00564	350	426	6.999519480519482	76	G5B446	352	428	6.925610389610389	76
O70145	PF13181	37	67	1.2958709677419356	30	G5B446	38	68	0.029677419354838714	30
Q9CQF0	PF00298	83	154	2.3492638888888884	71	G5BWY1	84	155	1.9032500000000008	71
Q9CQF0	PF03946	16	77	0.01370967741935484	61	G5BWY1	17	78	0.012290322580645163	61
Q8CIV7	PF00096	173	196	0.0	23	G5CBA6	170	193	0.0	23
Q8CIV7	PF00096	212	235	0.02479166666666667	23	G5CBA6	209	232	0.0	23
Q8CIV7	PF13894	146	167	0.0	21	G5CBA6	143	164	0.0	21
Q8CIV7	PF13912	117	140	0.0	23	G5CBA6	114	137	0.0	23
Q7TSH3	PF00096	33	55	0.0	22	G5C0K9	34	56	0.0	22
Q7TSH3	PF00096	235	257	0.32308695652173913	22	G5C0K9	235	257	0.2632608695652173	22
Q7TSH3	PF00096	265	285	0.0	20	G5C0K9	265	285	0.0	20
Q7TSH3	PF00096	1091	1113	0.059173913043478264	22	G5C0K9	1092	1114	0.10004347826086957	22
Q7TSH3	PF13909	61	84	0.0	23	G5C0K9	62	85	0.0	23
Q8CAK3	PF15135	31	271	0.20275103734439828	240	G5B340	1	205	0.2431463414634145	204
Q6ZPK0	PF00628	498	542	4.373044444444443	44	G5ATB2	503	547	4.379422222222224	44
P25785	PF00965	43	202	0.15346249999999995	159	G5AVF5	1	160	0.14287499999999995	159
Q99LY9	PF10200	0	95	1.5566770833333332	95	G5BP30	1	96	0.0	95
P47911	PF01159	188	295	1.1457222222222223	107	G5AKV6	180	287	1.4006448598130838	107
P47911	PF03868	42	102	2.728049180327869	60	G5AKV6	35	93	2.707118644067797	58
Q9CR59	PF10147	98	193	0.0	95	G5BYV9	1	95	0.0	94
Q80U22	PF02759	1034	1166	12.343827067669167	132	G5BL06	1034	1166	12.386406015037599	132
Q80U22	PF07653	1449	1498	0.69506	49	G5BL06	1444	1493	4.1706199999999995	49
Q9CZ83	PF09776	8	123	0.93825	115	G5C106	10	123	0.15200000000000005	113
Q8BTX9	PF00106	68	253	6.7925806451612925	185	G5BFY1	69	254	5.493258064516129	185
Q3UIL6	PF00169	164	279	9.965646551724138	115	G5B0I2	92	207	9.824353448275856	115
Q400C8	PF07998	240	296	10.380350877192985	56	G5BLS3	241	297	9.161526315789473	56
Q9Z2Q5	PF09812	44	198	0.053303225806451617	154	G5CA11	45	199	0.042909677419354836	154
Q91VF2	PF13489	33	214	6.758494505494506	181	G5ARN5	34	214	6.794104972375691	180
Q3UI66	PF13904	62	314	0.3845217391304348	252	G5BA67	91	340	0.28657599999999994	249
Q61751	PF00096	183	205	0.07239130434782608	22	G5B5Z1	99	121	0.25734782608695644	22
Q61751	PF00096	211	233	0.0	22	G5B5Z1	127	149	0.0	22
Q61751	PF00096	239	261	0.02869565217391305	22	G5B5Z1	155	177	0.028260869565217388	22
Q61751	PF00096	267	289	0.0	22	G5B5Z1	183	205	0.05760869565217393	22
Q61751	PF00096	320	342	0.0	22	G5B5Z1	238	260	0.0	22
Q61751	PF00096	348	370	0.0	22	G5B5Z1	266	288	0.0	22
Q61751	PF00096	404	426	0.5473913043478261	22	G5B5Z1	322	344	0.5421739130434783	22
Q61751	PF00096	433	454	0.0	21	G5B5Z1	351	372	0.0	21
Q61751	PF00096	488	510	0.0	22	G5B5Z1	406	428	0.0	22
Q61751	PF00096	516	538	0.0	22	G5B5Z1	434	456	0.0	22
Q61751	PF00096	544	566	0.0	22	G5B5Z1	462	484	0.0	22
Q61751	PF13894	460	482	0.0	22	G5B5Z1	378	400	0.0	22
Q61751	PF16622	376	397	0.0	21	G5B5Z1	294	315	0.0	21
P15089	PF00246	124	402	2.786598566308243	278	G5BSK4	125	402	3.3842625899280603	277
P15089	PF02244	26	102	0.09338961038961037	76	G5BSK4	27	103	0.061571428571428576	76
Q91W61	PF00646	18	55	0.040210526315789474	37	G5CAH3	19	56	0.05118421052631579	37
Q91W61	PF13516	217	240	0.0	23	G5CAH3	158	181	0.0	23
Q6QI06	PF14663	746	851	2.472679245283019	105	G5ANE1	747	852	2.470490566037736	105
Q6QI06	PF14664	57	438	6.6120811518324665	381	G5ANE1	58	439	6.608013089005241	381
Q6QI06	PF14665	1083	1185	0.0	102	G5ANE1	1084	1187	0.008028846153846156	103
Q6QI06	PF14666	641	739	7.077101010101007	98	G5ANE1	642	740	7.0660101010100975	98
Q6QI06	PF14668	921	990	10.19037142857143	69	G5ANE1	922	991	10.18312857142857	69
Q9Z2U2	PF00096	806	830	0.0	24	G5B6Y0	752	776	0.0	24
Q9JLV5	PF00888	33	664	4.160110759493668	631	G5AYD4	12	649	5.422047021943572	637
Q9JLV5	PF10557	697	759	0.3386507936507937	62	G5AYD4	682	744	0.3387777777777778	62
Q91YJ2	PF00787	99	182	9.756630952380949	83	G5AQ78	100	183	7.834095238095238	83
Q2MH31	PF15181	0	259	1.122030769230769	259	G5B056	1	266	1.1097094339622644	265
Q8BTW3	PF01138	35	85	0.6939411764705882	50	G5B5W4	36	85	0.69544	49
Q9CU62	PF02463	2	513	2.7203281250000013	511	G5BAY7	3	514	2.693408203125001	511
Q9CU62	PF06470	514	628	1.9763391304347824	114	G5BAY7	515	629	1.9763391304347824	114
Q80XF5	PF01108	64	112	0.16997959183673467	48	G5C1B5	1	49	0.03295918367346938	48
Q80XF5	PF09294	124	227	5.1720865384615395	103	G5C1B5	61	163	7.588718446601941	102
Q62393	PF04201	48	202	0.08042580645161289	154	G5BAJ5	49	200	0.0647171052631579	151
O08664	PF04714	31	50	0.54225	19	G5BYK1	41	60	0.52725	19
Q9QXT1	PF00017	34	108	0.18596	74	G5AP63	35	109	0.09482666666666673	74
Q9QXT1	PF00169	166	254	1.229561797752809	88	G5AP63	167	255	1.2295168539325847	88
Q8BHG2	PF05907	4	156	0.14102614379084974	152	G5C9K7	3	155	0.12952287581699345	152
Q9DBD5	PF08166	423	477	11.837309090909093	54	G5BWB3	422	476	11.92703636363636	54
Q9DBD5	PF08166	569	637	8.507304347826087	68	G5BWB3	552	620	8.020478260869563	68
Q9DBD5	PF08167	84	228	6.670331034482759	144	G5BWB3	85	227	7.2278111888111924	142
Q04891	PF00505	415	483	5.522623188405796	68	G5BML7	416	484	5.52891304347826	68
Q80YW0	PF00169	260	373	2.9409473684210528	113	G5BAU9	261	374	2.9423596491228072	113
Q80YW0	PF01369	62	242	7.132149171270718	180	G5BAU9	63	243	6.701662983425412	180
Q8VCL2	PF02630	90	224	12.638037037037034	134	G5B2G4	102	236	13.606822222222226	134
Q6P3E7	PF00850	24	320	5.78348484848485	296	G5B2I1	25	321	7.5400942760942735	296
Q8BPB5	PF07645	43	70	0.0	27	G5BKK1	17	44	0.0	27
Q8BPB5	PF07645	172	211	0.198125	39	G5BKK1	146	185	0.196625	39
Q8BPB5	PF07645	345	376	0.05328125	31	G5BKK1	306	337	0.0	31
Q8BPB5	PF12662	233	256	0.028958333333333336	23	G5BKK1	207	230	4.115624999999999	23
Q8BPB5	PF12662	273	296	1.4974583333333331	23	G5BKK1	247	270	1.9413333333333336	23
Q8R1G1	PF01112	43	325	1.2771660777385148	282	G5ALV4	44	326	1.118021201413428	282
P97481	PF00989	92	171	6.639325000000004	79	G5C9T6	85	164	6.510237499999998	79
P97481	PF08447	254	340	2.3049425287356318	86	G5C9T6	247	333	2.627310344827587	86
P97481	PF08778	837	872	0.0	35	G5C9T6	826	861	0.0	35
P97481	PF11413	515	547	0.0	32	G5C9T6	508	540	0.0	32
Q8CIV8	PF14560	456	521	0.12674242424242424	65	G5BTJ8	263	328	0.1252424242424242	65
Q8CIV8	PF14580	304	388	1.1376235294117651	84	G5BTJ8	127	215	0.4364382022471909	88
Q9JJN0	PF00817	11	225	5.565176744186045	214	G5BNN0	12	227	3.0918703703703705	215
Q9JJN0	PF11799	307	429	8.91129268292683	122	G5BNN0	309	430	10.312803278688524	121
Q9JJN0	PF18439	611	641	0.0	30	G5BNN0	629	659	0.0	30
P41183	PF00096	574	596	0.0	22	G5BTD0	574	596	0.0	22
P41183	PF00096	602	624	0.3982608695652174	22	G5BTD0	602	624	0.39869565217391306	22
P41183	PF00096	630	652	0.0	22	G5BTD0	630	652	0.0	22
P41183	PF00651	21	127	20.770981308411212	106	G5BTD0	22	128	21.311168224299067	106
Q9JI78	PF04721	453	647	2.7835794871794883	194	G5BF99	454	648	4.281420512820515	194
Q9JI78	PF09409	25	101	4.088675324675325	76	G5BF99	24	100	4.080636363636364	76
Q9JI78	PF01841	264	350	0.14105747126436785	86	G5BF99	265	351	0.14017241379310344	86
Q9D8X5	PF04857	14	131	7.290516949152541	117	G5AY06	15	132	7.290516949152541	117
Q9D8X5	PF04857	146	237	4.886467391304348	91	G5AY06	147	238	5.16925	91
Q8C436	PF10294	22	191	5.162811764705881	169	G5BLM5	14	183	5.1864411764705896	169
Q1RNF8	PF00536	402	461	0.06191666666666665	59	G5ATS1	504	563	0.6309833333333332	59
Q0VF58	PF01391	291	345	0.0	54	G5ALV0	141	195	0.0	54
Q0VF58	PF01391	330	387	0.0	57	G5ALV0	180	236	0.0	56
Q0VF58	PF01391	530	576	0.0	46	G5ALV0	676	722	0.0	46
Q0VF58	PF01391	571	617	0.0	46	G5ALV0	717	763	0.0	46
Q0VF58	PF01391	619	672	0.0	53	G5ALV0	765	815	0.0	50
Q0VF58	PF01391	754	804	0.0	50	G5ALV0	897	946	0.0	49
Q0VF58	PF01391	852	880	0.0	28	G5ALV0	995	1022	0.0	27
Q8R0Z5	PF00153	70	159	4.1819	89	G5C4U4	71	160	4.2652777777777775	89
Q8R0Z5	PF00153	170	253	0.5224761904761905	83	G5C4U4	171	254	0.5224761904761905	83
Q8R0Z5	PF00153	259	355	14.488783505154641	96	G5C4U4	260	356	14.488659793814435	96
Q7M6Z4	PF00225	10	340	6.6923353474320235	330	G5ARN1	11	341	6.8483323262839875	330
Q8BH35	PF00057	119	153	0.029485714285714282	34	G5APP5	120	154	0.029657142857142858	34
Q8BH35	PF00090	66	114	0.0	48	G5APP5	67	115	0.023142857142857142	48
Q8BH35	PF00090	546	588	0.0363953488372093	42	G5APP5	564	606	0.07678571428571429	42
Q8BH35	PF01823	280	494	2.976786046511628	214	G5APP5	281	512	1.954956896551724	231
Q03141	PF02149	710	752	0.030930232558139537	42	G5AWH0	716	758	0.03154761904761905	42
Q03141	PF00069	55	306	7.420738095238093	251	G5AWH0	39	311	7.628362637362637	272
Q03141	PF00627	327	362	14.172416666666667	35	G5AWH0	332	367	16.204250000000002	35
Q9ESS2	PF00167	31	155	4.3071920000000015	124	G5C5W5	61	185	2.4122960000000004	124
Q99ML9	PF13639	935	977	2.1918837209302318	42	G5AQ66	944	986	2.1922325581395348	42
Q99ML9	PF15303	23	286	0.002840909090909091	263	G5AQ66	25	285	0.0323984674329502	260
P51655	PF01153	19	531	0.9366276803118908	512	G5AXH4	2	554	1.110808318264014	552
Q91YE6	PF03810	42	116	0.6599599999999999	74	G5B397	43	117	0.6596133333333329	74
Q03385	PF00617	327	533	2.5379613526570037	206	G5ANW6	357	563	2.5917584541062797	206
Q03385	PF00618	60	168	8.51842201834863	108	G5ANW6	87	195	9.021559633027524	108
Q03385	PF00788	736	820	2.8602823529411765	84	G5ANW6	766	850	2.876188235294117	84
Q99JY9	PF00022	4	408	5.393834567901235	404	G5C3T1	5	409	5.292696296296297	404
Q9CQP2	PF04628	31	135	7.58431428571429	104	G5B7H8	1	112	11.013142857142864	111
P43346	PF01712	23	254	2.517659482758621	231	G5BN04	25	255	2.473155844155845	230
P15307	PF00554	9	177	3.2283846153846145	168	G5C1Z9	55	223	0.36208875739644975	168
P15307	PF16179	186	281	5.348802083333332	95	G5C1Z9	232	327	5.3455104166666665	95
Q9D0A0	PF09737	141	546	6.1263399014778335	405	G5CA81	183	588	6.1166206896551705	405
Q8BK75	PF09807	1	250	11.133260000000002	249	G5BTA4	2	302	10.070056478405306	300
Q6NZK5	PF15369	91	413	0.3356037151702787	322	G5C753	79	412	2.3724101796407187	333
Q8BX17	PF00400	56	94	0.4727179487179488	38	G5AY05	57	95	0.4651794871794874	38
Q8BX17	PF00400	630	667	0.4005263157894737	37	G5AY05	630	667	1.6240263157894743	37
Q8BX17	PF12894	116	203	15.750863636363631	87	G5AY05	117	204	14.579988636363636	87
Q8BX17	PF12894	421	478	0.7074827586206895	57	G5AY05	421	478	4.431362068965519	57
Q8BX17	PF12894	539	586	5.3051875	47	G5AY05	539	586	0.1	47
Q5DTW2	PF00536	866	928	6.0685873015873	62	G5ARR1	822	884	9.092984126984126	62
Q5DTW2	PF02820	76	145	19.6035	69	G5ARR1	77	146	19.60301428571428	69
Q5DTW2	PF02820	190	256	15.684074626865671	66	G5ARR1	191	257	16.826567164179107	66
Q5DTW2	PF02820	302	373	3.4034861111111105	71	G5ARR1	303	374	0.992625	71
Q5DTW2	PF02820	409	475	11.782746268656714	66	G5ARR1	411	477	4.318820895522388	66
Q5DTW2	PF12140	530	641	9.445151785714286	111	G5ARR1	530	641	8.200366071428572	111
Q76I79	PF00782	315	443	3.955108527131784	128	G5AWZ3	316	444	3.95224031007752	128
Q76I79	PF08766	250	302	4.305433962264152	52	G5AWZ3	251	303	4.4397358490566035	52
O70340	PF00354	229	413	7.195486486486484	184	G5AX82	209	393	7.280362162162158	184
Q8K4Z0	PF03736	223	264	9.583285714285717	41	G5B025	198	239	9.59959523809524	41
Q8K4Z0	PF03736	270	310	18.636341463414634	40	G5B025	245	285	18.636756097560976	40
Q8K4Z0	PF03736	315	361	8.552212765957448	46	G5B025	290	336	9.276829787234046	46
Q8K4Z0	PF03736	364	406	0.4599302325581396	42	G5B025	339	381	0.462860465116279	42
Q8K4Z0	PF03736	411	453	0.968186046511628	42	G5B025	386	428	0.9740232558139538	42
Q8K4Z0	PF03736	456	497	0.2061904761904762	41	G5B025	431	472	0.20650000000000007	41
Q8K4Z0	PF13855	93	140	2.0305208333333327	47	G5B025	76	122	1.6392553191489363	46
Q9JHR7	PF00675	73	210	3.8801884057971017	137	G5BV05	84	221	3.9933478260869566	137
Q9JHR7	PF05193	237	415	7.424474860335191	178	G5BV05	248	426	7.397882681564248	178
Q9JHR7	PF05193	706	888	4.966322404371587	182	G5BV05	708	890	4.979497267759563	182
Q9JHR7	PF16187	421	701	3.0754519572953747	280	G5BV05	432	703	3.291772058823529	271
Q8BI71	PF06046	188	720	4.264294559099433	532	G5C649	228	761	6.518005617977527	533
Q8BJ42	PF03359	714	1058	0.967855072463768	344	G5AYM8	690	1036	0.9827283236994218	346
Q69Z23	PF03028	3854	3981	6.775570312500004	127	G5AVF2	3863	3993	6.403816793893131	130
Q69Z23	PF08385	186	763	5.678164359861598	577	G5AVF2	190	767	6.242598615916954	577
Q69Z23	PF08393	1261	1666	2.2049901477832505	405	G5AVF2	1267	1672	2.2814088669950743	405
Q69Z23	PF12774	1792	2118	10.269978593272173	326	G5AVF2	1801	2127	12.147541284403674	326
Q69Z23	PF12775	2399	2578	6.22575	179	G5AVF2	2408	2587	5.434383333333333	179
Q69Z23	PF12777	3026	3369	9.244191860465119	343	G5AVF2	3035	3378	9.409787790697674	343
Q69Z23	PF12780	2754	3013	10.023126923076925	259	G5AVF2	2763	3022	8.03088461538462	259
Q69Z23	PF12781	3396	3613	5.404963302752292	217	G5AVF2	3405	3622	5.344188073394495	217
Q69Z23	PF17852	2277	2394	18.920432203389822	117	G5AVF2	2286	2403	15.73503389830508	117
Q69Z23	PF17857	2611	2709	6.46446464646464	98	G5AVF2	2620	2718	3.5270101010101	98
Q69Z23	PF18198	3998	4149	11.100565789473688	151	G5AVF2	4010	4161	10.930513157894733	151
Q69Z23	PF18199	4157	4478	10.299478260869568	321	G5AVF2	4169	4491	10.017498452012381	322
B2KFW1	PF00096	752	774	0.0	22	G5B5L2	768	790	0.0	22
B2KFW1	PF00096	780	802	0.0	22	G5B5L2	796	818	0.0	22
B2KFW1	PF00096	861	883	0.0	22	G5B5L2	876	898	0.0	22
B2KFW1	PF00096	889	911	0.0	22	G5B5L2	904	926	0.0	22
B2KFW1	PF00096	917	939	0.0	22	G5B5L2	932	954	0.0	22
B2KFW1	PF00096	945	967	0.0	22	G5B5L2	960	982	0.0	22
B2KFW1	PF00096	973	995	0.17282608695652174	22	G5B5L2	988	1010	0.17239130434782607	22
B2KFW1	PF00096	1001	1023	0.0	22	G5B5L2	1016	1038	0.0	22
B2KFW1	PF02023	40	125	1.1286279069767449	85	G5B5L2	46	131	4.338197674418603	85
B2KFW1	PF13837	315	399	5.961964705882353	84	G5B5L2	326	410	5.961223529411765	84
B2KFW1	PF13837	477	560	7.1008333333333375	83	G5B5L2	487	570	6.592928571428572	83
Q99K70	PF04670	75	287	11.718117370892019	212	G5BP34	1	213	11.721037558685449	212
P50428	PF00884	19	344	4.447797546012271	325	G5B2F7	21	346	5.014288343558284	325
P50428	PF14707	366	498	0.13306015037593988	132	G5B2F7	368	500	0.12636842105263155	132
Q8VHQ3	PF12796	73	160	3.4801250000000006	87	G5B807	74	161	3.6774772727272733	87
Q8VHQ3	PF12796	214	289	0.15627631578947365	75	G5B807	215	290	0.1529342105263158	75
Q3TSG4	PF13532	136	274	5.048669064748202	138	G5BMX4	92	230	5.0551942446043165	138
Q80SY4	PF00569	78	121	0.0765	43	G5BTR7	79	122	0.07622727272727271	43
Q80SY4	PF06701	14	71	7.041379310344827	57	G5BTR7	15	72	7.035517241379309	57
Q80SY4	PF06701	153	217	5.171723076923077	64	G5BTR7	154	218	5.164538461538461	64
Q80SY4	PF12796	510	592	4.413939759036143	82	G5BTR7	512	594	4.405457831325301	82
Q80SY4	PF12796	593	661	0.0	68	G5BTR7	595	652	0.041120689655172425	57
Q80SY4	PF13637	667	707	0.03648780487804878	40	G5BTR7	533	572	0.7277	39
Q80SY4	PF13920	816	858	0.0	42	G5BTR7	753	795	0.0	42
Q80SY4	PF13920	863	905	0.8172093023255814	42	G5BTR7	800	842	0.8165116279069767	42
Q80SY4	PF13920	959	1000	1.435166666666667	41	G5BTR7	896	937	1.4327380952380953	41
Q80SY4	PF18346	245	310	0.008636363636363636	65	G5BTR7	246	311	0.008636363636363636	65
Q80SY4	PF18346	332	396	0.04486153846153845	64	G5BTR7	333	397	0.04461538461538461	64
Q921I6	PF00018	60	105	0.2060434782608697	45	G5AY42	61	106	0.16595652173913047	45
Q921I6	PF00791	321	402	5.89929268292683	81	G5AY42	321	402	4.034524390243901	81
Q921I6	PF07653	656	719	9.586453124999997	63	G5AY42	656	719	6.583234375000001	63
Q9CWB5	PF01470	19	85	0.4676865671641792	66	G5ARX8	63	129	1.0756417910447762	66
P26231	PF01044	18	333	2.7422088607594937	315	G5AZ65	19	334	2.5143512658227856	315
P26231	PF01044	337	866	2.9097924528301884	529	G5AZ65	338	877	2.888679629629628	539
Q8BUB4	PF00400	190	226	1.8236486486486496	36	G5BUX5	146	182	3.8523243243243255	36
Q8BUB4	PF00400	236	269	4.2595294117647065	33	G5BUX5	192	225	4.48585294117647	33
Q8BUB4	PF00400	362	393	0.34078125000000004	31	G5BUX5	318	349	0.3622500000000001	31
Q8BUB4	PF01363	283	350	0.752220588235294	67	G5BUX5	239	306	0.7536029411764706	67
P97873	PF01186	402	603	0.04042574257425744	201	G5BRF7	432	633	0.04033168316831681	201
P35293	PF00071	9	169	6.047763975155282	160	G5C147	10	169	5.831549999999999	159
Q99PJ2	PF15227	14	54	5.465926829268294	40	G5CAH9	15	55	5.42380487804878	40
Q9D083	PF08286	82	190	2.8491926605504587	108	G5BUI6	83	191	3.2239908256880736	108
Q99J99	PF00581	16	136	1.3914958677685945	120	G5BAV5	28	147	2.2906416666666662	119
Q99J99	PF00581	165	280	5.273758620689655	115	G5BAV5	177	292	3.9361637931034488	115
Q9DB70	PF04930	53	152	16.83144	99	G5BTN3	54	153	15.334420000000001	99
Q8R2V2	PF00038	397	474	0.0	77	G5BZM1	267	344	0.0	77
Q8CFK6	PF02141	91	291	10.365298507462684	200	G5C4F2	92	292	10.795333333333335	200
Q8CFK6	PF03455	356	407	0.013365384615384616	51	G5C4F2	357	408	0.013461538461538462	51
Q8CFK6	PF03456	28	85	2.3683275862068967	57	G5C4F2	29	86	2.3652413793103446	57
Q7TNV0	PF08766	324	355	0.0	31	G5AXU0	291	321	0.08661290322580646	30
P97450	PF05511	0	96	2.5112989690721648	96	G5BQQ2	8	104	2.3817628865979383	96
Q8R1Y2	PF12130	49	146	0.03051020408163265	97	G5AK07	51	148	0.030612244897959183	97
P31313	PF00046	232	288	11.754561403508776	56	G5BIE6	235	291	11.757754385964912	56
P31313	PF12045	41	161	0.01863636363636364	120	G5BIE6	42	162	0.01863636363636364	120
P60898	PF01096	83	123	3.035658536585366	40	G5BK10	84	124	3.035658536585366	40
P60898	PF02150	13	49	2.308756756756757	36	G5BK10	14	50	2.344108108108108	36
Q61239	PF01239	113	142	0.3573666666666667	29	G5B3P3	114	143	0.3569333333333333	29
Q61239	PF01239	147	177	6.588548387096774	30	G5B3P3	148	178	5.580967741935483	30
Q61239	PF01239	182	211	0.15316666666666665	29	G5B3P3	183	212	0.17983333333333332	29
Q61239	PF01239	215	245	0.09564516129032258	30	G5B3P3	216	246	3.45525806451613	30
Q61239	PF01239	255	284	0.3367333333333334	29	G5B3P3	256	285	0.34600000000000003	29
Q07235	PF00079	33	396	8.33226648351648	363	G5AYD1	46	409	8.736674931129475	363
Q91ZQ5	PF03055	16	529	5.7206070038910495	513	G5BSQ6	15	528	4.741303501945525	513
Q9CPS6	PF11969	30	140	0.8631981981981984	110	G5C4S8	9	119	0.011936936936936936	110
Q9JIH2	PF00638	349	462	8.951385964912284	113	G5BKH9	352	467	3.3166034482758624	115
Q9JIH2	PF08911	1	63	0.020634920634920638	62	G5BKH9	2	64	0.019444444444444445	62
Q8K1M4	PF00096	433	456	0.0	23	G5C9L1	263	286	0.0	23
Q8K1M4	PF00096	492	516	0.0	24	G5C9L1	322	346	0.0	24
Q8BGC1	PF12640	18	255	0.7003487394957988	237	G5AJR6	19	258	0.1098125	239
Q9WVP1	PF00928	156	420	2.252094339622641	264	G5BUH5	157	423	2.0143820224719096	266
Q9WVP1	PF01217	4	134	18.422007633587786	130	G5BUH5	5	135	17.7948320610687	130
Q9WTM5	PF06068	20	363	3.440331395348838	343	G5BAG3	21	364	3.440331395348838	343
Q9WTM5	PF17856	369	434	13.43018181818182	65	G5BAG3	370	435	13.43018181818182	65
O54946	PF00226	2	65	0.03921875	63	G5C8S1	3	66	0.04	63
Q9D1G5	PF13855	37	96	0.0	59	G5BM32	38	97	0.0	59
Q9EQC5	PF00069	34	222	11.425291005291006	188	G5B6K6	35	223	10.897232804232805	188
P80314	PF00118	35	523	1.7353905930470357	488	G5C7U4	36	524	1.726451942740287	488
O88958	PF01182	16	234	3.6597762557077615	218	G5AQR6	17	235	3.7227442922374423	218
Q6ZQ93	PF00443	1930	2114	1.995594594594596	184	G5C1Z0	1678	1816	2.1566402877697857	138
Q6ZQ93	PF12030	2395	2681	12.234184668989556	286	G5C1Z0	1941	2167	11.171321585903085	226
Q80TZ3	PF10409	251	388	1.6649420289855077	137	G5BSN9	292	429	4.326014492753627	137
Q62120	PF07714	545	804	1.6805461538461557	259	G5B4Y4	546	805	1.7164884615384617	259
Q62120	PF07714	848	1119	4.1734558823529415	271	G5B4Y4	849	1120	3.615172794117645	271
Q62120	PF00017	400	480	8.22679012345679	80	G5B4Y4	401	481	8.2277037037037	80
Q62120	PF17887	301	380	4.536975000000001	79	G5B4Y4	302	381	4.5263875	79
Q62120	PF18377	142	260	6.039487394957981	118	G5B4Y4	143	261	6.0317058823529415	118
Q62120	PF18379	38	133	3.8753958333333336	95	G5B4Y4	39	134	4.5789895833333345	95
Q8BGV0	PF00152	193	470	4.61868345323741	277	G5AW60	1	278	4.794665467625901	277
P56477	PF00605	15	119	0.7329047619047617	104	G5BH92	16	120	2.2607523809523804	104
P56477	PF10401	246	428	2.3524644808743176	182	G5BH92	247	429	2.322398907103824	182
P97494	PF03074	235	466	4.906271551724137	231	G5BBE2	236	466	4.977308695652172	230
P28271	PF00330	62	563	7.293772908366531	501	G5C354	63	564	6.704984063745023	501
P28271	PF00694	692	817	3.552507936507937	125	G5C354	693	818	3.5490873015873	125
P26040	PF00373	92	205	5.417315789473681	113	G5BCM2	113	226	5.4465964912280675	113
P26040	PF00769	337	585	0.04347389558232932	248	G5BCM2	358	606	0.043548387096774194	248
P26040	PF09379	8	67	12.155399999999995	59	G5BCM2	29	88	12.153600000000004	59
P26040	PF09380	209	297	1.0629887640449438	88	G5BCM2	230	318	1.060876404494382	88
Q01063	PF00233	399	640	3.7000826446280985	241	G5C027	251	492	3.6961900826446237	241
Q01063	PF18100	161	277	0.4032820512820516	116	G5C027	13	129	0.4022991452991455	116
Q8C4Y3	PF06209	106	577	4.743298728813559	471	G5BFZ3	107	568	3.657852813852813	461
A2AL36	PF14580	148	277	6.396576923076924	129	G5AXS3	151	280	6.385830769230768	129
Q9D0D4	PF00398	29	255	2.566035242290751	226	G5AVR1	16	242	2.128185022026432	226
Q6NV72	PF15390	1	637	5.44723704866562	636	G5C382	2	637	5.572910377358488	635
Q8QZV7	PF10221	4	691	2.8912616279069794	687	G5AVM9	5	692	3.0405087209302346	687
Q9DC71	PF00312	108	187	5.4197500000000005	79	G5C6G4	107	186	4.2064	79
Q8BR65	PF08598	61	174	0.0518859649122807	113	G5AKT9	61	173	0.052389380530973466	112
D3Z5T1	PF14739	62	116	0.0	54	G5BXV3	53	106	0.014444444444444447	53
Q03350	PF00090	384	429	0.0	45	G5C7R0	385	430	0.0	45
Q03350	PF00090	440	490	0.016274509803921568	50	G5C7R0	441	491	0.016274509803921568	50
Q03350	PF00090	497	547	0.06374509803921567	50	G5C7R0	498	548	0.06386274509803921	50
Q03350	PF00093	319	373	0.0	54	G5C7R0	320	374	0.002363636363636364	54
Q03350	PF02412	728	763	0.021388888888888888	35	G5C7R0	729	764	0.021388888888888888	35
Q03350	PF02412	765	786	0.0	21	G5C7R0	766	787	0.0	21
Q03350	PF02412	788	822	0.0	34	G5C7R0	789	823	0.0	34
Q03350	PF02412	823	845	0.0	22	G5C7R0	824	846	0.0	22
Q03350	PF02412	847	883	0.0	36	G5C7R0	848	884	0.0	36
Q03350	PF02412	885	919	0.0	34	G5C7R0	886	920	0.0	34
Q03350	PF02412	920	951	0.0	31	G5C7R0	921	952	0.0	31
Q03350	PF05735	973	1170	6.551818181818183	197	G5C7R0	974	1170	6.603512690355327	196
Q03350	PF07645	589	628	0.08637500000000001	39	G5C7R0	590	628	1.5347179487179483	38
Q03350	PF12947	651	690	0.02575	39	G5C7R0	652	691	0.025875	39
O54788	PF02017	45	81	2.990135135135135	36	G5CBI1	12	47	6.158388888888887	35
O54788	PF09230	103	264	0.8119320987654319	161	G5CBI1	70	230	0.9553664596273291	160
O55142	PF01247	4	103	0.09945999999999997	99	G5ALA5	2	101	0.1008282828282828	99
P24526	PF00061	6	130	0.26555199999999995	124	G5BAK8	7	131	0.385432	124
Q3TRM8	PF00349	32	227	3.74486224489796	195	G5BPZ7	35	230	5.3803112244898	195
Q3TRM8	PF00349	480	671	5.136609375	191	G5BPZ7	483	674	5.123432291666667	191
Q3TRM8	PF03727	235	469	10.145468085106382	234	G5BPZ7	238	472	4.233029787234039	234
Q3TRM8	PF03727	677	911	3.8824851063829793	234	G5BPZ7	680	914	7.454165957446809	234
Q80Y86	PF00069	15	304	2.576817241379308	289	G5AWE8	16	305	3.45116206896552	289
P97492	PF00615	66	181	1.244870689655173	115	G5BQ06	67	182	0.9328879310344832	115
P97492	PF02188	500	521	0.0	21	G5BQ06	501	519	0.0	18
P97492	PF02196	303	371	2.659521739130436	68	G5BQ06	304	372	2.8650289855072453	68
P97492	PF02196	388	442	0.09038181818181816	54	G5BQ06	389	443	0.395	54
P22892	PF01602	22	572	5.05635390199637	550	G5BNU1	32	582	5.056357531760434	550
P22892	PF02883	704	816	5.110646017699117	112	G5BNU1	714	826	5.110690265486727	112
Q9QY83	PF00022	49	417	0.90310298102981	368	G5BAD5	49	419	0.6375081081081084	370
Q66X19	PF02758	9	84	1.715171052631579	75	G5CAV3	11	86	1.1511184210526315	75
Q66X19	PF05729	151	315	12.292139393939395	164	G5CAV3	150	314	8.158103030303026	164
Q66X19	PF13516	745	759	0.03793333333333333	14	G5CAV3	748	761	0.0	13
Q66X19	PF13516	801	823	0.05869565217391305	22	G5CAV3	804	826	0.03656521739130435	22
Q66X19	PF13516	857	880	0.0	23	G5CAV3	860	883	0.0	23
Q66X19	PF17776	450	563	24.68734210526315	113	G5CAV3	449	563	30.27580869565217	114
Q66X19	PF17779	393	448	3.544696428571428	55	G5CAV3	392	447	1.1783928571428577	55
P97343	PF00069	59	295	6.527253164556958	236	G5BU48	71	303	6.649781115879833	232
P97343	PF00076	344	397	4.692111111111111	53	G5BU48	361	414	6.1950555555555535	53
Q8K1H1	PF12872	5	70	1.4758030303030305	65	G5C1C9	6	70	0.0	64
Q8K1H1	PF12872	224	258	0.11351428571428568	34	G5C1C9	236	270	0.06465714285714287	34
Q8K1H1	PF00567	447	568	1.4506803278688525	121	G5C1C9	460	598	5.996100719424458	138
Q8K1H1	PF00567	637	761	0.029480000000000006	124	G5C1C9	667	791	0.011880000000000005	124
Q8K1H1	PF00567	898	1013	3.356620689655172	115	G5C1C9	928	1043	4.428603448275861	115
P19096	PF00109	0	237	5.697668067226889	237	G5BJ97	1	238	6.209193277310928	237
P19096	PF00698	492	808	6.396927444794952	316	G5BJ97	493	809	6.257911671924293	316
P19096	PF02801	242	358	2.3492307692307697	116	G5BJ97	243	359	3.081863247863248	116
P19096	PF16197	361	471	1.674873873873874	110	G5BJ97	362	472	2.162522522522522	110
P19096	PF00107	1671	1806	3.583375	135	G5BJ97	1621	1756	6.921448529411767	135
P19096	PF00550	2119	2178	0.015166666666666669	59	G5BJ97	2068	2127	0.38531666666666653	59
P19096	PF00975	2234	2492	6.148154440154444	258	G5BJ97	2184	2409	5.065451327433627	225
P19096	PF08242	1238	1321	0.14880952380952386	83	G5BJ97	1241	1330	0.24985555555555555	89
P19096	PF08659	1878	2056	7.133916201117313	178	G5BJ97	1828	2006	6.132178770949719	178
P19096	PF14765	871	1062	5.54236458333333	191	G5BJ97	872	1063	3.4999583333333337	191
Q5SNZ0	PF19047	16	164	6.658644295302013	148	G5B8W7	17	122	2.213575471698113	105
Q8JZQ5	PF01179	301	709	6.398396088019568	408	G5AMS3	338	746	3.7104914425427857	408
Q8JZQ5	PF02727	38	123	10.133895348837207	85	G5AMS3	75	160	10.052476744186043	85
Q8JZQ5	PF02728	140	239	2.88572	99	G5AMS3	177	276	3.6745699999999983	99
Q62009	PF02469	112	232	1.9697603305785119	120	G5C7K7	111	231	2.043884297520661	120
Q62009	PF02469	247	368	0.08567213114754099	121	G5C7K7	246	367	0.14059836065573775	121
Q62009	PF02469	382	495	0.4917631578947368	113	G5C7K7	381	494	0.1634035087719298	113
Q62009	PF02469	509	631	6.4339593495935015	122	G5C7K7	508	630	6.449097560975607	122
Q99NH0	PF00013	1724	1785	0.9781290322580646	61	G5B5P4	1664	1726	1.2885555555555557	62
Q99NH0	PF00023	329	359	16.797387096774195	30	G5B5P4	266	296	16.799806451612902	30
Q99NH0	PF00023	361	392	0.11450000000000002	31	G5B5P4	298	329	0.11450000000000002	31
Q99NH0	PF12796	233	325	1.6254086021505374	92	G5B5P4	170	262	1.6258279569892469	92
Q99NH0	PF12796	393	457	0.6597538461538459	64	G5B5P4	330	394	0.6598769230769229	64
Q99NH0	PF12796	463	524	9.225064516129034	61	G5B5P4	400	461	9.226612903225806	61
Q99NH0	PF12796	563	654	4.064347826086957	91	G5B5P4	500	591	4.065282608695653	91
Q99NH0	PF12796	657	714	8.28737931034483	57	G5B5P4	594	651	8.288241379310346	57
Q99NH0	PF12796	1070	1140	2.787929577464788	70	G5B5P4	1007	1077	2.7886056338028165	70
Q99NH0	PF12796	1145	1207	0.7005396825396824	62	G5B5P4	1082	1144	0.7005396825396827	62
Q99NH0	PF12796	1217	1308	5.666206521739126	91	G5B5P4	1155	1246	5.624804347826083	91
Q99NH0	PF12796	1319	1402	4.394797619047621	83	G5B5P4	1257	1340	4.09236904761905	83
P0CB42	PF13532	98	343	2.502646341463413	245	G5AW36	99	344	3.0617926829268285	245
Q9Z2R9	PF00069	166	238	0.2491506849315067	72	G5BF36	167	239	0.09949315068493153	72
Q9Z2R9	PF00069	377	578	2.9612128712871284	201	G5BF36	377	579	4.166812807881774	202
Q9CX80	PF00042	22	130	17.0372752293578	108	G5AQU5	3	111	19.90736697247707	108
Q91X51	PF04495	67	202	0.9906838235294112	135	G5C5N6	67	202	0.33498529411764705	135
Q6P6M7	PF05889	60	457	4.934804020100508	397	G5B024	61	458	4.06964070351759	397
P25322	PF00134	27	151	5.4539120000000025	124	G5BSR9	28	152	5.455695999999998	124
P25322	PF02984	154	270	4.34559829059829	116	G5BSR9	155	271	6.544435897435897	116
O35864	PF01398	52	162	1.0481441441441441	110	G5AQN1	53	163	1.0575315315315317	110
O35864	PF18323	250	328	0.23037974683544302	78	G5AQN1	251	329	0.228481012658228	78
Q8BFR1	PF18606	4	58	6.648527272727272	54	G5B552	5	59	0.7059090909090909	54
Q99JR5	PF00112	201	451	2.5394541832669315	250	G5BUA5	203	453	2.5822231075697206	250
Q62431	PF01388	245	330	11.307976744186046	85	G5C5X9	228	313	11.30767441860465	85
P09092	PF00046	154	210	0.09266666666666666	56	G5BD54	156	212	0.09266666666666666	56
Q8VI67	PF00096	290	314	0.0	24	G5BIF9	221	245	0.0	24
Q8VI67	PF00096	320	344	15.84888	24	G5BIF9	251	275	13.872759999999998	24
Q8VI67	PF00096	350	372	0.2578260869565217	22	G5BIF9	281	303	0.2067391304347826	22
Q810P2	PF07004	235	261	0.10029629629629627	26	G5AL81	264	290	0.0	26
O70445	PF12796	419	509	4.221472527472528	90	G5BHR8	381	471	0.4712197802197802	90
O70445	PF14835	47	98	0.15588461538461534	51	G5BHR8	1	52	0.2414807692307692	51
Q01705	PF07645	177	209	0.0	32	G5B6A9	175	207	0.0	32
Q01705	PF07645	294	328	0.060514285714285715	34	G5B6A9	292	326	0.060514285714285715	34
Q01705	PF07645	411	444	0.0	33	G5B6A9	409	442	0.0	33
Q01705	PF07645	451	482	0.0	31	G5B6A9	449	480	0.0	31
Q01705	PF07645	868	901	0.0	33	G5B6A9	866	899	0.0	33
Q01705	PF12796	1905	1978	3.816527027027027	73	G5B6A9	1909	1982	5.09487837837838	73
Q01705	PF12796	1988	2079	7.6660326086956525	91	G5B6A9	1992	2083	7.1023478260869535	91
Q01705	PF00008	62	95	0.0	33	G5B6A9	60	93	0.0	33
Q01705	PF00008	105	135	0.10983870967741936	30	G5B6A9	103	133	0.10967741935483873	30
Q01705	PF00008	143	173	0.0	30	G5B6A9	141	171	0.0	30
Q01705	PF00008	221	251	0.0	30	G5B6A9	219	249	0.0	30
Q01705	PF00008	260	289	0.0	29	G5B6A9	258	287	0.0	29
Q01705	PF00008	493	521	0.0	28	G5B6A9	491	519	0.0	28
Q01705	PF00008	531	560	0.056833333333333326	29	G5B6A9	529	558	0.056833333333333326	29
Q01705	PF00008	569	597	2.011896551724138	28	G5B6A9	567	595	2.6177241379310345	28
Q01705	PF00008	606	636	0.8824516129032257	30	G5B6A9	604	634	2.7936451612903226	30
Q01705	PF00008	644	672	0.0	28	G5B6A9	642	670	0.0	28
Q01705	PF00008	719	747	0.0	28	G5B6A9	717	745	0.0	28
Q01705	PF00008	756	786	0.07322580645161289	30	G5B6A9	754	784	0.4056129032258065	30
Q01705	PF00008	794	823	0.0	29	G5B6A9	792	820	0.0	28
Q01705	PF00008	910	939	0.0	29	G5B6A9	908	937	0.16636666666666666	29
Q01705	PF00008	948	978	0.0	30	G5B6A9	946	976	0.0	30
Q01705	PF00008	1024	1053	0.0	29	G5B6A9	1022	1051	0.0	29
Q01705	PF00008	1062	1091	0.0	29	G5B6A9	1060	1086	0.02240740740740741	26
Q01705	PF00008	1115	1140	0.08007692307692307	25	G5B6A9	1110	1135	0.0	25
Q01705	PF00008	1148	1178	0.0	30	G5B6A9	1143	1173	0.0	30
Q01705	PF00008	1186	1214	0.0	28	G5B6A9	1181	1209	0.0	28
Q01705	PF00008	1235	1262	0.0	27	G5B6A9	1230	1257	0.0	27
Q01705	PF00066	1446	1479	0.0	33	G5B6A9	1441	1474	0.0	33
Q01705	PF00066	1486	1521	0.0	35	G5B6A9	1481	1516	0.0	35
Q01705	PF00066	1525	1560	0.0	35	G5B6A9	1520	1555	0.0	35
Q01705	PF06816	1565	1620	13.084267857142859	55	G5B6A9	1560	1615	13.53669642857143	55
Q01705	PF07684	1661	1718	7.56587931034483	57	G5B6A9	1665	1722	7.5184655172413795	57
Q01705	PF11936	2454	2514	0.0	60	G5B6A9	2423	2483	0.0	60
Q01705	PF12661	686	707	0.3080454545454545	21	G5B6A9	684	705	0.0	21
Q01705	PF12661	991	1012	0.0	21	G5B6A9	989	1010	0.0	21
Q01705	PF12661	1356	1374	0.036052631578947364	18	G5B6A9	1351	1369	0.25131578947368416	18
Q9JHN8	PF10494	52	250	1.486110552763818	198	G5C3H5	53	242	1.2014736842105271	189
Q3UHC7	PF00168	213	312	4.431969999999999	99	G5AJL2	64	163	4.014550000000002	99
Q3UHC7	PF00616	391	459	0.016985507246376815	68	G5AJL2	242	310	0.014884057971014497	68
Q3UHC7	PF00616	465	562	2.5196938775510205	97	G5AJL2	316	413	2.526602040816325	97
Q3UHC7	PF12004	645	1158	1.2678832684824912	513	G5AJL2	496	1010	1.2711533980582523	514
Q99M15	PF00611	19	92	0.006324324324324324	73	G5BL80	20	93	0.0	73
Q6V5K9	PF13913	92	112	0.237	20	G5AK89	94	114	0.9249523809523811	20
Q6V5K9	PF13913	160	184	0.0	24	G5AK89	281	305	0.0	24
Q6V5K9	PF13913	217	239	8.76613043478261	22	G5AK89	219	241	8.17113043478261	22
Q6V5K9	PF13913	280	303	0.0	23	G5AK89	282	305	0.0	23
Q9ERE9	PF00640	688	817	2.0701692307692303	129	G5B2F8	266	395	2.098407692307693	129
Q9ERE9	PF14604	616	665	0.0	49	G5B2F8	194	243	0.0	49
P98192	PF01553	142	281	13.1877	139	G5BQJ3	144	283	12.919478571428563	139
P48967	PF00581	294	391	7.632459183673466	97	G5BA42	192	289	6.012744897959185	97
Q80UW5	PF00069	70	336	3.234621722846444	266	G5B6N6	71	337	2.9220037453183534	266
Q80UW5	PF00130	877	912	0.08166666666666668	35	G5B6N6	902	936	0.11128571428571428	34
Q80UW5	PF00433	356	397	5.137952380952382	41	G5B6N6	357	398	5.432261904761906	41
Q80UW5	PF00780	1096	1358	7.4140684410646385	262	G5B6N6	1095	1357	9.160224334600759	262
Q80UW5	PF08826	742	796	0.0	54	G5B6N6	739	793	0.0	54
Q9D7N6	PF00327	67	116	0.0	49	G5BMS9	68	117	0.04556	49
Q3UR97	PF00787	152	228	0.02514285714285714	76	G5B7P1	74	150	0.036311688311688316	76
Q7TNE3	PF01424	46	107	2.493725806451613	61	G5BW95	47	108	2.487290322580645	61
Q6PDC0	PF02759	65	187	1.924471544715448	122	G5C4X4	84	206	1.861552845528456	122
P33587	PF00008	99	127	0.0	28	G5B9V3	101	129	0.0	28
P33587	PF00089	211	443	8.603154506437768	232	G5B9V3	217	450	7.046782051282053	233
P33587	PF00594	45	84	11.222675	39	G5B9V3	47	86	0.83635	39
P33587	PF14670	138	173	0.0	35	G5B9V3	140	175	0.0	35
Q5SVD0	PF15068	72	202	3.2512137404580153	130	G5BVK8	1	131	1.679328244274809	130
Q78PG9	PF05670	0	111	5.254616071428571	111	G5BY86	39	150	5.306062500000001	111
Q8JZL3	PF01928	5	187	3.548043715846997	182	G5ASM2	6	188	2.052021857923497	182
Q91ZA6	PF00017	283	337	10.459090909090909	54	G5C4E9	190	244	4.950018181818184	54
Q8K2P1	PF14854	97	184	1.1815909090909085	87	G5AP51	26	113	2.125931818181819	87
Q9Z2H1	PF00610	13	83	10.6556338028169	70	G5BXX7	37	107	3.5645352112676036	70
Q9Z2H1	PF00615	279	391	0.2473185840707965	112	G5BXX7	281	424	7.7566875	143
Q9Z2H1	PF00631	202	260	0.5731525423728814	58	G5BXX7	204	262	0.3594237288135594	58
Q9Z2H1	PF18148	86	175	8.286044444444443	89	G5BXX7	110	199	5.472355555555557	89
Q3UST5	PF15882	55	332	5.75806834532374	277	G5B2M5	59	382	7.789530864197532	323
Q9CZ82	PF09637	18	204	2.643524064171123	186	G5AP88	19	205	2.6437058823529416	186
Q9CYZ6	PF14966	72	125	7.492407407407407	53	G5C5A7	1	54	2.116925925925926	53
Q9QZ88	PF12850	1	155	3.687741935483868	154	G5AWM2	2	156	3.0737741935483878	154
Q8BJL1	PF15965	7	99	1.4502473118279566	92	G5BL68	7	99	1.4440107526881725	92
Q8BJL1	PF15966	610	724	0.6658869565217391	114	G5BL68	604	718	0.7410608695652173	114
A6H611	PF01432	252	694	3.9346320541760713	442	G5AMY6	255	697	3.1221828442437927	442
Q8K010	PF01968	230	529	1.327696666666667	299	G5C5U2	231	530	1.7188333333333337	299
Q8K010	PF02538	733	1255	3.0294760994263883	522	G5C5U2	734	1256	3.770089866156788	522
Q8K010	PF05378	9	210	4.688707920792079	201	G5C5U2	10	211	3.1161534653465357	201
P58466	PF03031	91	249	5.761459119496857	158	G5AZI9	92	250	5.387584905660379	158
Q9QWV9	PF00134	12	147	4.9648602941176465	135	G5AU45	13	148	4.964625	135
Q9Z2E5	PF00010	41	92	13.345173076923075	51	G5B7Z2	40	91	6.6780769230769215	51
Q9R0I7	PF13671	1075	1211	2.898737226277373	136	G5C1M0	1764	1900	2.2157372262773727	136
Q9R1B9	PF00008	913	943	0.0	30	G5C7F6	922	952	0.0	30
Q9R1B9	PF00008	952	985	0.1997941176470588	33	G5C7F6	961	994	3.0232941176470587	33
Q9R1B9	PF00008	993	1022	0.0	29	G5C7F6	1002	1031	0.0	29
Q9R1B9	PF00008	1031	1063	0.0	32	G5C7F6	1040	1072	0.0	32
Q9R1B9	PF00008	1071	1100	0.0	29	G5C7F6	1080	1109	0.0	29
Q9R1B9	PF00054	1179	1309	0.7949465648854969	130	G5C7F6	1188	1318	0.7897404580152673	130
Q9R1B9	PF01462	26	53	0.0	27	G5C7F6	27	54	0.0	27
Q9R1B9	PF01462	272	298	0.0	26	G5C7F6	273	299	0.0	26
Q9R1B9	PF01462	718	744	0.0	26	G5C7F6	727	753	0.0	26
Q9R1B9	PF01463	233	257	0.01696	24	G5C7F6	234	258	0.0	24
Q9R1B9	PF01463	454	478	0.0	24	G5C7F6	455	479	0.0	24
Q9R1B9	PF01463	679	704	0.0	25	G5C7F6	688	713	0.0	25
Q9R1B9	PF01463	875	898	0.0	23	G5C7F6	884	907	0.0	23
Q9R1B9	PF12661	1121	1142	0.0	21	G5C7F6	1130	1151	0.0	21
Q9R1B9	PF13855	55	114	0.2535	59	G5C7F6	56	115	0.24775000000000005	59
Q9R1B9	PF13855	153	210	0.057396551724137934	57	G5C7F6	154	211	0.057396551724137934	57
Q9R1B9	PF13855	301	359	1.4093898305084744	58	G5C7F6	302	360	1.4101186440677964	58
Q9R1B9	PF13855	372	430	7.253491525423727	58	G5C7F6	373	431	6.407898305084747	58
Q9R1B9	PF13855	528	572	0.2726	44	G5C7F6	537	581	0.2728444444444444	44
Q9R1B9	PF13855	598	656	1.4019152542372877	58	G5C7F6	607	665	1.4742203389830508	58
Q9R1B9	PF13855	793	852	9.307816666666662	59	G5C7F6	802	861	9.189400000000004	59
Q14BK3	PF15079	14	188	0.0989314285714286	174	G5BIB4	2	183	0.6426214689265536	181
Q8R2Y9	PF01336	26	83	0.2513620689655173	57	G5BB82	27	84	0.2893103448275862	57
Q8BSI6	PF01424	17	77	0.12670491803278688	60	G5B9R7	44	104	0.1568032786885246	60
Q9CR86	PF00313	64	127	0.06321874999999999	63	G5BSC7	66	129	0.07379687500000001	63
Q80UW2	PF04300	117	294	0.7443932584269659	177	G5C514	126	306	0.5148287292817679	180
Q80UW2	PF00646	60	95	0.0788888888888889	35	G5C514	68	103	0.09805555555555556	35
P16332	PF01642	60	571	4.332564453125001	511	G5BGH1	63	574	4.564041015625003	511
P16332	PF02310	613	725	1.8053008849557504	112	G5BGH1	616	728	1.7872300884955747	112
Q9CYC6	PF00293	98	210	4.469929203539822	112	G5B1W3	46	158	4.4273362831858405	112
Q9CYC6	PF05026	70	92	0.0	22	G5B1W3	18	40	0.0	22
Q9DA11	PF00062	21	126	5.320264150943396	105	G5BCS8	19	132	5.001256637168142	113
Q8CJH3	PF01403	36	458	5.933527186761233	422	G5AVM5	37	459	6.1599763593380645	422
Q8CJH3	PF01437	481	528	8.202041666666664	47	G5AVM5	482	529	9.901729166666666	47
Q8CJH3	PF01833	1067	1154	0.9046590909090909	87	G5AVM5	1070	1157	1.5722954545454548	87
Q8CJH3	PF01833	1159	1245	5.244057471264367	86	G5AVM5	1162	1248	5.560908045977013	86
Q8CJH3	PF01833	1249	1357	0.0	108	G5AVM5	1252	1374	0.05597560975609756	122
Q8CJH3	PF08337	1545	2085	7.63642144177449	540	G5AVM5	1562	2096	7.341082242990653	534
Q8CJH3	PF17960	540	626	8.686241379310347	86	G5AVM5	541	627	7.866011494252873	86
Q8CJH3	PF18020	919	1017	2.8944040404040403	98	G5AVM5	922	1020	0.3396464646464645	98
P09026	PF00046	191	247	0.01201754385964912	56	G5C4M0	184	240	0.012105263157894735	56
P09026	PF13293	368	430	0.0	62	G5C4M0	361	424	0.0	63
Q8BW72	PF02373	174	290	2.7582735042735056	116	G5AQF5	175	291	2.405444444444445	116
Q8BW72	PF02375	14	48	10.209428571428571	34	G5AQF5	15	49	10.247857142857145	34
Q8BW72	PF13831	731	765	0.046542857142857136	34	G5AQF5	732	766	0.4797714285714286	34
Q8BW72	PF13832	773	883	12.723423423423426	110	G5AQF5	774	884	12.727171171171166	110
Q8BW72	PF18104	901	935	0.0	34	G5AQF5	902	936	0.0	34
Q8BW72	PF18104	959	993	0.01657142857142857	34	G5AQF5	902	936	0.0	34
Q5EBG6	PF00011	69	152	3.6067619047619037	83	G5BXN5	70	153	1.3488809523809526	83
Q5EBG6	PF00525	2	60	0.0	58	G5BXN5	3	61	0.0	58
Q91WQ9	PF13499	11	72	6.3343225806451615	61	G5C6S4	12	73	8.837677419354842	61
Q9D772	PF15260	25	156	0.020174242424242428	131	G5B057	54	185	0.0200763358778626	131
Q9QXN0	PF08687	1660	1945	3.5675209790209785	285	G5BJQ4	1363	1648	2.3991748251748253	285
Q9QXN0	PF08688	881	1024	0.006111111111111111	143	G5BJQ4	758	898	0.015602836879432626	140
Q9ESH5	PF00095	53	96	0.01590909090909091	43	G5BFY6	15	58	0.0	43
Q8CDY7	PF03645	122	216	9.222852631578947	94	G5ARV1	125	219	13.20682105263158	94
Q9JHS9	PF04889	77	228	0.012467105263157894	151	G5BQ53	47	201	0.940928571428572	154
Q3UZ45	PF07412	172	237	0.7264545454545455	65	G5C6X2	188	253	1.2525454545454546	65
Q9JLM4	PF06467	351	390	0.961625	39	G5BW27	143	182	0.51225	39
Q9JLM4	PF06467	406	441	0.0	35	G5BW27	198	233	0.0	35
Q9JLM4	PF06467	448	489	0.6598809523809523	41	G5BW27	240	281	0.5175952380952381	41
Q9JLM4	PF06467	497	533	0.2347297297297297	36	G5BW27	289	325	0.2344324324324325	36
Q9JLM4	PF06467	548	579	0.5025624999999999	31	G5BW27	335	366	0.5020937499999999	31
Q9JLM4	PF06467	590	624	0.7226285714285715	34	G5BW27	377	411	0.7217714285714286	34
Q9JLM4	PF06467	630	665	6.521305555555557	35	G5BW27	417	452	6.517777777777778	35
Q9JLM4	PF06467	676	711	1.2181388888888889	35	G5BW27	463	498	3.2190833333333333	35
Q9JLM4	PF06467	717	752	0.0	35	G5BW27	504	539	0.0	35
Q9JLM4	PF12012	1185	1351	7.095071856287423	166	G5BW27	974	1141	7.059000000000003	167
Q9CWL8	PF08216	57	161	2.6125904761904764	104	G5B820	51	155	1.9904761904761905	104
Q9D915	PF15063	11	84	6.569243243243244	73	G5AYK7	11	84	6.580918918918919	73
Q3U4G0	PF14811	132	239	0.6703055555555556	107	G5BZR5	133	239	1.1900471698113206	106
O08696	PF00250	232	314	7.741662650602411	82	G5AS16	192	273	7.773243902439026	81
Q8BJT9	PF01532	48	479	7.573655092592592	431	G5C6J1	51	483	6.871170900692839	432
Q8BHZ4	PF00096	1012	1035	0.0	23	G5B1R9	1014	1037	0.0	23
Q8BHZ4	PF00096	1042	1068	0.0598888888888889	26	G5B1R9	1044	1070	0.05155555555555555	26
Q8BHZ4	PF16622	1148	1176	0.439655172413793	28	G5B1R9	1150	1178	0.44131034482758624	28
Q8K0W9	PF05207	5	59	6.520072727272727	54	G5BMH6	6	60	6.503527272727273	54
Q3UPL0	PF12931	571	764	11.31032989690722	193	G5ALN3	573	766	12.813938144329901	193
P42682	PF00017	149	230	4.2010487804878025	81	G5B8D7	70	151	8.303792682926831	81
P42682	PF00018	87	133	0.054127659574468086	46	G5B8D7	8	54	0.04648936170212767	46
P42682	PF07714	271	517	3.829210526315791	246	G5B8D7	192	437	5.658402439024387	245
Q60867	PF00010	101	150	4.63558	49	G5BIQ8	102	151	6.1622	49
Q60867	PF12533	159	283	2.499512000000001	124	G5BIQ8	160	284	2.499920000000001	124
Q78JW9	PF00240	148	213	3.273909090909091	65	G5BV72	59	124	3.5585151515151514	65
Q6P9J5	PF12075	23	61	0.0	38	G5BSM8	18	56	0.0	38
Q6P9J5	PF12796	936	985	3.1796199999999994	49	G5BSM8	769	817	3.697551020408164	48
Q6P9J5	PF13637	812	858	10.79231914893617	46	G5BSM8	750	796	13.915510638297865	46
Q571H0	PF11707	77	392	11.338879746835447	315	G5BE99	78	396	11.129915360501569	318
Q571H0	PF16201	1666	1855	18.569147368421046	189	G5BE99	1673	1848	18.75883522727273	175
Q8BG32	PF01399	288	386	3.677868686868688	98	G5BVL7	259	357	4.544393939393938	98
Q8BG32	PF18055	30	128	0.7923131313131311	98	G5BVL7	1	99	0.7948080808080807	98
Q8BG32	PF18503	392	418	0.0	26	G5BVL7	363	389	0.0	26
E9Q8T7	PF03028	3666	3766	0.5726039603960398	100	G5BUL8	4185	4323	0.4088776978417266	138
E9Q8T7	PF08393	998	1399	1.5031268656716408	401	G5BUL8	988	1374	1.4330852713178301	386
E9Q8T7	PF12774	1527	1824	5.084305369127517	297	G5BUL8	1503	1761	4.214563706563705	258
E9Q8T7	PF12775	2173	2351	6.243480446927375	178	G5BUL8	2560	2746	5.133149732620322	186
E9Q8T7	PF12777	2815	3158	4.192625	343	G5BUL8	3338	3699	4.095892265193371	361
E9Q8T7	PF12780	2540	2766	8.618762114537445	226	G5BUL8	2936	3161	4.014898230088498	225
E9Q8T7	PF12781	3188	3409	0.7465360360360359	221	G5BUL8	3729	3950	0.7498963963963964	221
E9Q8T7	PF17852	2022	2166	6.4432206896551705	144	G5BUL8	1960	2104	10.29003448275862	144
E9Q8T7	PF17857	2396	2479	4.224869047619045	83	G5BUL8	2792	2875	7.309404761904763	83
E9Q8T7	PF18198	3780	3937	4.25031012658228	157	G5BUL8	4337	4494	3.612474683544305	157
E9Q8T7	PF18199	3943	4245	10.192198019801983	302	G5BUL8	4500	4857	10.25626815642458	357
Q8R1B5	PF05835	0	137	0.0	137	G5AL64	1	138	0.025239130434782608	137
P80316	PF00118	43	532	3.754736734693879	489	G5B710	44	533	3.684597959183673	489
Q8R1F9	PF08584	74	345	11.634919117647062	271	G5C8X0	75	348	12.263872262773726	273
Q9DAK8	PF14580	85	173	13.325179775280905	88	G5AVT3	86	174	13.48906741573033	88
Q61909	PF07531	95	182	5.685397727272727	87	G5C710	86	173	5.699795454545455	87
Q61909	PF08788	309	375	1.8790298507462688	66	G5C710	300	366	1.8888805970149252	66
Q8R4V2	PF00782	11	137	8.60364566929134	126	G5BR02	12	138	8.69303937007874	126
Q5FW52	PF15274	68	152	5.9672470588235305	84	G5BKI6	99	182	6.862250000000001	83
Q5FW52	PF15274	176	196	0.0	20	G5BKI6	259	279	0.0	20
Q9QY24	PF02295	13	59	2.386744680851064	46	G5AUM6	109	154	0.0	45
Q9QY24	PF02295	91	128	0.13410526315789476	37	G5AUM6	202	238	0.0	36
Q9QY24	PF12721	164	200	0.12297297297297301	36	G5AUM6	270	301	1.4139374999999996	31
Q9QY24	PF12721	224	256	0.3784545454545455	32	G5AUM6	325	357	0.0	32
Q9CR25	PF01866	53	371	4.681206896551723	318	G5AQF1	54	372	4.1987398119122235	318
P16546	PF00018	973	1017	8.59875555555556	44	G5ASE4	984	1028	6.676800000000003	44
P16546	PF00435	44	145	0.011127450980392157	101	G5ASE4	45	146	0.01107843137254902	101
P16546	PF00435	149	250	0.2228039215686274	101	G5ASE4	150	251	0.23016666666666666	101
P16546	PF00435	255	357	0.06538834951456311	102	G5ASE4	256	358	0.08199029126213593	102
P16546	PF00435	360	464	0.2496571428571428	104	G5ASE4	361	465	1.0680857142857143	104
P16546	PF00435	467	569	0.2135436893203884	102	G5ASE4	468	580	5.114964601769913	112
P16546	PF00435	573	675	1.0684466019417478	102	G5ASE4	584	686	1.0601456310679611	102
P16546	PF00435	678	780	0.02053398058252427	102	G5ASE4	689	791	0.02053398058252427	102
P16546	PF00435	784	887	0.02235576923076923	103	G5ASE4	795	898	0.02235576923076923	103
P16546	PF00435	890	960	0.0	70	G5ASE4	901	971	0.0	70
P16546	PF00435	1095	1165	0.0	70	G5ASE4	1106	1176	0.0	70
P16546	PF00435	1232	1335	0.05035576923076923	103	G5ASE4	1243	1346	0.05035576923076923	103
P16546	PF00435	1338	1440	0.3309320388349514	102	G5ASE4	1349	1451	0.3309320388349514	102
P16546	PF00435	1445	1548	0.2634423076923077	103	G5ASE4	1456	1559	0.39733653846153855	103
P16546	PF00435	1551	1655	0.9269904761904764	104	G5ASE4	1562	1672	5.405963963963965	110
P16546	PF00435	1658	1761	0.0	103	G5ASE4	1675	1778	0.0	103
P16546	PF00435	1763	1867	0.2711904761904762	104	G5ASE4	1780	1884	0.2840000000000001	104
P16546	PF00435	1870	1973	0.2849807692307692	103	G5ASE4	1887	1990	0.2849807692307692	103
P16546	PF00435	1977	2080	0.230125	103	G5ASE4	1994	2097	0.2048942307692308	103
P16546	PF00435	2091	2193	5.718475728155341	102	G5ASE4	2108	2210	4.839339805825243	102
P16546	PF00435	2205	2309	0.008476190476190476	104	G5ASE4	2222	2320	0.00898989898989899	98
P16546	PF08726	2401	2469	0.10418840579710148	68	G5ASE4	2412	2480	0.11602898550724637	68
P16546	PF13499	2329	2394	4.429045454545455	65	G5ASE4	2340	2405	5.301212121212122	65
O88844	PF00180	10	398	2.186776349614396	388	G5B6E8	11	399	2.132475578406169	388
Q91W92	PF00786	36	63	0.0	27	G5AYX2	37	64	0.0	27
Q91W92	PF14957	116	229	0.14700877192982456	113	G5AYX2	117	215	0.15834343434343434	98
Q91YU6	PF06818	440	637	0.0786010101010101	197	G5CAF0	441	638	0.016919191919191924	197
P61290	PF02251	9	68	0.13695000000000002	59	G5C9Z6	10	69	0.14184999999999998	59
P61290	PF02252	108	250	0.403762237762238	142	G5C9Z6	109	267	0.3697610062893083	158
Q07916	PF00046	234	289	1.6595714285714285	55	G5ATY9	572	627	1.6399642857142858	55
Q07916	PF00157	142	212	0.08212676056338028	70	G5ATY9	480	550	0.026112676056338026	70
Q8R0J1	PF00621	165	350	1.3074623655913975	185	G5CAN8	169	352	0.5583858695652173	183
Q61578	PF07992	41	197	3.0832420382165613	156	G5BNE0	51	207	3.0641401273885362	156
Q9JLI7	PF00514	113	153	9.723707317073167	40	G5C4E4	76	116	2.4314634146341465	40
Q9JLI7	PF00514	155	194	11.262075	39	G5C4E4	118	157	13.618800000000002	39
Q9JLI7	PF00514	197	236	0.31207499999999994	39	G5C4E4	160	199	0.4536750000000001	39
Q9JLI7	PF00514	241	278	9.737736842105262	37	G5C4E4	204	241	9.753526315789474	37
Q3U829	PF14764	318	436	1.229840336134454	118	G5BI69	1018	1136	1.5395210084033608	118
Q922U2	PF00038	160	473	0.3083439490445859	313	G5ALS3	164	477	0.299404458598726	313
Q922U2	PF16208	15	157	0.0	142	G5ALS3	16	161	0.0	145
Q9JJK2	PF05147	96	443	10.140002873563207	347	G5AMM5	227	574	8.693037356321849	347
Q8VIG3	PF02493	27	42	0.0	15	G5B2T3	28	43	0.0	15
Q8VIG3	PF02493	43	65	0.0	22	G5B2T3	44	66	0.0	22
Q8VIG3	PF02493	66	88	0.0	22	G5B2T3	67	89	0.26230434782608697	22
Q8VIG3	PF02493	89	111	18.967391304347824	22	G5B2T3	90	112	18.47095652173913	22
Q8VIG3	PF02493	112	130	0.33531578947368423	18	G5B2T3	113	131	0.8165789473684211	18
Q8VIG3	PF02493	136	147	4.097083333333333	11	G5B2T3	137	148	3.482083333333333	11
Q8VIG3	PF02493	158	179	0.11945454545454542	21	G5B2T3	159	180	0.12027272727272728	21
Q8K4T3	PF00069	57	368	7.6454134615384595	311	G5BW38	53	364	7.337698717948728	311
Q3TYG6	PF12348	502	683	1.30932967032967	181	G5C2Y0	515	696	1.8191648351648348	181
P56581	PF03167	141	290	3.650079999999999	149	G5AR40	122	271	3.639746666666664	149
Q99LM2	PF05600	4	499	3.3746491935483847	495	G5BY19	5	495	4.399164969450098	490
P21550	PF00113	142	429	0.7882673611111113	287	G5BW96	147	434	0.7639930555555557	287
P21550	PF03952	3	133	2.358610687022901	130	G5BW96	4	138	2.2879777777777783	134
Q8BG93	PF00293	20	128	8.156477064220184	108	G5BTQ6	22	130	4.202798165137615	108
Q9DCL8	PF04979	45	167	0.32837398373983745	122	G5ALD9	81	202	0.33147540983606555	121
Q8R344	PF08315	10	142	0.0	132	G5ANQ6	11	232	4.246590090090091	221
P35583	PF00250	158	227	10.406200000000004	69	G5CBC5	39	108	11.246614285714278	69
P35583	PF08430	120	157	0.0	37	G5CBC5	1	38	0.0	37
P35583	PF09354	373	447	0.0	74	G5CBC5	209	282	0.0	73
Q8R3H7	PF03567	73	325	8.031312252964426	252	G5BGG3	1	253	6.190707509881424	252
Q7TPQ3	PF00176	301	433	5.104082706766918	132	G5BL69	278	385	5.743250000000002	107
Q7TPQ3	PF00271	1504	1612	3.405183486238532	108	G5BL69	1378	1486	3.4937522935779817	108
Q7TPQ3	PF00538	434	504	9.427084507042254	70	G5BL69	386	456	9.346661971830997	70
Q8BYA0	PF12612	903	1089	6.905005347593579	186	G5BJB4	894	1086	6.366005181347145	192
Q9Z100	PF00246	294	599	3.3774509803921586	305	G5B4S1	303	609	4.8350260586319225	306
Q9Z100	PF00754	121	259	0.5535251798561149	138	G5B4S1	129	268	0.24957142857142856	139
Q9Z100	PF13620	612	676	2.659630769230769	64	G5B4S1	622	686	6.613307692307692	64
Q8BH64	PF00350	60	219	7.486575000000004	159	G5AV18	61	220	7.1431062499999936	159
Q8BH64	PF12763	448	535	0.08676136363636364	87	G5AV18	449	536	0.0954772727272727	87
Q8BH64	PF16880	24	55	0.0	31	G5AV18	25	56	0.0	31
Q8BH64	PF18150	288	393	1.8230566037735858	105	G5AV18	289	394	1.806971698113208	105
Q5GFD5	PF00685	90	328	3.4326652719665285	238	G5BY60	51	289	3.536489539748956	238
Q9D7P9	PF00079	6	422	3.9662302158273417	416	G5BH01	7	400	7.5095318066157715	393
Q69ZX8	PF00412	22	75	0.09181481481481482	53	G5C3A8	31	84	0.08794444444444445	53
Q69ZX8	PF00412	81	135	1.2552545454545458	54	G5C3A8	90	144	1.2540545454545458	54
Q69ZX8	PF00412	150	204	0.9604363636363636	54	G5C3A8	159	213	0.9594363636363636	54
Q69ZX8	PF00412	209	262	0.0	53	G5C3A8	218	271	0.0	53
Q69ZX8	PF02209	646	681	1.2340833333333332	35	G5C3A8	656	691	1.2679999999999998	35
Q69ZX8	PF16182	272	645	1.1281336898395722	373	G5C3A8	281	655	1.124856	374
O09105	PF00010	87	136	4.7398	49	G5BE55	87	136	6.295159999999999	49
O09105	PF12533	145	262	0.05498305084745763	117	G5BE55	145	263	0.06761344537815127	118
Q9JKM7	PF00071	30	190	14.586310559006215	160	G5B5N8	31	191	17.323695652173914	160
Q8CDL9	PF03999	673	853	3.318580110497237	180	G5BWY9	361	540	1.1251722222222222	179
Q8R1Q3	PF00147	120	331	0.6298301886792455	211	G5C518	128	339	0.5868254716981133	211
Q8BQM9	PF12144	1804	2030	0.3715726872246696	226	G5C103	1097	1314	0.2275642201834863	217
Q8BQM9	PF12145	710	729	7.410500000000001	19	G5C103	1	20	9.536	19
Q0VEJ0	PF15627	99	255	4.944910828025477	156	G5C080	100	256	4.9610127388535075	156
Q61200	PF06312	65	270	5.355621359223301	205	G5ANL8	49	254	5.3865121951219495	205
Q6PDH4	PF00638	312	410	0.9231414141414142	98	G5C9G2	251	349	1.112222222222222	98
Q9JI74	PF00651	205	308	8.583673076923075	103	G5AT72	41	144	8.6489326923077	103
Q9JI74	PF01344	461	491	4.0033548387096785	30	G5AT72	297	327	3.6022258064516133	30
Q9JI74	PF01344	497	542	16.035739130434784	45	G5AT72	333	378	16.0675652173913	45
Q9JI74	PF01344	545	589	4.935444444444445	44	G5AT72	381	425	6.31128888888889	44
Q9JI74	PF01344	591	635	0.6909111111111111	44	G5AT72	427	471	0.6683333333333334	44
Q9JI74	PF01344	638	675	6.690263157894736	37	G5AT72	474	510	7.082472222222222	36
Q9JI74	PF01344	692	736	3.0368666666666666	44	G5AT72	381	425	6.31128888888889	44
Q9JI74	PF07707	316	415	9.11733	99	G5AT72	152	251	9.07728	99
Q6HA09	PF01400	102	281	0.5633944444444445	179	G5APU0	103	282	0.6405111111111113	179
Q8K2K6	PF01412	56	126	4.979112676056336	70	G5C9F2	1	71	4.971591549295773	70
Q925T6	PF00595	54	92	0.414128205128205	38	G5AWA4	214	251	1.4147368421052633	37
Q925T6	PF00595	151	234	6.209690476190479	83	G5AWA4	301	384	6.558726190476192	83
Q925T6	PF00595	258	332	3.377653333333333	74	G5AWA4	408	482	2.95216	74
Q925T6	PF00595	574	653	0.11728750000000004	79	G5AWA4	725	804	0.11656249999999994	79
Q925T6	PF00595	672	750	3.3999620253164555	78	G5AWA4	823	901	2.5832405063291155	78
Q925T6	PF00595	1003	1080	0.054153846153846136	77	G5AWA4	1154	1231	0.053871794871794894	77
Q925T6	PF17820	501	555	0.8397454545454548	54	G5AWA4	652	706	0.6654363636363636	54
Q71RI9	PF00155	64	441	2.5438677248677264	377	G5BGF8	64	441	3.6982460317460335	377
P97930	PF02223	80	190	11.936864864864864	110	G5C3S3	85	195	10.150972972972973	110
Q8JZX3	PF00400	11	45	1.1573428571428572	34	G5AXN0	12	46	3.032714285714285	34
Q8JZX3	PF00400	55	87	1.0047272727272727	32	G5AXN0	56	88	1.0043636363636366	32
Q8JZX3	PF00400	96	130	0.01657142857142857	34	G5AXN0	97	131	0.015857142857142858	34
Q8JZX3	PF00400	137	172	4.404333333333332	35	G5AXN0	138	173	2.9487777777777793	35
Q8JZX3	PF00400	177	214	7.858184210526319	37	G5AXN0	178	215	8.025210526315794	37
Q8JZX3	PF00400	220	254	1.3260285714285711	34	G5AXN0	221	255	1.383142857142857	34
Q8JZX3	PF00400	260	298	2.063564102564103	38	G5AXN0	261	299	6.823051282051286	38
Q05A80	PF12287	527	838	0.08729166666666667	311	G5BLL6	532	846	0.17565714285714285	314
Q05A80	PF18293	118	233	1.1614051724137937	115	G5BLL6	119	234	2.183508620689655	115
Q9QZ67	PF00481	67	360	4.9845850340136035	293	G5AX25	72	364	4.863300341296928	292
Q8C2E4	PF13041	172	216	9.585533333333334	44	G5AX92	253	297	9.494555555555557	44
Q8C2E4	PF13812	231	286	8.716053571428573	55	G5AX92	312	367	2.5036785714285714	55
Q8C2E4	PF13812	571	615	15.449600000000002	44	G5AX92	696	740	14.980888888888893	44
Q9QZR0	PF05773	17	121	10.396428571428569	104	G5AZI2	18	123	9.971084905660376	105
Q9QZR0	PF17123	132	160	12.906793103448276	28	G5AZI2	134	162	13.029068965517236	28
Q8CI51	PF00412	414	467	10.01011111111111	53	G5BH59	338	391	10.034907407407408	53
Q8CI51	PF00412	473	527	13.70343636363636	54	G5BH59	397	451	14.887181818181816	54
Q8CI51	PF00412	532	584	0.965	52	G5BH59	456	508	0.7157924528301888	52
Q8CI51	PF15936	213	303	0.09648351648351647	90	G5BH59	132	222	0.09684615384615386	90
Q9D869	PF13202	33	52	0.00655	19	G5BV65	34	53	0.1904	19
Q9D869	PF13499	113	178	3.2745606060606063	65	G5BV65	114	179	3.2945757575757555	65
Q99LJ1	PF01120	10	352	4.11100583090379	342	G5BHX9	21	363	3.8739795918367377	342
Q99LJ1	PF16757	363	448	13.905011627906973	85	G5BHX9	374	458	10.507752941176467	84
Q99J95	PF00069	18	314	4.053097643097642	296	G5BLG4	19	315	4.053101010101009	296
Q1RLL3	PF00168	19	117	4.011353535353536	98	G5BX90	20	117	7.570469387755099	97
Q1RLL3	PF00168	153	248	5.383760416666671	95	G5BX90	153	248	5.381520833333336	95
Q1RLL3	PF07002	317	536	6.017022727272729	219	G5BX90	317	536	6.0171136363636375	219
Q99N20	PF08598	60	192	0.11881954887218048	132	G5BWX7	61	193	0.12010526315789476	132
Q8K1A0	PF05175	43	143	0.7756138613861387	100	G5C8P8	43	143	0.1253366336633664	100
O08674	PF09270	231	356	5.568476190476191	125	G5BB20	235	360	5.572619047619047	125
O08674	PF09271	66	203	1.3756594202898542	137	G5BB20	70	207	0.19637681159420287	137
Q9CZT4	PF04801	4	430	0.7225690866510541	426	G5BV83	22	433	0.8293252427184468	411
P70281	PF04803	100	231	0.12898484848484848	131	G5BBJ2	83	214	3.2060984848484857	131
Q9DBR7	PF12796	45	133	1.461876404494382	88	G5C9J2	46	134	0.9037078651685394	88
Q9DBR7	PF12796	190	258	0.775246376811594	68	G5C9J2	191	259	0.7746666666666667	68
Q9DBR7	PF15898	929	1028	0.0	99	G5C9J2	928	1027	0.0	99
Q9Z0H1	PF08149	438	515	0.04198717948717949	77	G5BAZ3	441	518	0.07030769230769232	77
Q3V3Q7	PF10254	443	857	1.6648120481927715	414	G5AWJ8	473	896	1.6288349056603766	423
Q99M73	PF00038	171	482	0.4832403846153845	311	G5B3P8	161	472	0.4988846153846154	311
Q99M73	PF16208	15	168	1.85362987012987	153	G5B3P8	16	158	1.4171538461538464	142
E9Q9R9	PF00595	632	705	2.0947972972972977	73	G5BRJ8	543	616	2.09345945945946	73
E9Q9R9	PF00595	721	791	6.176957746478871	70	G5BRJ8	632	702	6.261140845070423	70
E9Q9R9	PF00595	1350	1423	1.7761621621621617	73	G5BRJ8	1221	1294	1.7495135135135136	73
E9Q9R9	PF00625	1776	1907	6.516575757575757	131	G5BRJ8	1899	2030	10.497287878787876	131
E9Q9R9	PF04822	129	212	0.03839285714285714	83	G5BRJ8	40	123	0.029523809523809518	83
E9Q9R9	PF16610	1426	1500	0.0368	74	G5BRJ8	1297	1392	0.21317708333333335	95
Q5FW53	PF00041	148	228	11.453271604938273	80	G5BQW0	148	228	7.561901234567901	80
Q5FW53	PF07679	66	140	9.327026666666663	74	G5BQW0	66	140	11.185773333333335	74
Q5FW53	PF07679	261	350	0.23884444444444464	89	G5BQW0	261	350	0.10689999999999994	89
Q9Z1N2	PF01426	44	164	4.196272727272724	120	G5AUI4	46	165	2.623441666666667	119
Q9Z1N2	PF00004	508	651	6.793125	143	G5AUI4	527	670	8.217187500000001	143
Q9Z1N2	PF09079	756	835	3.82925	79	G5AUI4	775	854	1.7506999999999997	79
Q9Z1N2	PF17872	666	714	1.2669795918367346	48	G5AUI4	685	733	1.303632653061224	48
P31266	PF09270	231	353	2.052170731707318	122	G5B015	206	328	2.1421056910569107	122
P31266	PF09271	73	203	4.416748091603054	130	G5B015	48	178	4.0826106870229015	130
Q99N80	PF00168	286	385	0.43293999999999994	99	G5AUT3	302	399	0.44831632653061226	97
Q99N80	PF00168	426	525	0.03715	99	G5AUT3	440	539	0.0375	99
Q9WTL7	PF02230	12	226	5.04724186046512	214	G5BHY2	13	227	5.046879069767444	214
Q8VDK1	PF00795	43	299	2.615311284046692	256	G5BWI7	172	427	2.433113281249999	255
Q6ZPI3	PF05225	351	393	2.128325581395349	42	G5BET8	352	394	2.128325581395349	42
Q8BYJ6	PF00566	932	1139	15.571581730769225	207	G5C5G5	720	927	15.582923076923075	207
Q8BYJ6	PF00640	350	446	6.6586185567010325	96	G5C5G5	165	261	6.672494845360827	96
Q8BYJ6	PF11830	808	871	7.653828125	63	G5C5G5	597	660	7.671906249999998	63
Q3UFB2	PF04438	209	236	0.0	27	G5C912	223	250	0.038571428571428576	27
P70459	PF00178	27	105	0.8995696202531648	78	G5AZR2	21	99	0.8437848101265824	78
Q69ZR9	PF12509	160	313	6.166850649350648	153	G5ATM7	101	254	6.528571428571429	153
Q8VE37	PF00415	34	81	5.464645833333335	47	G5AP90	51	98	7.355541666666666	47
Q8VE37	PF00415	84	133	0.25802	49	G5AP90	101	150	0.25636	49
Q8VE37	PF00415	136	185	5.693260000000001	49	G5AP90	153	202	9.01784	49
Q8VE37	PF00415	189	254	11.010151515151515	65	G5AP90	206	271	12.669636363636364	65
Q8VE37	PF00415	257	308	0.2674423076923076	51	G5AP90	274	325	0.2585192307692308	51
Q8VE37	PF00415	311	354	0.4947272727272727	43	G5AP90	328	371	0.2039318181818182	43
Q8VE37	PF00415	362	413	12.924096153846152	51	G5AP90	379	430	10.478461538461538	51
Q9QZM0	PF00240	34	103	9.876199999999997	69	G5C131	35	104	9.879328571428571	69
Q9QZM0	PF00627	596	631	0.6476944444444442	35	G5C131	584	619	0.6490555555555556	35
O35646	PF00168	518	601	5.90377380952381	83	G5C7Y7	462	545	4.93222619047619	83
O35646	PF00648	55	340	1.6397937062937082	285	G5C7Y7	1	286	1.0686888111888122	285
O35646	PF01067	358	486	1.8779922480620157	128	G5C7Y7	304	430	2.5080314960629915	126
Q3V2D2	PF15144	0	75	16.222421052631564	75	G5BTH3	1	73	16.444194444444452	72
Q14AW5	PF01189	342	461	1.8585083333333332	119	G5C3T6	342	461	2.146841666666667	119
Q8BID6	PF00096	445	467	0.0	22	G5C8B8	446	468	0.0	22
Q8BID6	PF00651	20	126	1.7362710280373834	106	G5C8B8	21	127	4.253205607476633	106
Q8BID6	PF13909	417	441	0.0	24	G5C8B8	418	442	0.0	24
Q8BKT7	PF09766	96	451	5.81900842696629	355	G5APW7	97	452	6.085564606741568	355
Q8R2G6	PF13778	141	269	2.544186046511628	128	G5B1D2	153	281	2.411403100775193	128
Q8R2G6	PF13778	614	746	6.458646616541352	132	G5B1D2	633	765	6.901030075187968	132
Q8R2G6	PF13778	769	900	9.355681818181816	131	G5B1D2	788	919	9.348204545454543	131
Q61771	PF00225	14	339	3.0267975460122685	325	G5BR11	15	291	1.2866642599277978	276
O89100	PF00017	57	131	12.564639999999995	74	G5AYW0	58	132	12.633026666666668	74
O89100	PF00018	4	47	0.03913636363636363	43	G5AYW0	5	48	0.11240909090909088	43
O89100	PF00018	268	313	0.0	45	G5AYW0	274	319	0.0	45
Q61881	PF00493	321	540	6.862604545454543	219	G5AN15	325	544	6.8734772727272775	219
Q61881	PF14551	9	138	1.152553846153846	129	G5AN15	10	139	0.326653846153846	129
Q61881	PF17207	148	277	6.730238461538462	129	G5AN15	149	281	5.734684210526317	132
Q61881	PF17855	557	639	2.5136265060240968	82	G5AN15	561	643	2.4753614457831317	82
Q7TQD2	PF05517	50	205	0.3237692307692307	155	G5BPH4	53	193	0.08580851063829789	140
Q9ESL4	PF00536	347	406	7.168800000000001	59	G5ALR2	279	338	0.4272	59
Q9ESL4	PF07714	16	259	11.136040983606568	243	G5ALR2	17	209	8.98662176165803	192
Q920A9	PF13895	89	174	8.697197674418607	85	G5BWG6	80	165	4.769465116279068	85
Q920A9	PF13927	181	251	5.491295774647886	70	G5BWG6	172	242	5.738352112676057	70
Q8BL95	PF11069	221	284	1.5503125	63	G5BE97	231	294	0.4662656250000001	63
Q8C7K6	PF07156	120	483	7.599631868131863	363	G5C3A5	121	485	6.495454794520542	364
Q8C7K6	PF13450	30	94	7.483061538461534	64	G5C3A5	31	95	0.6536000000000001	64
Q9ES74	PF00069	34	285	3.89611111111111	251	G5BM78	35	286	3.943742063492062	251
Q78ZA7	PF00956	64	337	4.4724963503649615	273	G5BST6	61	334	4.456372262773724	273
Q60972	PF00400	172	205	0.6351470588235294	33	G5B5J6	184	217	0.6336764705882354	33
Q60972	PF00400	220	255	0.07775000000000001	35	G5B5J6	232	267	0.06108333333333335	35
Q60972	PF00400	263	296	1.9933235294117648	33	G5B5J6	275	307	1.8987272727272728	32
Q60972	PF00400	321	345	0.0478	24	G5B5J6	307	331	0.023000000000000003	24
Q60972	PF00400	366	401	2.9108055555555565	35	G5B5J6	352	387	2.894416666666668	35
Q60972	PF12265	18	87	3.5106428571428565	69	G5B5J6	19	88	3.5059142857142853	69
O88512	PF01602	23	573	5.936720508166973	550	G5ASM3	23	572	5.473065454545453	549
O88512	PF02883	674	785	4.966392857142857	111	G5ASM3	662	773	6.302330357142859	111
P61924	PF01217	11	145	14.847459259259255	134	G5BID5	7	140	14.891850746268654	133
Q9WUT3	PF00069	58	317	5.721288461538464	259	G5BDY1	121	380	6.057253846153847	259
Q9WUT3	PF00069	414	671	8.414116279069766	257	G5BDY1	503	802	6.1718166666666665	299
Q9WUT3	PF00433	341	377	2.8364054054054053	36	G5BDY1	404	440	3.848108108108108	36
Q8K1B8	PF00169	367	451	5.910917647058822	84	G5B6F5	378	462	1.239764705882353	84
Q8K1B8	PF00373	257	366	2.7684818181818187	109	G5B6F5	258	377	2.623449999999999	119
Q8K1B8	PF18124	10	97	0.6542727272727272	87	G5B6F5	11	98	0.6546590909090906	87
Q7TSZ8	PF00651	19	119	15.313683168316837	100	G5BYV4	37	137	15.331841584158418	100
Q7TSZ8	PF10523	384	439	1.8965	55	G5BYV4	421	476	1.897910714285714	55
Q9CXI3	PF01082	186	313	4.1571484375000045	127	G5C784	118	245	5.613257812500003	127
Q9CXI3	PF03351	69	147	4.145746835443037	78	G5C784	1	79	4.1656329113924055	78
Q9CXI3	PF03712	333	481	7.98073154362416	148	G5C784	265	413	7.4491006711409415	148
Q9D1K7	PF15006	27	172	0.884472602739726	145	G5B4U5	77	222	0.9201575342465752	145
Q6PFD9	PF04096	738	884	3.5181292517006817	146	G5AVS4	722	868	3.5089659863945566	146
Q6PFD9	PF12110	1330	1621	4.964969178082192	291	G5AVS4	1312	1603	4.364770547945204	291
A6H639	PF13516	306	322	0.0	16	G5BNP2	257	272	0.0	15
A6H639	PF13516	330	348	0.10026315789473683	18	G5BNP2	281	298	0.10555555555555557	17
A6H639	PF13516	361	380	10.6287	19	G5BNP2	312	331	1.6575000000000002	19
A6H639	PF13516	414	435	4.973772727272726	21	G5BNP2	365	386	0.0	21
P10630	PF00270	57	221	8.810006060606066	164	G5BT85	58	222	8.810787878787881	164
P10630	PF00271	259	367	10.962458715596327	108	G5BT85	260	368	10.962458715596327	108
P70404	PF00180	55	376	1.663248447204969	321	G5BQT9	56	377	1.8205652173913052	321
Q8CDE2	PF01344	366	409	3.5552500000000014	43	G5BWB6	268	311	2.507659090909091	43
Q8CDE2	PF07707	176	233	16.587534482758613	57	G5BWB6	78	135	16.130241379310345	57
Q8CDE2	PF13964	318	363	2.4859130434782606	45	G5BWB6	220	265	3.4743043478260867	45
Q9D2L9	PF13365	367	556	8.783657894736839	189	G5AP38	370	556	12.514909090909095	186
Q8BGR8	PF05303	33	132	7.482360000000003	99	G5B498	34	133	8.775720000000009	99
Q9WU63	PF04832	22	193	5.918308139534882	171	G5AUC9	3	174	5.453744186046515	171
Q5SUQ9	PF15489	545	1096	7.5232500000000035	551	G5B5F6	436	997	7.954241992882565	561
Q91VA0	PF00501	67	468	9.159912935323382	401	G5B4E7	72	470	8.750421052631584	398
Q91VA0	PF13193	478	558	5.985456790123459	80	G5B4E7	481	561	5.625234567901233	80
Q8R395	PF07258	148	213	7.223045454545454	65	G5C5R0	149	214	7.420727272727274	65
Q80VJ8	PF14658	107	174	11.407147058823528	67	G5B8N4	38	105	13.554191176470585	67
Q80VJ8	PF14662	242	415	0.0	173	G5B8N4	173	327	0.0	154
P12815	PF13202	30	49	5.2379	19	G5BPG9	29	48	2.54245	19
P12815	PF13499	94	152	0.5958135593220338	58	G5BPG9	93	151	0.7662542372881357	58
Q3UA16	PF08234	150	219	7.1140285714285705	69	G5C8R1	151	220	8.83312857142857	69
Q91YI1	PF10033	87	194	6.191277777777778	107	G5ATC1	88	195	6.291194444444447	107
P97371	PF02251	8	45	0.08444736842105262	37	G5B296	9	45	0.0865945945945946	36
P97371	PF02252	103	244	10.580443661971833	141	G5B296	81	222	10.531295774647887	141
P35545	PF00240	3	70	4.1844117647058825	67	G5B6L6	4	71	6.5832058823529405	67
Q9D3R3	PF14580	47	69	0.22386956521739126	22	G5BPH3	50	71	0.17481818181818182	21
Q04887	PF00505	104	172	4.479	68	G5AV36	105	173	4.478217391304348	68
Q04887	PF12444	22	93	0.06608333333333333	71	G5AV36	23	94	0.06601388888888889	71
Q8VC42	PF07035	475	629	13.295103225806455	154	G5BTR0	445	599	12.743696774193554	154
Q8BL03	PF00153	11	88	19.00097435897436	77	G5B4B2	44	121	16.491858974358973	77
Q8BL03	PF00153	89	178	8.62135555555556	89	G5B4B2	122	211	7.5720777777777775	89
Q8BL03	PF00153	188	272	10.866494117647061	84	G5B4B2	221	305	11.953176470588234	84
P97465	PF02174	152	252	3.8129306930693083	100	G5AXE4	170	270	6.842475247524755	100
P97465	PF00169	4	116	0.3125221238938053	112	G5AXE4	5	117	1.115345132743363	112
Q04742	PF00046	159	215	0.4342105263157895	56	G5CBQ8	193	249	0.4318421052631579	56
Q8BG80	PF12937	474	506	0.2557272727272729	32	G5AUX6	464	496	0.198060606060606	32
Q921X6	PF05158	12	314	1.7853696369636975	302	G5CBB1	13	315	1.7853696369636975	302
Q9ES46	PF00307	89	194	12.581367924528301	105	G5BKH3	52	157	14.376320754716986	105
Q9ES46	PF00307	256	361	15.677575471698114	105	G5BKH3	219	324	11.734283018867927	105
Q8R2F2	PF00487	66	288	15.671470852017944	222	G5B4B1	167	405	14.0892510460251	238
Q8R2F2	PF08557	27	41	0.0	14	G5B4B1	128	142	0.0	14
P35396	PF00104	241	417	11.07835593220339	176	G5BDB4	360	542	10.605846994535518	182
P35396	PF00105	91	129	0.0	38	G5BDB4	120	156	0.0	36
Q7TT45	PF04670	112	338	11.240268722466958	226	G5C901	169	395	11.260850220264318	226
A2AI08	PF13914	506	643	1.0291739130434785	137	G5BZG1	160	297	1.0237536231884057	137
P62281	PF00366	74	143	0.2009285714285714	69	G5B8P3	70	139	0.16934285714285713	69
P62281	PF16205	5	72	0.06394117647058824	67	G5B8P3	1	68	0.09560294117647057	67
Q8K031	PF00620	581	725	6.840896551724137	144	G5B0H9	539	683	6.820193103448276	144
Q8K031	PF01852	814	1006	0.17662176165803115	192	G5B0H9	772	964	0.16874093264248707	192
Q6PB97	PF00646	403	442	0.07675	39	G5BYJ9	404	443	0.07675	39
Q6PB97	PF02008	12	56	0.0	44	G5BYJ9	13	57	0.0	44
Q6PB97	PF16866	61	128	1.1432205882352942	67	G5BYJ9	62	129	1.121044117647058	67
Q8R146	PF00326	522	730	7.386095693779902	208	G5BZW8	520	728	6.1029234449760725	208
Q8CC96	PF15661	30	657	2.1948980891719745	627	G5BEV9	1	632	1.3798589540412045	631
P37242	PF00104	268	435	5.479095238095236	167	G5BFQ2	284	451	5.452333333333333	167
P37242	PF00105	105	174	1.2978142857142854	69	G5BFQ2	121	190	1.329342857142857	69
O09061	PF00227	34	224	8.795785340314136	190	G5C7R9	35	225	8.849078534031413	190
P09084	PF00292	90	212	0.36535772357723584	122	G5CBC4	32	154	0.36924390243902416	122
O08811	PF06733	71	255	7.34747027027027	184	G5BKU3	71	255	3.394881081081081	184
O08811	PF06777	271	412	5.827253521126761	141	G5BKU3	271	412	6.451915492957745	141
O08811	PF13307	523	698	7.338164772727278	175	G5BKU3	523	698	7.085670454545458	175
Q9CQW7	PF10231	53	181	4.414069767441856	128	G5AWH3	11	139	4.3834573643410835	128
B7ZNG0	PF00225	20	348	3.872136778115502	328	G5CA96	21	349	3.8817203647416414	328
Q8VDY4	PF13499	105	166	0.2782903225806452	61	G5BSN1	106	167	0.028112903225806448	61
O55023	PF00459	6	266	6.559180076628351	260	G5BAK3	15	275	5.77689272030651	260
P97770	PF01170	295	478	3.324445652173913	183	G5BX93	295	478	1.678146739130435	183
P97770	PF02926	207	284	6.168089743589745	77	G5BX93	207	284	2.122551282051282	77
Q05A13	PF00106	37	229	9.180036269430051	192	G5B330	30	196	11.745461077844306	166
Q9DAN1	PF00085	385	486	13.27460784313726	101	G5C2G4	391	492	11.156098039215676	101
Q9DAN1	PF13848	176	360	8.379924324324321	184	G5C2G4	182	366	8.486064864864867	184
Q9CQ36	PF00808	58	103	11.50523913043478	45	G5AL07	2	47	5.441521739130435	45
O08738	PF00656	27	269	6.385555555555558	242	G5AQL9	16	269	7.4142992125984195	253
P48744	PF00007	43	129	5.011517241379312	86	G5ARF9	46	132	5.026057471264369	86
Q8C092	PF00400	471	498	0.2264999999999999	27	G5CAJ0	175	202	0.1877857142857143	27
Q8C092	PF00400	560	571	2.6500000000000004	11	G5CAJ0	237	247	0.04881818181818181	10
Q8C092	PF00400	638	655	0.2941666666666667	17	G5CAJ0	185	201	0.1166470588235294	16
Q8C092	PF00400	730	739	0.055200000000000006	9	G5CAJ0	239	248	0.0716	9
Q8C092	PF04494	297	337	0.9594878048780484	40	G5CAJ0	1	41	0.998	40
Q8VE09	PF10300	58	494	9.73619450800915	436	G5BLQ7	1	437	11.342878718535461	436
Q8QZX5	PF01423	19	82	3.5645781249999984	63	G5C6G2	20	83	1.957421875	63
Q9Z0J1	PF07648	631	670	0.0	39	G5B0H3	552	591	0.01775	39
Q9Z0J1	PF07648	715	740	0.1278846153846154	25	G5B0H3	636	661	0.12769230769230772	25
Q9Z0J1	PF07648	749	772	0.063875	23	G5B0H3	670	693	0.08466666666666668	23
Q8VDY9	PF15335	112	174	5.951238095238095	62	G5BPW6	126	188	5.9090317460317445	62
P48301	PF01285	50	106	0.01880701754385965	56	G5BAF0	1	57	0.02333333333333333	56
P48301	PF17725	225	441	11.133903225806458	216	G5BAF0	176	395	10.8816	219
Q8K0G5	PF00400	225	256	0.11199999999999999	31	G5C7L6	226	257	0.1113125	31
Q8K0G5	PF00400	262	296	1.3245714285714285	34	G5C7L6	263	297	1.4938571428571432	34
Q8K0G5	PF00400	338	372	2.3404857142857143	34	G5C7L6	340	374	2.2931714285714286	34
Q9Z2F6	PF00023	128	163	3.075333333333333	35	G5CBN2	52	87	9.761888888888887	35
Q9Z2F6	PF12796	182	265	6.496214285714284	83	G5CBN2	106	189	9.589261904761905	83
Q9Z2F6	PF12796	274	291	16.566833333333335	17	G5CBN2	198	214	9.712411764705884	16
Q8VCS6	PF07544	59	134	0.022578947368421056	75	G5BMW2	65	140	0.03	75
Q99M31	PF00012	19	506	2.5645	487	G5C5E2	1	488	2.9427438524590173	487
Q80U38	PF11977	429	581	10.416372549019613	152	G5BDS1	423	575	9.376359477124183	152
E9QAU8	PF13639	293	335	0.3056279069767441	42	G5BL84	227	269	0.31053488372093024	42
Q05306	PF00386	552	676	9.058575999999999	124	G5C156	556	680	8.620304000000006	124
Q05306	PF01391	108	150	0.0	42	G5C156	314	356	0.0	42
Q05306	PF01391	155	202	0.0	47	G5C156	156	202	0.0	46
Q05306	PF01391	199	242	0.0	43	G5C156	200	242	0.0	42
Q05306	PF01391	417	470	0.0	53	G5C156	304	359	0.0	55
Q3TNL8	PF03281	367	484	10.141406779661015	117	G5C8J4	360	470	8.36592792792793	110
Q8BT60	PF00168	12	112	16.796861386138627	100	G5BPJ9	13	113	16.554108910891088	100
Q8BT60	PF00168	144	239	0.10744791666666666	95	G5BPJ9	145	240	0.3406145833333333	95
Q8BT60	PF07002	309	523	11.801186046511633	214	G5BPJ9	310	524	8.906446511627907	214
Q8K039	PF15377	4	151	0.20126351351351351	147	G5B430	5	152	0.20890540540540545	147
A3KGW5	PF01755	316	498	14.046185792349725	182	G5ASE7	369	551	14.703426229508198	182
A3KGW5	PF13704	36	155	7.018541666666668	119	G5ASE7	89	208	5.965858333333334	119
Q99J78	PF00130	135	186	20.04401923076923	51	G5APH1	139	190	20.5175	51
Q99J78	PF13901	230	430	1.3074029850746267	200	G5APH1	234	434	1.305512437810945	200
Q921W0	PF03357	6	170	0.2867575757575758	164	G5API1	7	171	0.13829696969696972	164
Q9R0G7	PF00096	281	303	0.0	22	G5BLT0	282	304	0.0	22
Q9R0G7	PF00096	309	329	0.0	20	G5BLT0	310	330	0.0	20
Q9R0G7	PF00096	1054	1074	0.0	20	G5BLT0	1055	1075	0.0	20
Q9R0G7	PF05605	210	261	0.5068076923076923	51	G5BLT0	211	262	0.4838653846153846	51
Q9CXE2	PF04714	31	50	0.5425	19	G5AWP1	1	20	0.5345	19
Q8K3H0	PF00169	290	373	0.7312738095238098	83	G5ATN2	282	365	0.7304285714285712	83
Q8K3H0	PF00640	500	628	7.513713178294574	128	G5ATN2	492	620	8.372023255813954	128
Q8K3H0	PF16746	17	246	1.3925086956521744	229	G5ATN2	9	238	1.3626739130434782	229
Q8CHS8	PF07200	235	379	0.04351724137931035	144	G5B8F2	236	380	0.047220689655172406	144
Q9JI11	PF00069	30	280	1.1106294820717122	250	G5BB27	20	270	1.1078804780876497	250
Q9JI11	PF11629	432	479	0.0	47	G5BB27	422	469	0.0	47
Q9Z183	PF08526	0	110	6.289648648648647	110	G5BZN2	1	111	4.780441441441441	110
Q9Z183	PF03068	283	662	0.7983473684210531	379	G5BZN2	284	664	1.6169028871391076	380
Q9Z183	PF08527	112	272	3.2618074534161474	160	G5BZN2	113	273	3.2256832298136646	160
Q8BJQ2	PF00443	80	597	2.8631602316602285	517	G5BZE7	81	532	2.5037809734513266	451
Q9R0C0	PF14712	51	139	0.44961797752808985	88	G5BR26	25	113	0.3973370786516852	88
Q9CQT7	PF05903	7	145	0.5989928057553957	138	G5BPQ0	8	146	0.5996690647482013	138
Q8BZI0	PF00169	227	314	9.875272727272725	87	G5C3A7	223	310	7.550056818181818	87
Q8BZI0	PF00169	422	503	5.103756097560979	81	G5C3A7	418	499	6.186219512195121	81
P27546	PF00418	903	924	0.0	21	G5BTG1	939	960	0.0	21
P27546	PF00418	964	994	0.0	30	G5BTG1	1000	1030	0.0	30
P27546	PF00418	995	1025	0.0	30	G5BTG1	1031	1061	0.0	30
P27546	PF00418	1026	1056	0.0	30	G5BTG1	1062	1092	0.0	30
Q8VCM2	PF00018	240	281	0.4525000000000001	41	G5BY54	215	256	0.5033333333333333	41
Q8VCM2	PF00787	43	119	0.6231688311688311	76	G5BY54	22	98	5.4116753246753255	76
P53612	PF00432	73	115	39.359395348837204	42	G5AXL8	20	62	37.05539534883721	42
P53612	PF00432	121	164	27.978795454545452	43	G5AXL8	68	111	17.32454545454545	43
P53612	PF00432	169	202	1.4133235294117648	33	G5AXL8	116	148	0.5285757575757576	32
P53612	PF00432	233	260	34.93417857142857	27	G5AXL8	132	165	28.767117647058825	33
P53612	PF00432	265	309	6.922755555555558	44	G5AXL8	170	214	6.877244444444447	44
P97431	PF00605	8	112	1.4642571428571427	104	G5BAM5	9	113	1.4763333333333344	104
P97431	PF10401	223	405	2.3084316939890708	182	G5BAM5	219	401	2.315153005464481	182
Q9CWS0	PF02274	101	162	4.301193548387096	61	G5C915	12	73	4.287129032258063	61
Q8JZZ6	PF01871	110	278	2.0997100591715987	168	G5B9W2	111	279	2.1267337278106506	168
Q3TYA6	PF00385	58	108	0.0	50	G5B1A9	58	108	0.0	50
Q3TYA6	PF12796	569	660	15.105576086956516	91	G5B1A9	571	662	14.831119565217387	91
Q3TYA6	PF12796	661	716	2.9712500000000004	55	G5B1A9	663	718	2.838446428571429	55
Q7TQ07	PF00476	446	851	3.904512315270937	405	G5BCI0	441	846	4.529532019704433	405
Q7TQ07	PF18049	197	414	10.456963302752293	217	G5BCI0	194	405	7.992448113207547	211
Q8BXN7	PF00481	114	337	8.10297767857143	223	G5AKM2	115	338	8.166308035714282	223
Q8C5N3	PF02847	453	559	5.524570093457941	106	G5BIR2	458	564	5.494373831775701	106
Q8C5N3	PF02854	161	342	11.98475824175824	181	G5BIR2	167	349	11.929114754098366	182
Q8C0M0	PF00400	97	133	12.944486486486484	36	G5B5X1	77	113	12.976783783783784	36
Q8C0M0	PF00400	158	175	0.0	17	G5B5X1	138	155	0.0	17
Q8C0M0	PF00400	187	219	0.08378787878787873	32	G5B5X1	167	199	0.055575757575757584	32
Q8C0M0	PF17120	939	988	0.3483600000000001	49	G5B5X1	900	949	0.34973999999999994	49
Q9WTZ9	PF04538	0	119	0.0	119	G5C3Q0	53	159	0.03642056074766355	106
Q8BU27	PF00481	132	211	8.654175000000002	79	G5AXM7	148	227	8.765612499999998	79
Q8BU27	PF00481	268	361	5.6095425531914875	93	G5AXM7	284	376	1.0018064516129028	92
P10629	PF00046	141	197	0.09359649122807018	56	G5BIE2	142	198	0.09359649122807018	56
P54285	PF00625	175	353	5.453692737430169	178	G5AU42	183	361	5.454402234636872	178
P54285	PF12052	15	57	0.0	42	G5AU42	16	58	0.003302325581395349	42
Q8CFV2	PF12516	304	368	0.0	64	G5BNV4	298	361	0.0	63
P63248	PF02827	1	69	0.10443478260869568	68	G5AW51	2	70	0.10443478260869568	68
Q8BZ64	PF07773	211	380	3.6553235294117674	169	G5AWL9	250	411	3.4770061728395065	161
Q0VBL6	PF00989	89	143	9.010709090909092	54	G5AUZ0	84	138	8.767254545454545	54
Q0VBL6	PF08447	249	323	0.23819999999999994	74	G5AUZ0	244	318	0.23756	74
Q0VBL6	PF11413	475	503	0.0	28	G5AUZ0	473	501	0.0	28
Q921L5	PF06148	14	145	0.494462121212121	131	G5BQI4	15	146	0.4908787878787885	131
Q921L5	PF12022	565	691	0.10983464566929138	126	G5BQI4	574	699	0.1102380952380952	125
Q9CQ84	PF00240	2	72	0.23316901408450705	70	G5BD73	3	73	0.6479154929577464	70
Q9CQ84	PF17840	88	132	1.533755555555555	44	G5BD73	93	136	0.31395454545454543	43
Q8R4E4	PF05556	19	237	0.025990867579908674	218	G5B719	20	237	0.0	217
O35425	PF00452	70	171	13.266794117647068	101	G5C3S0	20	121	9.759715686274507	101
P23812	PF00046	200	256	0.0	56	G5BU15	205	261	0.0	56
Q9Z0G0	PF00595	133	202	0.2493	69	G5BYS5	134	203	0.2453285714285713	69
Q8K0H5	PF03540	127	176	1.98628	49	G5BBQ4	37	86	2.0184800000000003	49
O08608	PF02100	97	178	14.112060975609758	81	G5AN78	68	149	12.841658536585367	81
Q3TB82	PF00169	38	130	13.300129032258072	92	G5BL44	39	131	13.305881720430104	92
Q3TB82	PF01363	147	210	2.100078125000001	63	G5BL44	148	211	2.11303125	63
Q80WM7	PF00089	33	270	4.088453781512605	237	G5B1K3	22	259	3.5009915966386567	237
O54940	PF12496	49	162	0.01773684210526316	113	G5AWC5	119	232	0.04899122807017544	113
O54940	PF13716	165	299	18.77002962962963	134	G5AWC5	235	368	19.605947761194006	133
Q8BMA5	PF15712	754	1403	0.998835384615384	649	G5BXR1	755	1412	1.534764437689968	657
Q8VIK1	PF18036	31	119	5.174134831460675	88	G5BXY9	78	166	5.145764044943818	88
Q9CZB3	PF01170	273	411	4.8959784172661855	138	G5AMV9	331	469	7.93468345323741	138
Q9CZB3	PF02926	188	254	0.9645223880597014	66	G5AMV9	246	312	1.7468805970149253	66
Q8BMB3	PF01652	54	213	4.638268750000002	159	G5ASX1	57	216	4.6253375000000005	159
P33609	PF00136	778	1230	4.73305077262693	452	G5AUJ3	742	1183	4.5513212669683245	441
P33609	PF03104	374	713	5.128782352941174	339	G5AUJ3	377	677	6.005893687707641	300
P33609	PF08996	1269	1386	1.81593220338983	117	G5AUJ3	1222	1338	4.028444444444443	116
P33609	PF12254	40	101	0.0	61	G5AUJ3	41	101	0.0	60
Q8C3Q9	PF00619	38	90	0.6119056603773585	52	G5BRS8	1	53	1.4798490566037736	52
Q8C3Q9	PF00656	198	450	4.768873517786555	252	G5BRS8	160	412	6.038280632411062	252
Q9CXI5	PF10208	25	169	1.369751724137931	144	G5BZT9	26	170	1.3657310344827591	144
P22727	PF00110	43	362	2.6467406250000005	319	G5AKL4	11	330	2.6487093749999993	319
Q80Y17	PF08366	278	378	5.364267326732675	100	G5BMX5	254	354	7.782356435643566	100
Q80Y17	PF08596	822	951	5.312638461538464	129	G5BMX5	798	926	5.512930232558137	128
Q8R1H8	PF00170	27	68	0.0	41	G5B6M9	13	53	0.0	40
Q9JJR7	PF00010	95	144	0.41772	49	G5BUW8	97	146	0.14670000000000002	49
Q9QYM5	PF00071	62	176	3.8929826086956503	114	G5BN94	1	115	4.0982521739130435	114
Q8VED5	PF00038	137	451	0.3135142857142857	314	G5BJ37	138	453	0.3161708860759496	315
Q8VED5	PF16208	27	92	0.07495454545454545	65	G5BJ37	28	92	0.13192307692307692	64
Q8VED5	PF16208	78	134	0.14931578947368426	56	G5BJ37	77	135	0.0	58
O88968	PF01122	18	325	5.7748733766233755	307	G5AVP0	19	322	5.535460526315797	303
O88968	PF14478	354	426	0.8836438356164386	72	G5AVP0	354	426	0.541904109589041	72
Q91YP2	PF01432	250	699	2.2704866666666668	449	G5B0F0	238	687	2.8746422222222225	449
Q80TI1	PF00169	573	664	0.8713913043478262	91	G5C7X8	583	674	1.0114021739130437	91
Q80TI1	PF00373	1099	1223	3.674071999999999	124	G5C7X8	1109	1233	1.55296	124
Q80TI1	PF00784	871	977	8.31207476635514	106	G5C7X8	881	987	12.328084112149535	106
O35423	PF00266	48	397	6.706771428571424	349	G5C3Q9	27	376	4.360068571428573	349
P14847	PF00354	25	220	7.531928571428572	195	G5BWM1	26	221	6.303836734693879	195
P29594	PF00619	36	117	1.14609756097561	81	G5C2L9	20	101	2.9382439024390243	81
P29594	PF00656	199	426	5.246293859649117	227	G5C2L9	183	410	6.471135964912277	227
Q9JME7	PF04628	6	134	8.15268992248062	128	G5C2T6	7	135	7.420193798449612	128
P97313	PF00454	3747	4014	4.977097014925372	267	G5BHS5	3742	4010	6.2190855018587365	268
P97313	PF02259	3026	3469	3.3998355855855857	443	G5BHS5	3034	3477	3.783511261261264	443
P97313	PF02260	4097	4127	0.0	30	G5BHS5	4093	4123	0.0	30
P97313	PF08163	1812	2197	5.06385233160622	385	G5BHS5	1817	2203	6.71197932816537	386
Q9DAA3	PF15022	0	116	0.03671794871794872	116	G5C955	1	116	0.6428521739130437	115
Q8CCX5	PF00038	1	148	0.02155405405405405	147	G5AX72	2	149	0.020547297297297297	147
Q8N7N5	PF00400	177	214	16.46971052631579	37	G5BWK5	156	193	18.84094736842105	37
Q8N7N5	PF00400	417	455	0.4172564102564104	38	G5BWK5	401	439	0.4272051282051281	38
Q8N7N5	PF00400	467	498	0.12503124999999995	31	G5BWK5	451	482	0.1256875	31
Q9D7S9	PF03357	23	194	0.004395348837209302	171	G5BYI9	1	129	0.0	128
Q924S8	PF00568	17	116	0.93475	99	G5C7C9	18	117	0.9346099999999996	99
Q924S8	PF05210	331	435	8.864095238095238	104	G5C7C9	333	437	8.863809523809524	104
Q8VCC9	PF00090	445	493	0.00826530612244898	48	G5BUE5	383	431	0.005551020408163266	48
Q8VCC9	PF00090	504	553	0.0	49	G5BUE5	442	491	0.0	49
Q8VCC9	PF00090	562	609	0.0	47	G5BUE5	500	547	0.0	47
Q8VCC9	PF00090	617	664	0.0	47	G5BUE5	555	602	0.0	47
Q8VCC9	PF00090	758	806	0.01826530612244898	48	G5BUE5	696	744	0.013333333333333334	48
Q8VCC9	PF02014	79	170	10.203760869565217	91	G5BUE5	40	108	9.485971014492751	68
Q8VCC9	PF06468	204	396	2.8604455958549218	192	G5BUE5	142	334	2.866233160621761	192
Q8VCC9	PF19028	668	719	0.0	51	G5BUE5	606	657	0.0	51
Q8BW96	PF00069	30	278	7.4227630522088335	248	G5BE23	1	249	7.403341365461844	248
Q68FE6	PF15903	16	364	1.8209999999999995	348	G5C664	118	468	1.7975811965811948	350
Q60936	PF03109	315	429	1.172756521739131	114	G5BL23	363	477	1.1718695652173914	114
Q7TPZ8	PF00246	127	404	1.1345323741007192	277	G5BH74	130	407	2.0300215827338133	277
Q7TPZ8	PF02244	26	99	0.0279054054054054	73	G5BH74	27	100	0.7812297297297296	73
Q80WR5	PF15772	5	222	0.026605504587155958	217	G5CBI0	104	326	0.12396412556053812	222
Q80WP8	PF00282	105	472	4.418739130434784	367	G5BIW6	59	377	4.806840125391848	318
Q8CGI1	PF15914	1174	1229	0.07089285714285715	55	G5BCH4	1183	1238	0.8307678571428571	55
O35639	PF00191	22	86	10.462353846153848	64	G5C320	45	109	9.516876923076923	64
O35639	PF00191	93	158	2.4148333333333327	65	G5C320	116	181	1.7784393939393937	65
O35639	PF00191	177	242	5.897015151515151	65	G5C320	200	265	7.6297878787878775	65
O35639	PF00191	254	317	0.25053125000000004	63	G5C320	277	340	0.10034375	63
P53569	PF03914	522	731	8.177204761904761	209	G5BZ83	525	733	8.0215980861244	208
Q9D8T3	PF00071	7	167	11.571124223602483	160	G5AU30	8	168	10.344677018633543	160
Q9D0R9	PF00400	62	97	0.2251944444444444	35	G5BCZ3	63	98	0.0	35
Q9D0R9	PF00400	159	197	0.7925897435897438	38	G5BCZ3	161	199	0.8239487179487178	38
Q9D0R9	PF00400	314	347	2.096970588235294	33	G5BCZ3	316	349	0.0	33
P61375	PF00046	180	236	5.824315789473684	56	G5AKX3	181	237	5.824315789473684	56
P61375	PF00412	4	59	8.765214285714286	55	G5AKX3	5	60	8.765196428571429	55
P61375	PF00412	63	120	0.5687931034482759	57	G5AKX3	64	121	0.5687931034482759	57
P62340	PF00352	10	89	12.82285	79	G5AS62	11	90	11.765912500000002	79
P62340	PF00352	98	177	13.326925	79	G5AS62	99	178	12.1311125	79
Q8K3F2	PF00045	354	388	12.552485714285718	34	G5C968	354	388	12.905228571428573	34
Q8K3F2	PF00045	403	447	0.0	44	G5C968	403	447	0.0	44
Q8K3F2	PF00045	450	494	18.003711111111112	44	G5C968	450	494	27.04508888888888	44
Q8K3F2	PF00413	169	325	0.035745222929936316	156	G5C968	169	325	0.041210191082802564	156
Q8K3F2	PF01471	47	106	0.61195	59	G5C968	48	112	0.9405384615384615	64
Q61083	PF00069	357	614	4.048554263565893	257	G5B9V0	348	605	4.061054263565893	257
Q61083	PF00564	43	120	6.028961538461537	77	G5B9V0	34	111	6.065217948717949	77
Q8CI75	PF00773	368	716	3.5808051575931232	348	G5ASX6	372	720	4.590644699140402	348
Q8CI75	PF17216	49	125	0.5294025974025973	76	G5ASX6	51	127	0.5320259740259738	76
Q8CI75	PF17849	262	338	6.870597402597403	76	G5ASX6	266	342	7.015220779220781	76
Q8CI75	PF17877	763	851	13.736898876404505	88	G5ASX6	767	855	17.22537078651685	88
Q80VC6	PF00076	25	72	0.33391666666666664	47	G5AP91	1	48	0.3141458333333333	47
Q80VC6	PF00076	97	160	6.598609375	63	G5AP91	73	136	6.530625	63
Q80VC6	PF17654	185	283	0.03116161616161616	98	G5AP91	161	259	0.03126262626262626	98
O35144	PF00249	487	534	0.6182499999999999	47	G5AK43	449	496	0.6163541666666666	47
O35144	PF08558	97	292	4.083836734693878	195	G5AK43	59	254	4.068913265306122	195
O35144	PF16772	320	358	1.5236153846153844	38	G5AK43	283	321	0.014743589743589743	38
Q3UM29	PF10191	1	765	4.205690196078436	764	G5BV75	2	766	4.6541189542483625	764
Q9Z2V5	PF00850	104	399	5.210888513513514	295	G5BJI0	511	805	5.470247457627118	294
Q9Z2V5	PF00850	498	795	6.905352348993293	297	G5BJI0	905	1202	6.730724832214767	297
Q9Z2V5	PF02148	1066	1127	11.875258064516126	61	G5BJI0	1407	1468	6.119419354838708	61
Q9CQ22	PF15454	17	84	0.9694558823529412	67	G5AVT4	18	85	0.965720588235294	67
P54830	PF00102	299	419	6.565785123966943	120	G5AK96	400	519	6.593133333333339	119
Q8C0Q2	PF00046	496	544	0.0	48	G5C9N2	502	550	0.0	48
Q8C0Q2	PF00046	614	660	0.0	46	G5C9N2	620	666	0.0	46
Q8C0Q2	PF11569	844	886	0.0	42	G5C9N2	850	892	0.0	42
Q8C0Q2	PF18387	104	155	2.135038461538461	51	G5C9N2	105	156	9.966365384615383	51
P97460	PF00010	11	56	7.950913043478261	45	G5B794	12	57	7.904065217391302	45
P97460	PF00989	84	153	9.463857142857146	69	G5B794	85	154	8.701814285714287	69
P97460	PF14598	248	351	6.405355769230771	103	G5B794	211	314	10.396865384615383	103
P60867	PF00338	20	114	0.14930526315789475	94	G5B335	21	115	0.14930526315789475	94
Q99M07	PF10203	12	64	0.6547358490566038	52	G5BMT6	13	64	4.629423076923077	51
P57080	PF00443	221	654	4.6191036866359445	433	G5B4P6	1	432	5.596187500000003	431
Q61081	PF03234	0	109	0.033818181818181824	109	G5B224	1	109	0.03408256880733945	108
Q61081	PF08564	291	355	0.0	64	G5B224	291	355	0.0	64
Q61081	PF08565	162	273	8.07175	111	G5B224	162	273	11.318232142857141	111
Q9Z175	PF00530	52	145	0.0	93	G5AXE5	51	144	0.0	93
Q9Z175	PF00530	185	281	1.942	96	G5AXE5	184	280	3.517958762886598	96
Q9Z175	PF00530	311	407	0.19354639175257726	96	G5AXE5	309	405	0.19360824742268046	96
Q9Z175	PF00530	421	525	1.0131619047619047	104	G5AXE5	419	523	0.8675047619047621	104
Q9Z175	PF01186	530	729	3.22574	199	G5AXE5	528	727	3.225895	199
P39689	PF02234	19	66	0.0309375	47	G5B541	21	68	0.021125	47
P61600	PF00583	25	127	12.042223300970873	102	G5CBB8	26	128	12.05935922330097	102
O55189	PF05111	22	406	0.13662597402597407	384	G5BMZ7	1	343	0.09020467836257312	342
Q8BL66	PF01363	1347	1409	0.084984126984127	62	G5B009	1341	1403	0.0580952380952381	62
Q91YQ3	PF00313	70	133	0.240671875	63	G5BPP8	69	132	0.31625000000000003	63
Q8K0L0	PF07525	591	629	0.0	38	G5AXI9	578	616	0.0	38
Q8K0L0	PF12796	175	267	1.2450967741935486	92	G5AXI9	176	268	1.062827956989248	92
Q8K0L0	PF12796	307	396	0.19462222222222225	89	G5AXI9	308	382	0.09626666666666668	74
Q8K0L0	PF13606	271	297	5.898222222222223	26	G5AXI9	272	298	5.8530740740740725	26
Q8K0L0	PF13637	105	156	0.0	51	G5AXI9	106	157	0.0	51
P59024	PF00254	39	131	8.360978494623657	92	G5BRM1	40	132	7.493784946236558	92
P59024	PF13499	140	205	0.0346969696969697	65	G5BRM1	141	206	0.034924242424242434	65
P50462	PF00412	9	64	0.0	55	G5AR19	10	65	0.0	55
P50462	PF00412	119	175	0.023596491228070168	56	G5AR19	120	176	0.023596491228070168	56
Q9D7I8	PF07894	19	292	5.905182481751822	273	G5B806	20	294	6.0459018181818225	274
Q8C3R1	PF02985	500	527	0.2230714285714286	27	G5BF56	504	530	0.059851851851851864	26
O08911	PF00069	42	310	4.846572490706318	268	G5B2I0	1	269	3.8190817843866167	268
O35125	PF13516	88	101	0.0	13	G5CAR7	90	103	0.22814285714285715	13
O35125	PF14580	201	304	3.6239134615384616	103	G5CAR7	202	304	3.646708737864077	102
A2AAJ9	PF00041	515	596	0.1974634146341463	81	G5C996	337	418	1.1667073170731708	81
A2AAJ9	PF00041	5469	5507	2.4579743589743592	38	G5C996	7486	7523	0.6641052631578948	37
A2AAJ9	PF00069	7415	7490	9.594315789473681	75	G5C996	9806	9880	8.069093333333335	74
A2AAJ9	PF00069	8594	8670	6.3315064935064935	76	G5C996	9805	9880	7.962921052631581	75
A2AAJ9	PF00612	5822	5841	0.0	19	G5C996	7814	7833	0.0	19
A2AAJ9	PF00621	6645	6817	2.002531791907514	172	G5C996	8633	8805	2.178739884393064	172
A2AAJ9	PF07679	8	94	3.0271149425287365	86	G5C996	103	233	2.63193893129771	130
A2AAJ9	PF07679	108	199	2.0605434782608696	91	G5C996	8058	8148	5.359054945054945	90
A2AAJ9	PF07679	242	324	6.675240963855423	82	G5C996	154	236	0.6337951807228916	82
A2AAJ9	PF07679	332	403	0.04854166666666667	71	G5C996	2800	2870	3.9677746478873255	70
A2AAJ9	PF07679	718	777	3.3793833333333327	59	G5C996	538	596	18.569966101694913	58
A2AAJ9	PF07679	868	936	0.0	68	G5C996	713	781	0.016956521739130436	68
A2AAJ9	PF07679	960	1028	0.0	68	G5C996	713	781	0.016956521739130436	68
A2AAJ9	PF07679	1052	1120	0.0	68	G5C996	1056	1124	0.016956521739130436	68
A2AAJ9	PF07679	1144	1212	0.0	68	G5C996	1539	1607	0.016956521739130436	68
A2AAJ9	PF07679	1236	1304	0.0	68	G5C996	1056	1124	0.016956521739130436	68
A2AAJ9	PF07679	1328	1398	0.0	70	G5C996	713	783	0.016478873239436618	70
A2AAJ9	PF07679	1420	1488	0.0	68	G5C996	1056	1124	0.016956521739130436	68
A2AAJ9	PF07679	1512	1580	0.0	68	G5C996	713	781	0.016956521739130436	68
A2AAJ9	PF07679	1604	1672	0.0	68	G5C996	713	781	0.016956521739130436	68
A2AAJ9	PF07679	1604	1672	0.0	68	G5C996	713	781	0.016956521739130436	68
A2AAJ9	PF07679	1604	1672	0.0	68	G5C996	713	781	0.016956521739130436	68
A2AAJ9	PF07679	1604	1672	0.0	68	G5C996	713	781	0.016956521739130436	68
A2AAJ9	PF07679	1972	2041	0.0	69	G5C996	713	781	0.016956521739130436	68
A2AAJ9	PF07679	2064	2132	0.0	68	G5C996	1056	1124	0.016956521739130436	68
A2AAJ9	PF07679	2158	2227	15.815599999999995	69	G5C996	1817	1885	8.269144927536232	68
A2AAJ9	PF07679	2242	2317	1.8236973684210533	75	G5C996	1901	1975	0.6636666666666666	74
A2AAJ9	PF07679	2332	2410	3.6147088607594937	78	G5C996	1991	2069	0.3666962025316456	78
A2AAJ9	PF07679	2422	2499	0.013653846153846155	77	G5C996	2081	2158	9.099205128205126	77
A2AAJ9	PF07679	2599	2675	0.9568311688311684	76	G5C996	2258	2335	5.078487179487179	77
A2AAJ9	PF07679	2725	2797	0.0	72	G5C996	2439	2511	0.20104109589041103	72
A2AAJ9	PF07679	2904	2984	0.482395061728395	80	G5C996	2624	2704	0.17975308641975304	80
A2AAJ9	PF07679	3079	3160	0.74509756097561	81	G5C996	2799	2880	4.125536585365855	81
A2AAJ9	PF07679	3169	3239	3.733943661971831	70	G5C996	2889	2959	4.789225352112677	70
A2AAJ9	PF07679	3260	3335	1.8542105263157895	75	G5C996	2980	3054	8.014613333333331	74
A2AAJ9	PF07679	3348	3420	0.16139726027397255	72	G5C996	3068	3140	0.36424657534246574	72
A2AAJ9	PF07679	3529	3600	1.5753888888888892	71	G5C996	3249	3319	0.4158591549295775	70
A2AAJ9	PF07679	3617	3700	0.19830952380952374	83	G5C996	3337	3420	0.2826428571428572	83
A2AAJ9	PF07679	3706	3787	1.120158536585366	81	G5C996	3426	3507	0.07689024390243904	81
A2AAJ9	PF07679	3794	3876	0.15175903614457828	82	G5C996	3426	3508	0.07596385542168675	82
A2AAJ9	PF07679	3882	3963	0.029414634146341462	81	G5C996	3602	3683	0.2871585365853659	81
A2AAJ9	PF07679	3970	4038	0.993	68	G5C996	6345	6413	0.0163768115942029	68
A2AAJ9	PF07679	4043	4122	0.02522499999999999	79	G5C996	3427	3506	0.0712625	79
A2AAJ9	PF07679	4131	4209	0.02379746835443038	78	G5C996	6346	6424	0.05565822784810127	78
A2AAJ9	PF07679	4218	4299	0.02	81	G5C996	6345	6425	0.06649382716049383	80
A2AAJ9	PF07679	4307	4379	0.022465753424657533	72	G5C996	3427	3499	0.045000000000000005	72
A2AAJ9	PF07679	4395	4474	0.336175	79	G5C996	5554	5633	0.042825	79
A2AAJ9	PF07679	4482	4562	0.07448148148148148	80	G5C996	3426	3506	0.07038271604938272	80
A2AAJ9	PF07679	4570	4650	0.024913580246913567	80	G5C996	6345	6425	0.06649382716049383	80
A2AAJ9	PF07679	4658	4738	0.20785185185185187	80	G5C996	6345	6425	0.06649382716049383	80
A2AAJ9	PF07679	4747	4821	0.0396	74	G5C996	6346	6420	0.017066666666666667	74
A2AAJ9	PF07679	4835	4915	0.4829382716049382	80	G5C996	6685	6765	0.5215185185185185	80
A2AAJ9	PF07679	4924	4996	0.0	72	G5C996	6774	6846	0.0	72
A2AAJ9	PF07679	5012	5087	0.14425000000000002	75	G5C996	6862	6937	0.020131578947368417	75
A2AAJ9	PF07679	5105	5179	0.4392	74	G5C996	6955	7028	0.0	73
A2AAJ9	PF07679	5380	5457	2.3128461538461518	77	G5C996	7397	7473	3.2723376623376623	76
A2AAJ9	PF07679	5578	5636	0.04033898305084746	58	G5C996	7579	7636	0.24324137931034484	57
A2AAJ9	PF07679	5846	5935	2.8338222222222216	89	G5C996	7838	7927	2.411422222222222	89
A2AAJ9	PF07679	6076	6166	5.187835164835165	90	G5C996	8067	8157	5.350615384615383	90
A2AAJ9	PF07679	6208	6298	0.9923296703296706	90	G5C996	8199	8289	1.680428571428571	90
A2AAJ9	PF07679	6319	6414	2.596177083333333	95	G5C996	8310	8404	2.620042105263158	94
A2AAJ9	PF07679	6989	7046	0.35139655172413786	57	G5C996	9038	9095	0.4336551724137931	57
A2AAJ9	PF07679	7057	7139	7.320012048192773	82	G5C996	9106	9188	4.848168674698796	82
A2AAJ9	PF07679	7305	7394	4.432611111111114	89	G5C996	9695	9783	1.7080112359550557	88
A2AAJ9	PF07679	8383	8463	9.83782716049383	80	G5C996	8057	8137	6.023037037037038	80
Q8K4R4	PF02121	16	242	3.9395947136563874	226	G5BVE4	19	281	3.385448669201521	262
P62515	PF00046	278	334	1.5545263157894738	56	G5C0F2	279	335	1.5545263157894738	56
P62515	PF00157	190	259	1.0306142857142857	69	G5C0F2	191	260	1.0306142857142857	69
Q07076	PF00191	163	228	5.638378787878787	65	G5C7G6	190	255	6.7556818181818175	65
Q07076	PF00191	235	299	1.2364461538461535	64	G5C7G6	262	326	1.436784615384615	64
Q07076	PF00191	319	383	0.8298769230769228	64	G5C7G6	346	410	0.8227230769230766	64
Q07076	PF00191	394	459	7.194939393939393	65	G5C7G6	421	486	9.490363636363636	65
Q9JLI8	PF00076	705	773	4.043057971014494	68	G5AWZ8	705	770	3.123863636363636	65
Q9JLI8	PF00076	802	871	0.24207142857142855	69	G5AWZ8	764	833	0.23955714285714286	69
Q9JLI8	PF05391	943	960	0.10400000000000001	17	G5AWZ8	906	923	0.10438888888888888	17
Q9JLI8	PF16605	876	934	0.0	58	G5AWZ8	838	897	0.0	59
Q8C1A9	PF09752	15	456	2.4858914027149326	441	G5AKY7	16	418	3.251794044665014	402
O70378	PF03665	3	198	2.9332959183673464	195	G5BJG0	4	199	4.451214285714285	195
Q6I6G8	PF00168	186	295	5.878772727272728	109	G5AX16	187	297	5.5796936936936925	110
Q6I6G8	PF00397	817	843	0.027333333333333338	26	G5AX16	818	844	0.027555555555555555	26
Q6I6G8	PF16562	44	163	4.1326333333333345	119	G5AX16	45	164	4.136366666666668	119
Q6I6G8	PF18436	921	986	11.56840909090909	65	G5AX16	922	987	11.371863636363635	65
Q6NT99	PF00782	71	145	8.083133333333334	74	G5BWM0	72	146	8.484253333333331	74
O89101	PF00167	83	174	2.7921847826086954	91	G5B476	225	371	2.1662925170068017	146
Q80VW7	PF12443	585	655	0.0	70	G5B1Y8	605	671	0.02426865671641791	66
Q8R3P7	PF10234	13	281	2.434962825278809	268	G5B1H2	78	346	2.5225390334572486	268
Q9R1A8	PF00400	471	500	3.695566666666666	29	G5BIA6	456	485	3.744066666666667	29
Q9R1A8	PF00400	505	543	0.0	38	G5BIA6	490	528	0.0	38
Q9R1A8	PF00400	558	585	0.0	27	G5BIA6	543	570	0.0	27
Q9R1A8	PF00400	591	627	0.04364864864864864	36	G5BIA6	576	612	0.0445945945945946	36
Q9R1A8	PF00400	633	668	4.723527777777779	35	G5BIA6	618	653	5.783083333333334	35
Q9R1A8	PF13923	137	174	0.03026315789473684	37	G5BIA6	122	159	0.061631578947368426	37
Q4VAA7	PF00787	259	333	3.71944	74	G5AL79	257	331	3.723213333333333	74
Q4VAA7	PF10456	336	571	2.702711864406778	235	G5AL79	334	569	2.3313389830508457	235
Q4VAA7	PF14604	6	56	0.6077450980392156	50	G5AL79	7	57	0.625686274509804	50
Q99LJ2	PF00651	104	207	11.657048076923079	103	G5C7W7	105	208	11.650499999999996	103
Q99LJ2	PF00651	270	373	9.06610576923077	103	G5C7W7	271	374	7.069855769230768	103
Q99LJ2	PF12796	5	63	1.321542372881356	58	G5C7W7	6	64	11.084118644067798	58
Q8BWR4	PF00443	41	321	8.01777580071174	280	G5BXG1	49	329	8.020014234875442	280
Q52KI8	PF01480	45	114	0.2278285714285715	69	G5BHW9	30	99	0.2276714285714285	69
Q8VHC5	PF00036	130	156	0.0	26	G5BSA3	131	157	0.0212962962962963	26
Q8VHC5	PF13499	205	264	0.5236666666666667	59	G5BSA3	206	265	0.8537166666666667	59
Q9ESW4	PF00781	61	194	7.015134328358211	133	G5B577	62	195	7.010291044776117	133
Q4FZF2	PF17734	0	35	0.0	35	G5BU45	1	36	1.3454444444444442	35
Q4FZF2	PF17734	36	184	1.2971140939597314	148	G5BU45	242	393	0.2899736842105263	151
Q9Z1P8	PF00147	188	402	1.0235813953488375	214	G5B4M0	78	292	0.8718232558139535	214
Q76LL6	PF02181	1042	1408	5.256449591280658	366	G5C755	986	1352	5.277348773841965	366
Q99NI3	PF02946	103	177	3.535360000000001	74	G5C6B2	107	181	3.429066666666667	74
Q99NI3	PF02946	327	399	3.831068493150685	72	G5C6B2	331	403	5.525589041095889	72
Q99NI3	PF14291	534	622	12.501528089887636	88	G5C6B2	538	626	13.704101123595505	88
Q99NI3	PF18658	424	484	6.715967213114754	60	G5C6B2	428	488	6.7189836065573765	60
O35643	PF01602	13	531	7.762658959537577	518	G5APX0	30	548	7.570763005780347	518
O35643	PF02883	717	822	3.4511698113207543	105	G5APX0	729	834	3.847462264150944	105
O35643	PF09066	832	940	4.976055045871559	108	G5APX0	844	952	4.913853211009172	108
Q9CY02	PF09236	4	90	5.12735632183908	86	G5BYB6	5	104	10.60197	99
Q62559	PF09822	12	115	2.4545288461538477	103	G5BCW7	13	116	2.7584423076923064	103
Q9DBA8	PF01979	78	421	1.754656976744185	343	G5C0T0	79	422	3.9635058139534887	343
Q61884	PF13868	114	464	0.11972934472934478	350	G5B7F5	82	420	0.015061946902654869	338
Q9EQX0	PF04643	56	114	0.0	58	G5BX68	57	115	0.0	58
Q9EQX0	PF04644	23	50	0.0	27	G5BX68	24	51	0.0	27
Q9DAQ5	PF15075	12	145	0.16087313432835815	133	G5BK66	12	144	0.061654135338345864	132
Q8BIG2	PF15478	79	178	1.63143	99	G5C8A7	1	100	3.839930000000001	99
O35129	PF01145	41	219	0.8262569832402233	178	G5CAS2	42	220	0.7774581005586594	178
Q8VCR9	PF07303	105	205	2.080247524752476	100	G5B7U8	68	168	4.8102475247524765	100
A3KGB4	PF00566	489	692	20.18963725490196	203	G5C3Z0	553	756	20.19456862745097	203
A3KGB4	PF02893	145	250	20.621716981132078	105	G5C3Z0	209	314	20.12717924528302	105
A3KGB4	PF02893	285	376	1.8629782608695649	91	G5C3Z0	349	439	8.288285714285715	90
Q8R5A3	PF00169	314	419	2.562056603773586	105	G5AUW1	312	417	2.554971698113208	105
Q8R5A3	PF00788	185	264	0.08002500000000001	79	G5AUW1	183	262	0.081375	79
Q7TSK7	PF00090	50	104	0.005727272727272728	54	G5B8I0	177	263	2.8374942528735634	86
Q7TSK7	PF05986	214	329	2.7386120689655167	115	G5B8I0	373	488	2.7479482758620675	115
Q7TSK7	PF08686	921	952	0.06765625	31	G5B8I0	1109	1140	0.0671875	31
Q7TSK7	PF19030	631	690	0.0	59	G5B8I0	785	844	0.0	59
Q7TSK7	PF19030	746	799	0.0	53	G5B8I0	900	987	4.646840909090908	87
Q7TSK7	PF19030	803	859	0.8441228070175437	56	G5B8I0	991	1047	0.8547368421052631	56
Q7TSK7	PF19030	862	912	0.0	50	G5B8I0	1050	1100	0.0	50
Q9DBE9	PF01728	23	199	6.967700564971751	176	G5BDJ0	24	200	6.998531073446327	176
Q9DBE9	PF07780	620	825	2.072165048543689	205	G5BDJ0	616	819	2.0815196078431373	203
Q9DBE9	PF11861	231	397	0.0	166	G5BDJ0	232	395	0.0	163
Q3UHD2	PF01408	79	112	0.0	33	G5BN49	3	36	0.010088235294117646	33
Q3UHD2	PF02894	131	358	3.5302149122807016	227	G5BN49	55	282	3.8433114035087717	227
P22361	PF04814	7	167	3.1744161490683234	160	G5AWX7	8	168	3.1572422360248433	160
P22361	PF04812	281	537	2.0351984435797674	256	G5AWX7	282	540	1.4388841698841686	258
P22361	PF04813	539	626	0.962306818181818	87	G5AWX7	542	630	0.9529550561797752	88
Q9JKL4	PF04430	60	168	6.120779816513761	108	G5BZV0	60	168	6.101155963302755	108
Q8C5Q4	PF00076	251	317	1.6963731343283577	66	G5BN02	195	291	8.771432989690718	96
Q62234	PF00041	491	575	11.805847058823536	84	G5CAX9	449	533	11.876705882352944	84
Q62234	PF00041	619	703	8.171600000000002	84	G5CAX9	577	661	8.127117647058826	84
Q62234	PF00041	720	802	3.889493975903616	82	G5CAX9	678	760	3.4905662650602407	82
Q62234	PF00041	916	1004	0.9380674157303374	88	G5CAX9	833	921	3.5067752808988764	88
Q62234	PF00041	1022	1108	1.3452413793103446	86	G5CAX9	939	1025	4.508172413793104	86
Q62234	PF07679	257	349	3.233591397849463	92	G5CAX9	245	306	4.8512903225806445	61
Q62234	PF07679	395	465	0.3953098591549296	70	G5CAX9	353	423	6.114028169014086	70
Q62234	PF07679	1124	1198	2.8113466666666667	74	G5CAX9	1041	1115	1.2921733333333334	74
Q62234	PF07679	1352	1424	2.7868904109589034	72	G5CAX9	1269	1341	5.3585068493150665	72
Q62234	PF07679	1560	1644	5.845188235294117	84	G5CAX9	1477	1561	4.6768470588235305	84
Q8CEZ4	PF03281	145	354	9.14793333333333	209	G5C3R0	131	339	9.508531100478466	208
Q8C119	PF10179	290	381	8.187163043478265	91	G5BZK0	291	382	7.785565217391302	91
Q9DBH0	PF00397	301	330	0.0	29	G5AK37	302	331	0.0	29
Q9DBH0	PF00397	331	360	0.0	29	G5AK37	332	361	0.0	29
Q9DBH0	PF00397	406	434	0.3787931034482758	28	G5AK37	407	435	0.3787931034482758	28
Q9DBH0	PF00397	445	474	0.0	29	G5AK37	446	475	0.0	29
Q9DBH0	PF00632	565	867	6.379181518151817	302	G5AK37	566	868	5.747792079207923	302
Q61142	PF02513	53	101	0.5791632653061225	48	G5C375	54	102	0.5791632653061225	48
Q61142	PF02513	132	181	17.997840000000004	49	G5C375	133	182	17.997840000000004	49
Q61142	PF02513	213	258	3.821804347826088	45	G5C375	214	259	4.14504347826087	45
Q6P9S0	PF08397	22	235	7.707565420560748	213	G5C1Q2	7	220	7.706528037383179	213
Q9R0T8	PF00069	28	225	7.3330909090909095	197	G5BP26	1	198	7.094843434343432	197
Q9R0T8	PF18394	401	647	1.370999999999999	246	G5BP26	374	624	5.177318725099605	250
Q9R0T8	PF18396	307	394	5.715386363636362	87	G5BP26	280	367	13.032215909090905	87
Q8K0Y2	PF00038	54	365	0.6718429487179489	311	G5B0N6	55	366	0.08812179487179488	311
Q6IQX7	PF05679	261	760	2.183584	499	G5AKI9	180	678	1.8041943887775556	498
P28740	PF00225	227	550	3.935169753086425	323	G5AVR0	109	380	1.5478823529411772	271
Q9WUA6	PF00069	149	404	1.7892656250000007	255	G5AM38	135	390	1.7862812499999996	255
Q9WUA6	PF00169	15	104	2.353299999999999	89	G5AM38	1	90	2.3559777777777784	89
Q9WUA6	PF00433	425	472	0.04110416666666667	47	G5AM38	411	458	0.041	47
Q8C8V1	PF00096	208	232	0.47044	24	G5B0V4	217	241	0.4674800000000001	24
Q8C8V1	PF00096	238	262	0.59348	24	G5B0V4	247	271	0.5930799999999999	24
Q8C8V1	PF00096	268	290	0.0	22	G5B0V4	277	299	0.0	22
Q8C8V1	PF00096	388	412	0.0	24	G5B0V4	397	421	0.0392	24
G5E8P0	PF04130	1462	1765	4.057335526315791	303	G5B2I2	1394	1697	4.004973684210523	303
G5E8P0	PF17681	352	622	11.567018450184506	270	G5B2I2	353	624	8.842801470588238	271
Q148V8	PF07894	15	282	6.151305970149252	267	G5AWE7	16	283	6.1491417910447765	267
Q8BHA0	PF08265	140	148	0.10011111111111112	8	G5C763	142	149	0.0725	7
O08573	PF00337	15	143	5.150968992248067	128	G5BVM8	16	145	3.244038461538462	129
O08573	PF00337	223	351	4.5419534883720925	128	G5BVM8	208	335	4.378992187499999	127
Q8CGE9	PF00595	22	93	0.6873611111111108	71	G5BZF4	5	76	0.513125	71
Q8CGE9	PF00615	714	829	0.7863965517241378	115	G5BZF4	877	992	0.6658448275862068	115
Q8CGE9	PF02188	1187	1208	0.0	21	G5BZF4	1297	1318	0.0	21
Q8CGE9	PF02196	1009	1029	0.0980952380952381	20	G5BZF4	1107	1127	0.031904761904761915	20
Q8CGE9	PF02196	1034	1101	0.3869558823529412	67	G5BZF4	1132	1199	0.0	67
Q8CGE9	PF16611	1111	1179	0.0	68	G5BZF4	1221	1289	0.03144927536231884	68
Q8CGE9	PF16612	1237	1380	0.013340277777777777	143	G5BZF4	1347	1465	0.010720338983050848	118
Q8CGE9	PF16613	835	946	0.0423125	111	G5BZF4	998	1108	0.043504504504504514	110
P46061	PF07834	413	586	7.963126436781612	173	G5BVC9	409	582	5.261810344827588	173
P46061	PF13516	113	129	0.0	16	G5BVC9	114	130	0.0	16
P46061	PF13516	292	304	0.053076923076923084	12	G5BVC9	293	305	0.053076923076923084	12
P46061	PF13516	322	340	0.0	18	G5BVC9	323	341	0.0	18
A2AKX3	PF13086	1909	2192	2.1702007042253504	283	G5AT46	1929	2212	2.5578661971830976	283
A2AKX3	PF13087	2200	2399	6.6025350000000005	199	G5AT46	2220	2419	7.015414999999997	199
A2AHC3	PF08683	1443	1560	4.216584745762713	117	G5B6C2	1565	1672	4.6055	107
A2AHC3	PF11971	268	309	6.0509523809523795	41	G5B6C2	372	413	6.023928571428572	41
A2AHC3	PF17095	861	916	0.06089285714285714	55	G5B6C2	971	1026	0.047803571428571424	55
Q9QXQ1	PF00233	171	381	4.027620853080569	210	G5C1A5	224	433	1.1386190476190474	209
Q7TPD6	PF00076	71	121	8.285529411764704	50	G5BSN5	1	51	8.477254901960784	50
Q7TPD6	PF00076	132	197	5.047439393939394	65	G5BSN5	62	127	4.9757424242424255	65
Q7TPD6	PF00076	223	289	0.7300895522388058	66	G5BSN5	153	218	0.11987878787878788	65
Q8C796	PF00249	329	373	2.861399999999999	44	G5B6G1	313	357	2.902755555555556	44
Q8C796	PF01448	45	96	1.182019230769231	51	G5B6G1	29	80	1.1985576923076924	51
O70362	PF00882	50	206	5.089936305732488	156	G5BJY2	29	149	7.570239669421487	120
O70362	PF01839	378	414	7.587621621621622	36	G5BJY2	320	356	8.904324324324325	36
O70362	PF01839	444	482	11.757794871794871	38	G5BJY2	388	426	17.073948717948717	38
O70362	PF01839	508	541	5.082323529411765	33	G5BJY2	452	485	4.456735294117646	33
P10166	PF00010	285	336	7.026846153846152	51	G5C409	282	333	7.408749999999999	51
P10166	PF01056	0	124	0.017896000000000002	124	G5C409	1	125	0.017352000000000003	124
P10166	PF01056	129	218	0.3818888888888888	89	G5C409	130	219	0.4025555555555556	89
Q9JIY0	PF00169	22	129	5.39771296296296	107	G5BH29	15	122	5.364055555555557	107
Q9QZR5	PF00069	198	526	0.8373313069908813	328	G5B560	159	487	0.8504255319148933	328
O54998	PF00254	43	136	4.292946808510639	93	G5B0U3	106	199	5.450744680851064	93
O54998	PF13499	148	209	0.0	61	G5B0U3	211	272	0.0	61
Q8BI66	PF00096	139	162	0.0	23	G5AZR1	142	165	0.014541666666666666	23
Q8BI66	PF00096	338	360	0.0	22	G5AZR1	330	352	0.0	22
Q8BI66	PF00096	476	498	0.0	22	G5AZR1	470	492	0.0	22
Q8BI66	PF00096	504	526	0.06760869565217391	22	G5AZR1	498	520	0.06804347826086958	22
Q8BI66	PF00096	532	554	0.0	22	G5AZR1	526	548	0.0	22
Q8BI66	PF13894	447	469	0.0	22	G5AZR1	441	463	0.0	22
Q8VD72	PF13176	294	303	9.233700000000002	9	G5BRE0	298	306	10.319666666666668	8
Q63810	PF13499	21	77	0.1043157894736842	56	G5BA16	7	63	0.10866666666666666	56
Q63810	PF13499	88	155	2.3776029411764696	67	G5BA16	74	141	2.0266417910447747	67
P28656	PF00956	75	344	4.5092740740740735	269	G5AXD0	71	340	4.507229629629629	269
Q9WUD6	PF00110	39	331	0.3212764505119455	292	G5CAE0	20	312	0.31906825938566546	292
Q6P2B1	PF08389	101	247	16.769965986394563	146	G5BH91	102	248	16.776816326530618	146
A7DTG3	PF06031	107	141	4.022228571428571	34	G5BAM8	108	142	3.4159428571428565	34
P70399	PF09038	1479	1600	3.7295819672131145	121	G5BM49	1429	1550	3.7305737704918034	121
P70399	PF18428	1863	1965	11.249747572815533	102	G5BM49	1813	1915	11.250902912621358	102
Q99PW4	PF06293	62	215	4.295227272727272	153	G5B7R3	65	218	4.890837662337663	153
Q61999	PF00011	114	175	0.3064193548387097	61	G5C0H0	129	190	0.05025806451612905	61
Q5NCX5	PF07177	59	206	4.090351351351351	147	G5B5B3	27	174	4.085277027027027	147
Q5NCX5	PF07177	321	483	10.953171779141105	162	G5B5B3	267	429	10.95405521472393	162
Q5NCX5	PF07177	524	686	2.2915460122699387	162	G5B5B3	470	632	2.2922392638036806	162
Q5NCX5	PF07177	720	883	3.70245731707317	163	G5B5B3	666	827	2.56417901234568	161
Q5NCX5	PF07177	917	1084	3.110369047619048	167	G5B5B3	861	1028	2.8849285714285715	167
Q5NCX5	PF07177	1134	1292	6.1384402515723275	158	G5B5B3	1078	1235	6.395177215189872	157
A6PWV5	PF01388	112	189	7.166128205128207	77	G5B062	115	191	7.285909090909095	76
P09240	PF00918	42	114	0.042273972602739726	72	G5ALX5	1	73	0.22399999999999998	72
Q7TS75	PF09422	94	473	0.13663421052631572	379	G5C4Z6	95	446	0.13338636363636364	351
Q7TS75	PF09422	474	554	0.019444444444444445	80	G5C4Z6	447	527	0.2670370370370371	80
Q925E0	PF00595	73	152	0.35925	79	G5C0Y1	73	152	1.2807375000000003	79
P30275	PF00217	186	399	3.6971355140186937	213	G5BM52	186	354	3.920479289940828	168
P30275	PF02807	58	127	0.2774857142857143	69	G5BM52	58	127	0.2788428571428571	69
Q63836	PF05694	6	471	1.9313261802575112	465	G5AK02	18	494	2.295415966386554	476
O08901	PF00069	763	849	3.0187356321839083	86	G5APS4	857	942	0.3177093023255814	85
O08901	PF08311	8	125	3.7441271186440663	117	G5APS4	156	273	4.663152542372882	117
Q5SUD9	PF00118	372	553	17.45445604395605	181	G5C795	372	554	12.991475409836063	182
O55070	PF03372	29	278	7.612560000000002	249	G5BMH2	25	274	6.464516000000002	249
Q7TQE7	PF08014	287	506	3.6861454545454593	219	G5BAY1	293	512	4.0981590909090935	219
P35550	PF01269	93	319	8.9732422907489	226	G5APZ4	86	312	8.994132158590311	226
Q9QZB9	PF00132	101	127	0.06981481481481483	26	G5BV69	102	128	0.06981481481481483	26
P19123	PF13499	93	157	0.0	64	G5BUM2	101	165	0.0	64
P19123	PF13833	31	83	9.931849056603774	52	G5BUM2	39	91	9.927207547169813	52
Q99JF8	PF00855	4	85	4.350756097560975	81	G5B729	5	86	4.372012195121951	81
Q8BHB7	PF15032	0	408	0.7652811735941321	408	G5B1X6	1	368	0.5386185286103542	367
Q9WTI7	PF00063	48	717	5.093495522388063	669	G5BCW0	49	718	5.8401791044776115	669
Q9WTI7	PF00612	736	753	0.0	17	G5BCW0	737	754	0.0	17
Q9WTI7	PF00612	758	775	1.435	17	G5BCW0	759	776	1.4341111111111111	17
Q9WTI7	PF06017	873	1039	3.360497005988027	166	G5BCW0	874	1040	3.3754011976047904	166
Q9CQU0	PF13899	55	117	6.319634920634923	62	G5AUH8	1	63	1.4529523809523808	62
Q91VU7	PF01142	250	640	2.04879283887468	390	G5BI37	247	637	2.2153836317135567	390
O08848	PF05731	17	328	7.2864038461538465	311	G5ASG4	18	329	6.171179487179482	311
Q80VP9	PF05118	165	324	3.46519375	159	G5BGM2	192	351	7.627218749999999	159
Q80TK0	PF15363	1194	1238	0.0	44	G5AZX4	1357	1401	0.015272727272727271	44
P30051	PF01285	31	96	0.016303030303030302	65	G5C7T3	17	82	0.020303030303030302	65
P30051	PF17725	214	422	9.198253588516746	208	G5C7T3	200	408	9.279267942583731	208
P61372	PF00412	16	73	0.18010344827586208	57	G5C265	17	74	0.11829310344827587	57
P61372	PF00412	78	132	0.0	54	G5C265	79	133	0.0	54
P61372	PF00046	182	237	0.0	55	G5C265	183	238	0.0	55
Q9CZ00	PF04440	16	151	0.17497794117647056	135	G5APG9	148	281	0.1850671641791045	133
Q8K5A4	PF00071	6	176	3.692087719298249	170	G5APX1	7	142	3.738786764705882	135
Q8C0P7	PF18479	879	996	3.6920762711864388	117	G5AKH3	876	993	3.658186440677965	117
Q6P5D3	PF00270	552	704	10.345882352941182	152	G5CA68	551	703	9.694843137254905	152
Q6P5D3	PF00271	832	969	7.437123188405796	137	G5CA68	830	967	7.403449275362322	137
Q6P5D3	PF00642	302	322	0.0	20	G5CA68	302	322	0.0	20
Q6P5D3	PF04408	1040	1139	8.08112	99	G5CA68	1038	1136	6.435626262626263	98
Q6P5D3	PF05773	245	301	2.7398070175438587	56	G5CA68	246	300	2.8297636363636363	54
Q6P5D3	PF07717	1214	1311	4.417163265306123	97	G5CA68	1212	1309	1.9223367346938776	97
Q8VHQ4	PF00071	15	173	6.6603333333333365	158	G5BXW6	16	174	6.199534591194968	158
Q8VHQ4	PF07525	188	222	0.11714285714285713	34	G5BXW6	189	223	0.09762857142857144	34
Q8BP71	PF00076	182	248	6.436149253731344	66	G5BY13	122	188	6.427149253731344	66
Q8BP71	PF12414	323	420	0.07100000000000004	97	G5BY13	259	356	0.07081632653061225	97
P39429	PF00097	33	71	2.3656153846153845	38	G5BEI4	34	72	0.11151282051282052	38
P39429	PF02176	177	234	0.0	57	G5BEI4	246	303	0.0	57
P39429	PF16673	266	329	7.030328124999999	63	G5BEI4	335	398	6.973265624999998	63
O88396	PF01025	57	216	0.4863	159	G5C3A6	34	193	0.4390687500000003	159
Q99KX1	PF10248	25	197	0.17064739884393065	172	G5CAQ6	26	198	0.17064739884393065	172
Q9QWV4	PF10248	25	200	0.01823863636363636	175	G5BVR2	1	191	0.026937172774869112	190
Q99PV5	PF00010	46	98	1.5145094339622638	52	G5BQA4	47	99	1.6148113207547172	52
Q99PV5	PF07527	130	169	1.0875	39	G5BQA4	131	170	1.1094500000000005	39
P97821	PF00112	229	455	2.847101321585903	226	G5C2H0	230	456	2.213511013215858	226
P97821	PF08773	24	140	13.7332735042735	116	G5C2H0	25	141	15.789940170940163	116
Q9D051	PF02779	31	205	2.148817142857144	174	G5BUK7	32	206	2.142748571428572	174
Q9D051	PF02780	225	348	2.297975806451613	123	G5BUK7	226	349	1.8597258064516131	123
Q80UV9	PF00439	1422	1490	0.026956521739130438	68	G5BCY6	1128	1196	0.026608695652173917	68
Q80UV9	PF00439	1533	1614	0.5985853658536586	81	G5BCY6	1239	1320	0.5746585365853659	81
Q80UV9	PF09247	24	85	4.892306451612907	61	G5BCY6	5	66	5.221370967741937	61
Q80UV9	PF12157	668	1047	2.50377894736842	379	G5BCY6	443	862	3.4513428571428566	419
Q80UV9	PF15288	1281	1317	0.01864864864864865	36	G5BCY6	1017	1052	1.066611111111111	35
Q9JID9	PF00017	408	485	3.723807692307693	77	G5AXB0	401	480	5.725537499999998	79
Q9JID9	PF00169	204	297	0.34384042553191496	93	G5AXB0	198	291	0.24136170212765956	93
Q9JID9	PF08916	16	72	11.702789473684213	56	G5AXB0	6	62	0.4462456140350877	56
Q7TQK4	PF15985	195	242	0.9286458333333332	47	G5C1D5	196	243	0.9635833333333332	47
Q3UGS4	PF14799	5	90	0.08746511627906976	85	G5BJ75	1	86	0.08801162790697675	85
Q9D7Z6	PF08434	24	289	1.7680902255639095	265	G5CB31	25	294	1.5018037037037029	269
Q9D7Z6	PF13519	308	414	9.810607476635512	106	G5CB31	313	419	9.69129906542056	106
P97311	PF00493	362	512	5.835688741721853	150	G5AQB0	17	166	6.981053333333332	149
P97311	PF18263	723	807	3.705082352941174	84	G5AQB0	157	240	2.567083333333334	83
P62311	PF01423	20	95	1.9587894736842104	75	G5ANS5	15	90	1.9677368421052632	75
P20443	PF00339	22	179	3.3983037974683548	157	G5BXG3	23	180	4.465227848101263	157
P20443	PF02752	200	346	7.4232108843537405	146	G5BXG3	201	346	9.67644520547945	145
Q9D305	PF05485	4	79	0.0	75	G5BSY2	5	80	0.0	75
A2AR02	PF00160	11	174	2.8063292682926835	163	G5C8Q3	12	175	2.8043109756097566	163
Q99JY4	PF01963	66	306	8.571282157676345	240	G5B2I4	67	307	8.53675518672199	240
Q3TIR3	PF10165	66	498	7.313688221709003	432	G5AUC1	67	499	8.496965357967662	432
Q99L90	PF00498	362	434	3.1085342465753425	72	G5AU17	417	489	3.965	72
Q99L90	PF13325	133	330	5.684601010101009	197	G5AU17	153	350	5.232813131313131	197
Q80WG7	PF00041	430	496	0.10074626865671643	66	G5C1J1	488	552	0.972123076923077	64
Q80WG7	PF18568	358	399	2.0399047619047623	41	G5C1J1	416	456	0.7028536585365853	40
Q8BMS1	PF00378	46	221	1.2968238636363627	175	G5CBK7	47	222	1.2559488636363634	175
Q8BMS1	PF00725	543	638	1.5064270833333333	95	G5CBK7	544	639	1.6299062500000003	95
Q8BMS1	PF00725	675	752	1.8443974358974369	77	G5CBK7	676	753	1.927320512820512	77
Q8BMS1	PF02737	363	540	3.4668033707865167	177	G5CBK7	364	541	3.2182528089887636	177
Q91VN1	PF00096	250	272	0.6388695652173912	22	G5C294	251	273	0.6403913043478261	22
Q91VN1	PF00096	280	300	0.11304761904761905	20	G5C294	281	301	0.11333333333333336	20
Q91VN1	PF00096	306	328	0.0	22	G5C294	307	329	0.0	22
Q91VN1	PF00096	334	356	0.0	22	G5C294	335	357	0.0	22
Q91VN1	PF02023	47	135	1.0686966292134834	88	G5C294	48	136	1.0505617977528092	88
Q99LC9	PF00004	466	593	8.123843749999999	127	G5BNK8	466	607	6.2015563380281735	141
Q99LC9	PF00004	740	870	8.936007633587785	130	G5BNK8	754	884	9.441885496183204	130
Q497I4	PF00038	95	405	0.6880064308681674	310	G5B0N2	93	397	0.6926393442622951	304
Q9JK83	PF00595	157	235	1.2352278481012662	78	G5AZ00	161	239	1.2330379746835447	78
Q9JK83	PF00564	17	94	0.5368589743589743	77	G5AZ00	21	98	0.5357564102564104	77
Q9DD18	PF02580	1	145	4.171986206896552	144	G5CBB5	2	146	4.104434482758618	144
A2ARM1	PF09770	263	401	6.6671654676259005	138	G5BWT3	236	374	10.849467625899283	138
Q61644	PF00611	21	95	0.0	74	G5BCG0	25	99	0.15205333333333335	74
Q61644	PF14604	405	438	0.0	33	G5BCG0	389	422	0.0	33
Q9CZJ6	PF03226	75	155	1.5517407407407409	80	G5BEA1	5	90	2.1030465116279067	85
Q9CQ26	PF01398	253	360	2.265083333333333	107	G5AXH1	254	361	3.35924074074074	107
Q9CQ26	PF08969	11	115	8.354419047619048	104	G5AXH1	12	116	8.348333333333333	104
P68040	PF00400	7	43	3.4490270270270265	36	G5B7J7	8	44	3.4445945945945944	36
P68040	PF00400	54	90	0.038783783783783776	36	G5B7J7	55	91	0.038783783783783776	36
P68040	PF00400	96	132	10.771648648648648	36	G5B7J7	103	139	10.766000000000002	36
P68040	PF00400	145	177	6.37448484848485	32	G5B7J7	152	184	6.375212121212125	32
P68040	PF00400	187	219	0.8099090909090909	32	G5B7J7	194	226	0.8085757575757576	32
P68040	PF00400	224	259	1.9649444444444448	35	G5B7J7	231	266	1.9619722222222225	35
P68040	PF00400	285	309	1.2335200000000002	24	G5B7J7	292	316	1.5533200000000005	24
O08915	PF00254	28	90	0.5680158730158732	62	G5BSA1	29	91	0.9228412698412698	62
Q8BMA3	PF00536	5	66	0.0	61	G5BQ79	6	67	0.026338709677419355	61
Q8BMA3	PF00595	212	282	0.5369718309859156	70	G5BQ79	213	283	0.7380563380281691	70
Q8BMA3	PF06663	332	544	1.1362441314553993	212	G5BQ79	333	538	1.5086310679611652	205
Q8BMA3	PF10534	80	170	9.967725274725273	90	G5BQ79	81	170	9.844399999999997	89
Q9R1P3	PF00227	4	182	9.306837988826812	178	G5C6E5	5	183	9.250128491620114	178
Q61846	PF00069	10	262	8.41082608695652	252	G5AS57	11	263	8.971897233201584	252
Q61846	PF02149	599	641	0.06958139534883721	42	G5AS57	607	649	0.0521860465116279	42
Q9D2F5	PF07004	193	214	0.07500000000000001	21	G5BHX2	134	155	0.08872727272727272	21
Q9D2F5	PF07004	231	244	0.0	13	G5BHX2	171	184	0.0	13
Q9D2F5	PF07004	274	290	0.04847058823529412	16	G5BHX2	236	251	0.007875	15
Q9D2F5	PF07004	312	322	0.0	10	G5BHX2	274	283	0.0	9
P58252	PF00009	17	358	4.4055233918128645	341	G5BZB8	18	359	4.397309941520462	341
P58252	PF00679	738	825	3.9169090909090927	87	G5BZB8	739	826	3.9169090909090927	87
P58252	PF03144	410	484	5.0575066666666695	74	G5BZB8	411	485	4.687693333333336	74
P58252	PF03764	621	736	1.553008620689655	115	G5BZB8	622	737	1.553008620689655	115
P58252	PF14492	502	563	0.10554838709677418	61	G5BZB8	503	564	0.10554838709677418	61
Q8BRB7	PF00538	107	167	0.0	60	G5C7I6	107	167	0.0	60
Q8BRB7	PF00628	272	319	0.2770208333333333	47	G5C7I6	274	321	0.2777083333333334	47
Q8BRB7	PF01853	593	769	12.18101129943503	176	G5C7I6	777	1003	11.553982378854627	226
Q8BRB7	PF17772	536	588	0.0269811320754717	52	G5C7I6	720	772	0.027075471698113203	52
O35310	PF00685	58	297	2.7070166666666697	239	G5BWV3	56	295	2.3038541666666665	239
Q8BUL6	PF00169	9	111	4.579543689320389	102	G5AKF9	10	112	4.589097087378641	102
Q8BUL6	PF00169	191	286	1.21740625	95	G5AKF9	192	287	1.2499166666666668	95
Q8VCT9	PF07714	61	307	3.2971417004048584	246	G5ARW4	62	308	3.2946396761133614	246
Q33DR3	PF00348	110	310	3.638651741293531	200	G5BMP2	16	215	3.9074649999999984	199
Q9CQM5	PF06110	8	121	6.4227456140350885	113	G5B908	9	122	7.375877192982456	113
P61458	PF01329	6	97	1.8463804347826087	91	G5B1A4	19	110	1.8382717391304342	91
Q91YQ1	PF00071	8	173	4.746283132530121	165	G5BX48	9	174	4.576222891566268	165
Q99KD5	PF11701	316	504	4.557661375661372	188	G5CAB3	458	646	4.065587301587299	188
Q99KD5	PF13181	92	124	0.0	32	G5CAB3	234	266	0.0	32
Q99KD5	PF13432	26	86	0.07298360655737705	60	G5CAB3	168	228	0.07213114754098361	60
P54265	PF00069	70	338	5.7281263940520475	268	G5AUX9	71	339	5.8674386617100405	268
P54265	PF08826	471	530	0.0	59	G5AUX9	473	531	0.0	58
Q64444	PF00194	21	276	6.653031249999999	255	G5AX21	23	279	5.683042801556421	256
Q6DFV5	PF00642	180	204	0.0	24	G5BVE1	181	205	0.0	24
Q6DFV5	PF13086	641	757	3.4261111111111093	116	G5BVE1	642	758	3.4397094017094014	116
Q6DFV5	PF13086	760	832	8.85863013698631	72	G5BVE1	761	833	8.538657534246582	72
Q6DFV5	PF13087	840	1050	3.776682464454977	210	G5BVE1	841	1051	3.7987582938388624	210
Q9QZE5	PF01602	24	537	9.28903307392996	513	G5B3S5	25	538	9.277531128404668	513
Q9QZE5	PF08752	611	758	1.28972972972973	147	G5B3S5	612	758	1.0264285714285717	146
Q9QZE5	PF16381	760	872	5.000690265486725	112	G5B3S5	761	873	3.8989469026548655	112
Q921C5	PF09730	82	796	1.1179258741258735	714	G5BQK3	21	744	1.1233908839778999	723
A2A5I3	PF00188	66	206	3.672475177304965	140	G5BB40	67	207	5.337063829787233	140
A0A087WPF7	PF15336	643	855	0.5795258215962441	212	G5BIS8	604	816	0.5720328638497654	212
Q9CXH7	PF07557	464	485	0.0	21	G5B3I5	477	498	0.0	21
Q9CXH7	PF07558	21	65	8.315244444444447	44	G5B3I5	22	66	9.075644444444446	44
Q8CHH5	PF15249	707	807	0.2242772277227723	100	G5BNK2	712	812	0.0675049504950495	100
Q8CG14	PF00084	298	349	0.5809423076923077	51	G5CAS5	305	355	8.217549019607842	50
Q8CG14	PF00084	358	411	5.6150370370370375	53	G5CAS5	366	419	1.2256481481481485	53
Q8CG14	PF00089	437	674	5.235415966386554	237	G5CAS5	445	682	4.389294117647061	237
Q8CG14	PF00431	18	126	5.779779816513763	108	G5CAS5	25	133	6.150495412844037	108
Q8CG14	PF00431	174	286	8.69294690265487	112	G5CAS5	181	293	5.886884955752209	112
Q8CG14	PF14670	141	170	1.1061333333333332	29	G5CAS5	148	177	1.108866666666667	29
P23591	PF01370	9	244	6.420169491525428	235	G5AWF1	10	245	7.817110169491526	235
P15327	PF00300	5	129	7.1436480000000016	124	G5BS20	6	130	7.1459280000000005	124
P15327	PF00300	149	221	0.2235890410958904	72	G5BS20	150	222	0.3839726027397259	72
Q8VE42	PF12796	76	168	4.020193548387096	92	G5BCY5	79	171	3.2330430107526884	92
Q922Q2	PF01163	191	378	7.215760638297873	187	G5BAT3	194	381	8.83061170212766	187
O70133	PF00035	6	68	8.404396825396825	62	G5BE44	92	152	5.577540983606557	60
O70133	PF00035	182	251	2.9581714285714296	69	G5BE44	267	336	2.946742857142858	69
O70133	PF00270	395	548	14.390681818181822	153	G5BE44	480	633	13.653045454545458	153
O70133	PF00271	638	769	8.757962121212119	131	G5BE44	723	854	8.346053030303027	131
O70133	PF04408	833	899	12.932985074626865	66	G5BE44	918	984	13.229223880597011	66
O70133	PF07717	995	1073	15.033126582278475	78	G5BE44	1080	1158	13.812784810126585	78
Q8BSF5	PF00651	23	129	4.9233738317757005	106	G5AY90	24	130	5.400140186915888	106
Q8BSF5	PF01344	324	368	18.805200000000006	44	G5AY90	325	369	13.10266666666667	44
Q8BSF5	PF01344	371	417	5.294680851063831	46	G5AY90	372	418	10.698914893617019	46
Q8BSF5	PF01344	509	555	0.017872340425531916	46	G5AY90	510	556	0.01776595744680851	46
Q8BSF5	PF07707	135	235	3.8829504950495046	100	G5AY90	136	236	2.665168316831682	100
P42581	PF00046	227	283	0.03807017543859649	56	G5AKG8	255	311	0.038596491228070184	56
Q58NB6	PF00106	29	220	6.826520833333336	191	G5C8Q8	30	221	10.05608333333333	191
Q9D7K2	PF15490	2	117	7.432956896551721	115	G5AQW2	3	118	4.904750000000001	115
Q9Z0J7	PF00019	205	301	0.027536082474226804	96	G5B4C9	184	280	4.700350515463916	96
Q6P9R1	PF00270	194	412	5.428214611872148	218	G5AWT2	96	314	2.2037351598173527	218
Q6P9R1	PF00271	463	572	6.2015636363636375	109	G5AWT2	367	476	7.798672727272729	109
Q9CZJ1	PF03998	12	252	1.5804854771784231	240	G5C6I2	13	253	0.7706125	240
P62983	PF00240	2	73	0.11613888888888887	71	G5B8W4	3	74	0.11613888888888887	71
P62983	PF01599	101	146	0.20993478260869566	45	G5B8W4	102	147	0.6161086956521739	45
Q8K4B0	PF00249	286	330	10.644711111111109	44	G5AWK0	284	328	10.894111111111114	44
Q8K4B0	PF00320	392	428	0.7047297297297299	36	G5AWK0	390	426	0.705027027027027	36
Q8K4B0	PF01426	4	163	6.214525	159	G5AWK0	1	161	7.368577639751552	160
Q8K4B0	PF01448	166	218	8.940603773584906	52	G5AWK0	164	216	8.940792452830188	52
Q8K4B0	PF17226	463	540	0.07780769230769231	77	G5AWK0	461	538	0.0779102564102564	77
Q8K4B0	PF17226	657	689	0.4508181818181818	32	G5AWK0	655	687	0.3443939393939394	32
Q9JLT2	PF01204	42	547	1.4551541501976288	505	G5BHM4	46	463	1.0632775119617228	417
Q9D0R8	PF09793	85	164	0.29025	79	G5BN75	41	120	0.2941625	79
Q9WTU0	PF00628	33	54	0.0	21	G5BIP3	42	63	0.012363636363636365	21
Q9WTU0	PF02373	235	335	9.202910891089108	100	G5BIP3	282	382	9.01979207920792	100
Q9WTU0	PF17811	339	442	0.356375	103	G5BIP3	386	489	0.3551153846153846	103
P59470	PF00562	667	1040	1.581631016042781	373	G5C459	668	1041	1.560639037433155	373
P59470	PF04560	1042	1126	1.8299647058823536	84	G5C459	1043	1127	1.8299882352941184	84
P59470	PF04561	185	362	5.446370786516856	177	G5C459	186	363	6.7175786516853915	177
P59470	PF04563	37	184	3.465222972972973	147	G5C459	38	185	3.4653310810810805	147
P59470	PF04565	437	501	0.3147076923076921	64	G5C459	438	502	0.3261692307692306	64
P59470	PF04566	538	599	7.7434032258064525	61	G5C459	539	600	6.106048387096775	61
P59470	PF04567	620	654	0.0	34	G5C459	621	655	0.0	34
Q9D291	PF05903	16	147	1.0142348484848491	131	G5AM33	1	132	1.0210909090909095	131
Q80WE4	PF00225	225	476	3.9973214285714285	251	G5B0Z5	132	385	4.896700787401572	253
Q03267	PF00096	143	165	0.0	22	G5B3U0	133	155	0.0	22
Q03267	PF00096	171	193	0.0	22	G5B3U0	161	183	0.0	22
Q03267	PF00096	199	222	0.0	23	G5B3U0	189	212	0.0	23
Q9R0A5	PF00069	128	249	2.385819672131149	121	G5BUY2	39	160	2.7609918032786886	121
Q9JJ28	PF00626	508	590	9.432048192771084	82	G5BMX6	619	701	9.456289156626509	82
Q9JJ28	PF00626	628	702	9.70772	74	G5BMX6	739	813	6.573986666666667	74
Q9JJ28	PF00626	760	830	11.399985915492964	70	G5BMX6	871	941	11.392549295774653	70
Q9JJ28	PF00626	1181	1255	4.6067866666666655	74	G5BMX6	1289	1363	4.603519999999997	74
Q9JJ28	PF12799	269	309	0.0	40	G5BMX6	381	421	0.0	40
Q9JJ28	PF13855	130	185	2.046821428571429	55	G5BMX6	119	174	2.0611071428571424	55
Q9JJ28	PF13855	199	257	0.007016949152542373	58	G5BMX6	311	369	0.0	58
Q8VCR8	PF00069	303	556	8.397566929133855	253	G5BR00	286	539	8.147133858267715	253
Q6ZWN5	PF00163	18	62	0.0	44	G5CBG2	19	63	0.0	44
Q6ZWN5	PF01479	107	150	0.02613636363636364	43	G5CBG2	108	151	0.031363636363636364	43
P62962	PF00235	2	139	6.289108695652175	137	G5BW97	3	140	5.657211678832117	137
Q80V94	PF01602	50	596	13.143769652650812	546	G5C8S7	52	599	11.617116788321171	547
Q6P9N1	PF09790	22	329	10.381350649350647	307	G5BHB6	23	330	10.597827922077924	307
Q61574	PF00250	16	102	9.989873563218392	86	G5BR01	192	278	10.195103448275862	86
Q8C5N5	PF04194	191	355	4.527733333333333	164	G5BXL6	191	355	5.1566363636363635	164
Q8CH02	PF01805	184	235	1.2101346153846153	51	G5AN41	189	240	0.2686538461538461	51
Q8CH02	PF01805	261	311	2.1169607843137257	50	G5AN41	266	316	2.2933137254901963	50
Q8CH02	PF01585	560	602	0.06320930232558139	42	G5AN41	565	607	0.05988372093023255	42
O08524	PF00100	31	279	0.8367951807228919	248	G5BKC9	32	280	0.4415662650602412	248
Q99LE6	PF00005	105	261	2.2390573248407644	156	G5AMT7	103	259	2.238522292993631	156
Q99LE6	PF00005	417	549	5.430308270676694	132	G5AMT7	415	547	5.430345864661655	132
Q99LE6	PF12848	300	372	0.011520547945205479	72	G5AMT7	298	370	0.0	72
Q8BG36	PF00751	118	164	8.056914893617021	46	G5BXE7	110	156	8.080808510638297	46
P43120	PF00046	142	194	0.0	52	G5B7A4	23	75	0.0	52
Q9DBJ1	PF00300	5	127	3.7033902439024393	122	G5C0C5	6	122	3.894905982905983	116
Q9DBJ1	PF00300	142	211	0.4540714285714286	69	G5C0C5	137	206	3.5282571428571425	69
Q8VC51	PF00400	264	286	0.1658695652173913	22	G5B5D7	272	294	0.16717391304347826	22
Q8VC51	PF00400	341	379	0.23497435897435895	38	G5B5D7	349	387	0.2933846153846153	38
P51150	PF00071	24	173	3.2516800000000012	149	G5BC44	1	150	3.2383866666666687	149
B2RS91	PF05327	52	580	12.624238185255205	528	G5C0V7	101	629	11.354436672967866	528
Q8VE22	PF10484	1	128	0.6983593749999999	127	G5C424	2	129	0.5300546874999997	127
Q3TEL6	PF13920	274	318	0.1773777777777778	44	G5AQV4	275	319	0.17646666666666666	44
O70433	PF00412	39	95	0.0	56	G5CB79	40	96	0.0	56
O70433	PF00412	100	156	0.0	56	G5CB79	101	157	0.13149122807017544	56
O70433	PF00412	161	215	0.7014181818181818	54	G5CB79	162	216	1.0769818181818185	54
O70433	PF00412	220	274	0.012272727272727274	54	G5CB79	221	275	0.012272727272727274	54
O54956	PF04042	286	487	4.7248861386138605	201	G5BW62	209	410	4.201965346534652	201
Q07797	PF00530	26	123	0.15060204081632658	97	G5AVF6	177	274	0.455051020408163	97
Q07797	PF07707	260	357	2.715336734693877	97	G5AVF6	411	508	5.131571428571427	97
Q9D0J8	PF03247	15	96	0.0	81	G5CAQ7	1	83	0.0	82
Q8CAL5	PF01153	132	468	1.1091097922848654	336	G5B8Y9	1	336	1.6952797619047633	335
P70265	PF00300	254	436	4.377612021857924	182	G5BP12	224	406	4.3904043715847	182
P70265	PF01591	31	251	7.844049773755655	220	G5BP12	1	221	7.287416289592757	220
L0N7N1	PF00225	398	735	4.847863905325446	337	G5B3B5	365	703	6.776946902654861	338
L0N7N1	PF00498	860	925	0.4582878787878787	65	G5B3B5	828	893	0.3834848484848485	65
L0N7N1	PF16183	788	858	5.8056760563380285	70	G5B3B5	756	826	5.541873239436621	70
P13439	PF00156	43	161	5.02916806722689	118	G5AQ72	44	162	5.027	118
P13439	PF00215	251	465	5.1590325581395335	214	G5AQ72	252	466	5.084674418604648	214
Q9D898	PF04699	8	152	0.5136275862068969	144	G5B6W2	9	153	0.5194861111111108	144
Q8BZM1	PF08568	0	561	6.168323843416372	561	G5AZX1	1	565	5.680155752212395	564
Q62420	PF03114	14	240	0.16903524229074884	226	G5BYE6	1	227	0.16834361233480186	226
Q62420	PF00018	295	339	0.8465333333333332	44	G5BYE6	282	326	0.8864888888888891	44
A6X942	PF00017	324	399	4.007657894736843	75	G5B6D4	325	400	3.9773026315789473	75
Q8CHT3	PF14837	28	250	1.1047533632287	222	G5AYH9	29	251	1.053614349775785	222
Q8CHT3	PF14838	288	997	10.23167746478874	709	G5AYH9	291	1000	9.36329718309859	709
A2AIV8	PF00619	10	61	7.0515384615384615	51	G5B6B5	11	61	6.304607843137255	50
P48432	PF00505	46	110	1.6242461538461537	64	G5AL99	1	65	0.9912923076923076	64
P48432	PF12336	111	201	0.1009010989010989	90	G5AL99	66	156	0.0	90
Q5SSG5	PF00071	6	173	7.522827380952383	167	G5B749	7	171	9.80490909090909	164
Q8BGD0	PF15134	0	109	1.3948727272727273	109	G5BBX3	1	110	0.13799999999999998	109
O55103	PF00595	18	66	0.10024489795918368	48	G5C9X9	19	67	0.1056938775510204	48
Q2MV57	PF07773	170	441	0.13543382352941186	271	G5AWT9	170	469	0.6536200000000001	299
Q3U132	PF14722	130	265	7.223544117647058	135	G5BE54	129	264	7.794617647058822	135
Q8BIX3	PF14949	145	246	2.2435098039215693	101	G5C6P2	146	247	2.248598039215685	101
Q8BG17	PF09805	20	103	0.3946666666666666	83	G5AYX8	20	103	1.634023809523809	83
P48026	PF00583	42	143	9.965735294117652	101	G5BCE7	43	144	9.963431372549016	101
Q91YP3	PF01791	51	293	6.891539094650204	242	G5BV39	43	285	6.635102880658437	242
Q9QXL1	PF00225	13	370	2.016092178770949	357	G5B3A8	93	449	2.155745098039215	356
Q9QXL1	PF00400	1300	1335	0.3203055555555556	35	G5B3A8	1392	1427	0.3447777777777778	35
Q9QXL1	PF00400	1445	1484	4.100975000000001	39	G5B3A8	1537	1576	4.111574999999998	39
Q9QXL1	PF00400	1580	1614	0.19617142857142847	34	G5B3A8	1672	1706	2.1454000000000004	34
Q9CQ13	PF15340	23	172	0.0	149	G5B508	2	145	0.039160839160839164	143
Q8BH75	PF08941	136	314	6.744715083798883	178	G5BB83	235	413	6.7408100558659205	178
Q8BH75	PF13923	17	54	0.7974736842105262	37	G5BB83	18	55	0.7946842105263158	37
Q9JIF9	PF07679	247	337	1.2880989010989008	90	G5B1V8	248	338	2.3244725274725284	90
Q9JIF9	PF07679	346	437	4.749391304347825	91	G5B1V8	347	438	4.673836956521738	91
O89090	PF00096	626	650	0.0	24	G5BIF8	679	703	0.0	24
O89090	PF00096	656	680	0.0	24	G5BIF8	709	733	0.5488	24
O89090	PF00096	686	708	0.0	22	G5BIF8	739	761	0.0	22
Q9WVA8	PF15085	57	113	0.5644912280701755	56	G5BIF2	52	108	0.10178571428571427	56
O09165	PF01216	28	388	3.0568919667590047	360	G5BWK7	17	376	2.9898833333333323	359
Q6PDM4	PF15771	18	571	0.6594440433212997	553	G5BZV9	19	595	0.1063223570190641	576
Q91XS1	PF01363	1104	1168	0.04230769230769232	64	G5BJU1	1110	1174	0.04230769230769232	64
Q91XS1	PF06602	127	517	3.963347826086956	390	G5BJU1	128	517	3.9866692307692295	389
Q91YD9	PF02205	397	422	0.0	25	G5BZQ2	286	311	0.0	25
Q91YD9	PF02205	426	445	0.0	19	G5BZQ2	315	334	0.0	19
Q91YD9	PF00568	110	132	0.5007391304347826	22	G5BZQ2	6	28	0.5012173913043477	22
Q91YD9	PF00786	198	256	1.7231186440677964	58	G5BZQ2	86	144	1.7242033898305085	58
Q09PK2	PF13975	196	287	1.977739130434784	91	G5C6V8	114	205	2.9449239130434783	91
Q8R5B6	PF00622	97	223	8.648677165354332	126	G5B0D2	98	224	8.667086614173229	126
Q8R5B6	PF07525	233	271	0.0	38	G5B0D2	234	272	0.0	38
Q8BI29	PF15385	43	605	0.6674884547069271	562	G5BP14	48	592	0.050205882352941184	544
Q9CS00	PF09732	647	771	3.4616160000000002	124	G5AKP9	556	680	3.416862903225806	124
Q9CS00	PF10312	291	478	0.8693031914893615	187	G5AKP9	201	388	0.9858031914893618	187
Q921C3	PF00400	182	213	19.7171875	31	G5AM05	103	134	19.681218750000006	31
Q921C3	PF00400	217	254	0.16276315789473686	37	G5AM05	138	175	0.1628947368421053	37
Q921C3	PF00400	261	300	4.198224999999999	39	G5AM05	182	221	4.761849999999999	39
Q921C3	PF00400	360	394	0.0	34	G5AM05	281	315	0.0	34
Q921C3	PF00400	457	496	2.165525	39	G5AM05	378	417	1.99585	39
Q921C3	PF00439	1167	1252	3.3426976744186048	85	G5AM05	1086	1171	3.2209302325581395	85
Q921C3	PF00439	1330	1401	2.942263888888889	71	G5AM05	1250	1320	1.241704225352113	70
Q9CQH8	PF01900	32	105	2.720675675675676	73	G5BUK9	35	108	2.098310810810811	73
Q8JZL1	PF08357	355	510	17.87432692307692	155	G5ATN0	315	470	17.382794871794868	155
Q8JZL1	PF16742	48	168	4.932851239669423	120	G5ATN0	8	128	4.8933140495867775	120
Q9CWM2	PF06031	32	67	1.1063333333333332	35	G5AWJ3	37	72	1.1121111111111108	35
O08800	PF00079	6	373	5.286375000000001	367	G5B5Z9	7	374	6.6275313351498655	367
Q8VCN9	PF07986	198	315	3.6104661016949153	117	G5BNK1	195	312	2.0073050847457634	117
Q9WTK5	PF16179	228	326	6.2967272727272725	98	G5CAH1	229	327	6.313999999999999	98
Q9WTK5	PF00531	775	847	0.15986301369863012	72	G5CAH1	722	794	0.011575342465753424	72
Q9WTK5	PF00554	39	219	2.250298342541436	180	G5CAH1	40	220	1.7487237569060776	180
Q9WTK5	PF12796	493	554	14.427258064516131	61	G5CAH1	431	492	11.372661290322581	61
Q9WTK5	PF12796	604	696	0.09563440860215054	92	G5CAH1	542	634	0.0963655913978495	92
P14131	PF00380	13	145	3.3047593984962407	132	G5BJD7	14	146	3.3297954545454544	132
O54786	PF02017	18	93	6.429486842105264	75	G5C528	19	94	5.464302631578947	75
O54786	PF09033	99	262	1.1812987804878048	163	G5C528	100	263	0.7274573170731706	163
Q69AB2	PF00085	18	86	2.620956521739132	68	G5C093	26	93	4.016323529411765	67
Q3ULJ0	PF01210	6	173	3.8435892857142835	167	G5BIW1	7	174	3.7257142857142833	167
Q3ULJ0	PF07479	194	340	6.466319727891157	146	G5BIW1	195	341	5.26734693877551	146
Q6NXH8	PF13679	145	409	0.3154641509433964	264	G5APZ8	156	422	1.0651198501872652	266
Q80Y44	PF00270	92	262	4.151526315789476	170	G5BXR5	93	263	4.080859649122805	170
Q80Y44	PF00271	299	408	14.23490909090909	109	G5BXR5	300	409	12.304454545454547	109
Q80Y44	PF13959	450	510	2.0813114754098367	60	G5BXR5	451	511	1.977655737704918	60
Q6PE01	PF00400	59	94	15.780416666666667	35	G5BF61	60	95	17.709388888888892	35
Q6PE01	PF00400	103	137	2.5202857142857145	34	G5BF61	104	138	2.5208571428571425	34
Q6PE01	PF00400	143	180	0.019894736842105264	37	G5BF61	144	181	0.023210526315789477	37
Q6PE01	PF00400	196	221	16.28038461538462	25	G5BF61	197	222	8.795923076923076	25
Q6PE01	PF00400	226	263	0.037578947368421066	37	G5BF61	227	264	0.0438421052631579	37
Q6PE01	PF00400	272	313	11.636833333333335	41	G5BF61	273	314	11.636261904761904	41
Q6PE01	PF00400	319	346	0.3966071428571428	27	G5BF61	320	346	0.0	26
P52912	PF00076	8	76	4.2807681159420286	68	G5C6V4	9	77	4.275159420289857	68
P52912	PF00076	107	177	4.178676056338029	70	G5C6V4	108	178	4.16181690140845	70
P52912	PF00076	215	279	0.7567076923076924	64	G5C6V4	216	280	0.7541384615384618	64
A2AG50	PF05672	431	607	0.010084745762711863	176	G5B3X4	400	570	0.010555555555555556	170
P46664	PF00709	60	452	2.939201017811706	392	G5AM35	44	436	4.167320610687022	392
Q8CBR6	PF13855	62	120	0.23735593220338985	58	G5AW83	66	124	0.6247118644067796	58
Q8CBR6	PF13855	207	265	0.057152542372881386	58	G5AW83	211	269	0.0348135593220339	58
P70279	PF04935	164	333	0.08049411764705879	169	G5B8G8	92	261	0.20317058823529416	169
Q9D7Q1	PF00704	22	360	6.64707079646018	338	G5B366	33	407	2.994666666666667	374
Q9D7Q1	PF01607	417	463	0.0	46	G5B366	464	509	3.3019999999999987	45
P27641	PF02735	252	451	3.5648249999999977	199	G5C2J9	241	440	4.862349999999998	199
P27641	PF03730	476	569	0.050382978723404255	93	G5C2J9	465	558	0.07738297872340426	93
P27641	PF03731	8	242	5.082357446808513	234	G5C2J9	8	231	6.524517857142852	223
P27641	PF08785	608	705	2.4249489795918366	97	G5C2J9	581	678	0.2584285714285714	97
Q99KP3	PF00725	191	260	1.8381428571428573	69	G5BKV7	179	248	1.6320571428571424	69
Q99KP3	PF02737	13	188	1.0916875000000008	175	G5BKV7	1	176	0.8885852272727266	175
Q9WU19	PF01070	15	360	3.588312138728325	345	G5BAS2	16	361	5.374468208092483	345
Q61026	PF08832	635	708	0.1260135135135135	73	G5BGR4	636	709	0.1260135135135135	73
Q61026	PF16279	730	815	0.014406976744186046	85	G5BGR4	731	816	0.014244186046511629	85
Q61026	PF00989	118	174	15.341280701754375	56	G5BGR4	119	175	14.814754385964903	56
Q61026	PF07469	1278	1335	0.0	57	G5BGR4	1281	1338	0.0	57
Q61026	PF08815	1070	1116	4.917680851063831	46	G5BGR4	1071	1117	4.916595744680851	46
Q61026	PF14598	267	377	1.3501981981981983	110	G5BGR4	268	378	1.3498378378378375	110
Q61026	PF16665	462	584	0.004284552845528456	122	G5BGR4	463	585	0.008552845528455285	122
Q99KE1	PF00390	88	269	4.252340659340662	181	G5BVT0	89	270	3.6821923076923064	181
Q99KE1	PF03949	279	533	10.132596078431378	254	G5BVT0	280	534	9.559674509803928	254
P39053	PF00169	519	619	9.481752475247527	100	G5ASF4	468	568	9.479861386138614	100
P39053	PF00350	53	205	6.015503267973855	152	G5ASF4	1	153	6.228934640522878	152
P39053	PF01031	215	500	1.5092972027972036	285	G5ASF4	163	449	1.4602090592334491	286
P39053	PF02212	655	743	3.2495056179775283	88	G5ASF4	604	692	3.2568089887640457	88
Q33DR2	PF00348	113	359	7.716145748987848	246	G5AUW2	70	359	7.540093103448275	289
Q6DFV1	PF12422	211	360	11.697286666666663	149	G5C8S3	212	362	5.689450331125827	150
Q60598	PF14604	494	542	2.2517346938775504	48	G5BSS7	604	652	1.4000816326530612	48
Q60598	PF02218	82	116	0.0	34	G5BSS7	194	259	3.295090909090909	65
Q60598	PF02218	119	154	0.0	35	G5BSS7	262	297	0.0	35
Q60598	PF02218	156	191	0.0	35	G5BSS7	299	334	0.0	35
Q60598	PF02218	193	227	0.0	34	G5BSS7	336	370	0.0	34
Q60598	PF02218	230	264	0.027571428571428573	34	G5BSS7	373	407	0.027428571428571427	34
Q60598	PF02218	267	302	0.0	35	G5BSS7	373	408	0.02666666666666666	35
Q60598	PF02218	304	328	0.0	24	G5BSS7	410	434	0.0	24
Q6NVD9	PF00038	109	414	0.19171568627450966	305	G5BQB4	109	414	2.29587908496732	305
Q9ESN1	PF00168	99	200	0.0	101	G5BTW4	82	183	0.0	101
Q9ESN1	PF00168	259	362	8.447846153846154	103	G5BTW4	241	345	7.3307142857142855	104
Q6PE54	PF00270	53	142	5.109355555555553	89	G5C894	34	122	5.1796516853932575	88
Q6PE54	PF00271	263	324	8.75895161290323	61	G5C894	128	188	8.850590163934429	60
Q6PE54	PF04408	497	544	1.031479166666667	47	G5C894	188	235	0.8769583333333332	47
Q6PE54	PF07717	618	697	13.849675	79	G5C894	309	388	13.868049999999993	79
Q9D187	PF01883	74	119	7.467500000000001	45	G5BDH7	12	57	7.1026739130434775	45
P97474	PF00046	111	141	0.7384516129032258	30	G5BXG9	1	45	0.5213333333333335	44
P97474	PF03826	274	291	0.0	17	G5BXG9	178	195	0.0	17
Q9DCD0	PF00393	179	468	1.1814896551724143	289	G5C530	179	468	1.585651724137931	289
Q9DCD0	PF03446	13	164	7.4527039473684225	151	G5C530	1	152	6.851184210526313	151
Q9D358	PF01451	8	153	3.661910958904109	145	G5C0X7	9	154	3.117363013698629	145
Q149C2	PF10243	81	115	4.887371428571429	34	G5BHH8	1	35	0.4657142857142858	34
Q149C2	PF17749	464	618	0.004761290322580646	154	G5BHH8	402	556	0.1349290322580645	154
Q80TG1	PF15275	815	962	0.12202702702702703	147	G5BMZ2	882	1029	0.12245270270270267	147
Q62418	PF00241	28	130	5.9563009708737855	102	G5ASR1	77	179	6.431902912621355	102
Q62418	PF14604	383	432	0.0488	49	G5ASR1	442	491	0.0488	49
Q91UZ5	PF00459	34	280	8.360574898785423	246	G5C074	1	246	5.24341869918699	245
Q63932	PF00069	71	369	3.0791204013377933	298	G5BZB5	41	338	3.1152114093959717	297
Q924T3	PF06632	0	289	4.239682758620689	289	G5AT30	1	294	3.79517747440273	293
Q811G0	PF14727	0	416	4.244261390887288	416	G5AKE4	1	417	5.542376498800962	416
Q811G0	PF14728	439	705	2.1877977528089896	266	G5AKE4	440	705	2.1979511278195467	265
Q91W97	PF00349	21	218	1.8018888888888884	197	G5B183	22	219	1.8006111111111112	197
Q91W97	PF00349	469	663	4.678794871794869	194	G5B183	470	666	4.089492385786801	196
Q91W97	PF03727	224	458	3.99512340425532	234	G5B183	225	459	5.454778723404254	234
Q91W97	PF03727	669	903	1.689417021276596	234	G5B183	672	906	3.755872340425532	234
Q9CYX7	PF07890	91	214	2.667951612903226	123	G5ATT2	90	213	2.6995322580645165	123
Q8K4K3	PF00069	74	307	7.75981623931624	233	G5AST4	75	308	7.75981623931624	233
Q8BFW4	PF00622	386	500	8.669043478260871	114	G5BN99	251	365	5.114069565217389	114
Q9CYC5	PF08202	80	345	1.9772894736842117	265	G5B831	74	338	2.1109018867924543	264
Q3UVG3	PF14647	7	311	5.418698360655737	304	G5AY91	8	267	5.2779269230769215	259
Q3UVG3	PF14648	374	819	4.4841345291479815	445	G5AY91	330	737	4.652975490196078	407
P28481	PF00093	33	87	0.0	54	G5BWD5	34	89	0.011160714285714286	55
P28481	PF01391	115	172	0.0	57	G5BWD5	118	175	0.0	57
P28481	PF01391	200	258	0.0	58	G5BWD5	202	260	0.0	58
P28481	PF01391	257	316	0.0	59	G5BWD5	259	318	0.0	59
P28481	PF01391	317	375	0.0	58	G5BWD5	319	377	0.0	58
P28481	PF01391	857	911	0.0	54	G5BWD5	859	913	0.0	54
P28481	PF01391	881	939	0.0	58	G5BWD5	883	941	0.0	58
P28481	PF01391	911	962	0.0	51	G5BWD5	913	964	0.0	51
P28481	PF01391	986	1041	0.0	55	G5BWD5	988	1043	0.0	55
P28481	PF01391	1100	1154	0.0	54	G5BWD5	1102	1155	0.0	53
P28481	PF01391	1157	1215	0.0	58	G5BWD5	823	875	0.0	52
P28481	PF01410	1251	1485	0.21203829787234046	234	G5BWD5	1253	1487	1.2417574468085109	234
Q9D534	PF13913	14	37	0.0	23	G5BL61	7	30	0.0	23
Q9D534	PF13913	118	140	0.0	22	G5BL61	111	133	0.0	22
P20293	PF00907	43	218	3.3797784090909087	175	G5BDY6	44	219	3.381642045454546	175
P10076	PF00096	245	267	1.3641304347826086	22	G5B349	337	359	0.10239130434782608	22
P10076	PF00096	273	295	0.4974782608695652	22	G5B349	365	387	0.15913043478260872	22
P10076	PF00096	301	323	0.0	22	G5B349	393	415	0.0	22
P10076	PF00096	329	351	0.0	22	G5B349	421	443	0.0	22
P10076	PF00096	357	379	0.0	22	G5B349	449	471	0.0	22
P10076	PF00096	385	407	0.1217391304347826	22	G5B349	477	499	0.12347826086956523	22
P10076	PF00096	413	435	0.9968695652173912	22	G5B349	505	527	1.1226521739130435	22
P10076	PF00096	469	491	0.0	22	G5B349	561	583	0.0	22
P10076	PF00096	497	519	0.0	22	G5B349	589	611	0.09634782608695654	22
P10076	PF00096	525	547	0.0	22	G5B349	617	639	0.0	22
P10076	PF00096	553	575	0.0	22	G5B349	645	667	0.0	22
P10076	PF00096	581	603	0.0	22	G5B349	673	695	0.0	22
P10076	PF00096	609	631	6.260695652173912	22	G5B349	701	723	0.0	22
P10076	PF00096	637	659	0.0	22	G5B349	533	555	0.0	22
P10076	PF00096	665	687	0.0	22	G5B349	701	723	0.0	22
P10076	PF00096	693	715	0.0	22	G5B349	729	751	0.0	22
P10076	PF00096	721	743	0.0	22	G5B349	757	779	0.0	22
P10076	PF00096	749	771	0.0	22	G5B349	645	667	0.0	22
P10076	PF00096	805	827	0.0	22	G5B349	729	751	0.0	22
P10076	PF01352	8	48	0.0251219512195122	40	G5B349	99	139	0.05173170731707317	40
P10076	PF13912	191	213	0.0	22	G5B349	282	303	0.0	21
Q8CFD5	PF00400	95	127	0.0	32	G5BHG7	96	128	0.0	32
Q8CFD5	PF00400	175	214	3.0928750000000003	39	G5BHG7	176	215	1.8797249999999996	39
Q8CFD5	PF00400	244	272	0.25213793103448273	28	G5BHG7	241	269	0.2669655172413793	28
Q8CFD5	PF00400	325	360	0.5580833333333333	35	G5BHG7	322	357	0.7743888888888889	35
Q571K4	PF02845	10	49	0.0	39	G5B866	11	50	0.0	39
Q8K443	PF00615	33	148	5.024137931034481	115	G5ASG8	34	149	2.305362068965517	115
P67871	PF01214	7	190	4.64866304347826	183	G5C3F2	84	309	4.566238938053097	225
Q2M3X8	PF02755	139	160	0.08199999999999999	21	G5BN51	57	78	0.10272727272727274	21
Q2M3X8	PF02755	422	444	0.0	22	G5BN51	340	362	0.0	22
Q2M3X8	PF02755	460	482	0.0	22	G5BN51	378	400	0.0	22
Q2M3X8	PF02755	498	518	0.1279047619047619	20	G5BN51	416	436	0.19804761904761906	20
Q6P542	PF00005	312	471	2.7572687500000006	159	G5C3B5	400	559	3.1462562500000004	159
Q6P542	PF00005	633	762	3.715592307692309	129	G5C3B5	721	850	3.7123076923076916	129
Q6P542	PF12848	510	578	0.0	68	G5C3B5	598	666	0.0	68
E9QA62	PF03250	15	95	0.07129629629629629	80	G5AVQ4	15	95	0.26198765432098764	80
Q8BUR3	PF00250	77	158	8.418402439024389	81	G5AQJ0	63	144	8.419292682926828	81
Q80XA6	PF12763	137	226	7.508744444444446	89	G5AJX5	188	280	7.3179462365591395	92
Q5DTV4	PF11977	245	400	6.252634615384616	155	G5C2D9	184	339	6.262666666666666	155
Q5DTV4	PF18039	162	203	2.9015238095238094	41	G5C2D9	101	142	2.910642857142857	41
Q5DTV4	PF18561	833	878	18.228782608695656	45	G5C2D9	772	817	15.120652173913047	45
Q8QZX0	PF00069	52	266	10.478265116279072	214	G5BRB5	53	266	10.527060747663553	213
Q5FWH3	PF04516	227	418	6.371619791666666	191	G5BHX3	182	373	6.364885416666667	191
Q61753	PF00389	8	110	0.14748543689320387	102	G5BV17	9	111	1.2755533980582523	102
Q61753	PF02826	111	284	0.15320114942528734	173	G5BV17	112	285	0.12097126436781605	173
Q8BYY4	PF10300	76	532	11.839437636761485	456	G5AP59	121	577	13.778687089715529	456
Q8BYY4	PF13174	563	592	15.8461	29	G5AP59	608	637	14.94393333333333	29
Q9Z315	PF03343	116	758	1.312737169517885	642	G5BWW1	117	737	1.3338067632850237	620
Q8K371	PF12240	477	678	1.6533663366336633	201	G5BL15	470	671	0.05360891089108912	201
O08997	PF00403	5	59	1.9602727272727276	54	G5BN23	6	60	1.9658	54
O70585	PF00569	240	279	0.0	39	G5CBL4	241	280	0.02025	39
O70585	PF09068	16	139	9.374927419354831	123	G5CBL4	17	140	9.328346774193543	123
O70585	PF09069	144	231	2.010113636363636	87	G5CBL4	145	232	2.654465909090909	87
Q8BNL5	PF02214	13	100	0.9394318181818182	87	G5BUK6	114	201	0.9247386363636364	87
Q91VV4	PF02141	149	331	11.59792349726776	182	G5BNY1	265	449	17.191140540540545	184
Q91VV4	PF03455	403	450	10.197395833333333	47	G5BNY1	522	569	10.187895833333334	47
Q91VV4	PF03456	72	102	0.0	30	G5BNY1	203	232	0.0	29
Q920Q4	PF04840	516	834	6.309432601880876	318	G5B4S4	344	662	6.599413793103447	318
Q920Q4	PF04841	24	172	4.974268456375839	148	G5B4S4	1	148	5.2427837837837865	147
Q9WV06	PF00023	150	179	0.0	29	G5C0C0	155	184	0.0	29
Q9WV06	PF12796	186	278	0.1054516129032258	92	G5C0C0	191	283	0.30518279569892465	92
Q61699	PF00012	3	704	2.1278917378917384	701	G5B2P2	4	705	2.1040042735042737	701
Q62158	PF00622	369	476	10.87060185185185	107	G5C445	372	479	10.874324074074078	107
Q62158	PF13765	317	365	0.01489795918367347	48	G5C445	320	368	0.01489795918367347	48
Q62158	PF15227	15	55	2.9549024390243903	40	G5C445	16	56	2.9480731707317074	40
Q8K4P0	PF00400	192	229	0.3082368421052632	37	G5B9V9	193	230	0.36492105263157903	37
Q8K4P0	PF00400	237	265	0.04431034482758621	28	G5B9V9	238	266	0.04431034482758621	28
Q8K4P0	PF00400	277	315	0.5501025641025643	38	G5B9V9	278	316	0.5548461538461541	38
Q8K4P0	PF00400	322	358	3.0080540540540546	36	G5B9V9	323	359	3.421891891891892	36
Q8K4P0	PF00400	372	401	3.1809	29	G5B9V9	373	402	3.179666666666667	29
Q9Z1N7	PF01388	214	300	16.9714367816092	86	G5BRG7	211	297	16.976908045977016	86
Q9CQ66	PF03645	45	140	16.752229166666666	95	G5ALB7	57	152	17.22405208333333	95
Q9CZX0	PF00583	397	534	3.612210144927535	137	G5B4Z7	392	529	4.058021739130435	137
Q9CZX0	PF04055	106	303	1.1490303030303028	197	G5B4Z7	101	298	1.1440555555555556	197
Q9CZX0	PF16199	311	391	1.763777777777778	80	G5B4Z7	306	386	1.7655802469135802	80
P49698	PF00104	176	360	7.240156756756755	184	G5BB39	177	361	7.245470270270269	184
P49698	PF00105	58	126	0.2457971014492753	68	G5BB39	59	127	0.18342028985507247	68
O35386	PF05721	60	276	4.885608294930873	216	G5BE18	36	252	3.5691474654377884	216
P84096	PF00071	4	176	7.070300578034684	172	G5AVS2	5	177	7.070300578034684	172
Q3UD82	PF00644	677	749	0.7090958904109588	72	G5C264	548	620	0.7069726027397256	72
Q3URR0	PF15510	0	79	11.9633125	79	G5C4S6	1	104	8.305223300970873	103
Q9CQJ0	PF03061	154	223	2.465614285714284	69	G5B8K7	154	223	4.276242857142855	69
Q8BLD6	PF12796	107	190	6.908928571428572	83	G5C414	90	173	5.292845238095238	83
Q8BLD6	PF12796	246	318	2.4414383561643835	72	G5C414	229	301	2.691342465753425	72
Q8BLD6	PF13857	54	96	1.6763255813953493	42	G5C414	37	79	2.7513255813953488	42
Q9CTN5	PF15676	30	573	1.2754466911764704	543	G5C5H6	31	576	1.2173137614678915	545
Q9D1I6	PF00238	31	144	4.777473684210525	113	G5BNN5	32	145	4.069141592920356	113
Q9D211	PF11952	24	111	1.936920454545455	87	G5BN14	25	112	1.9280454545454548	87
Q8BTE0	PF07896	58	103	0.0	45	G5ALU7	59	108	0.0	49
Q8CFV4	PF15056	30	114	1.1618117647058823	84	G5BAS7	31	115	1.2315294117647055	84
P05784	PF00038	71	381	0.8742122186495186	310	G5BJ40	81	399	0.6929592476489029	318
Q5SS90	PF17662	0	290	0.0	290	G5B3U5	1	290	0.0	289
Q8VDC0	PF00133	59	315	2.1328326848249017	256	G5ANN2	61	316	3.1094453124999992	255
Q8VDC0	PF00133	442	599	3.0954620253164555	157	G5ANN2	444	601	3.1116708860759505	157
Q8VDC0	PF00133	636	676	13.55336585365854	40	G5ANN2	638	678	12.536292682926824	40
Q8VDC0	PF08264	725	849	6.174152000000001	124	G5ANN2	727	851	10.595384000000008	124
Q8R3G1	PF00498	48	117	0.4010000000000001	69	G5AUU5	49	118	0.3945142857142859	69
Q9D8B3	PF03357	23	197	0.016428571428571428	174	G5BPU2	18	192	0.016485714285714288	174
Q5HZG4	PF00628	868	915	0.179625	47	G5AXV4	729	776	0.17475	47
Q8VCH5	PF01344	250	290	1.6411951219512193	40	G5B6V8	243	283	0.4269756097560977	40
Q8VCH5	PF07646	38	87	3.85146	49	G5B6V8	31	80	3.87184	49
Q8VCH5	PF13415	107	154	5.2824375	47	G5B6V8	100	147	5.226708333333336	47
Q8VCH5	PF13415	156	207	2.9200192307692303	51	G5B6V8	149	200	5.829442307692307	51
P42582	PF00046	137	193	0.736	56	G5BGI8	139	195	0.7369122807017545	56
P23738	PF00282	42	420	5.135002638522424	378	G5CA48	35	413	5.101403693931402	378
P97363	PF00155	166	525	4.5361777777777785	359	G5B672	167	526	4.590474999999999	359
P61202	PF01399	309	410	0.986656862745098	101	G5CA43	326	427	0.921803921568628	101
Q60648	PF02221	80	189	1.8117727272727269	109	G5BCB7	184	293	0.9948909090909088	109
Q91X96	PF04421	27	121	5.904873684210526	94	G5B378	28	122	5.930905263157892	94
P48455	PF00149	79	279	5.6419203980099475	200	G5B9Q6	64	264	8.259507462686566	200
P28359	PF00046	266	318	10.787943396226414	52	G5BU17	262	313	11.065403846153847	51
Q02650	PF00292	15	139	0.3858960000000001	124	G5AS56	4	128	0.3861119999999999	124
Q02650	PF12403	284	367	0.0	83	G5AS56	273	355	0.0	82
P35428	PF00010	34	91	0.01363793103448276	57	G5ALE8	35	92	0.01363793103448276	57
P35428	PF07527	108	146	0.03256410256410257	38	G5ALE8	109	147	0.03269230769230769	38
Q9WUF2	PF00096	371	395	0.0	24	G5CBQ2	343	367	0.0	24
Q9WUF2	PF00096	401	423	0.0	22	G5CBQ2	373	395	0.0	22
Q9WUF2	PF00096	429	451	0.0	22	G5CBQ2	401	423	0.0	22
Q9D9D9	PF15104	22	99	0.38320512820512814	77	G5BDC4	2	79	0.04537179487179487	77
Q80YV4	PF01937	450	805	6.75738202247191	355	G5ATI7	451	759	3.5928770226537226	308
Q80YV4	PF03630	36	366	4.648066465256798	330	G5ATI7	37	367	4.9434501510574025	330
P35290	PF00071	8	170	3.0727116564417165	162	G5BQ02	9	171	3.1179509202453985	162
Q8BUP8	PF14719	68	255	8.123271276595744	187	G5ALE2	17	204	8.057643617021277	187
Q9EPQ7	PF01852	9	209	3.603960199004976	200	G5BEZ4	10	210	3.4762587064676618	200
Q9D3X5	PF10274	77	244	8.212035714285719	167	G5C7F5	78	218	8.434787234042554	140
Q9JLB4	PF00008	132	160	0.4658620689655173	28	G5BFE6	133	160	0.3633928571428572	27
Q9JLB4	PF00008	435	463	0.14927586206896554	28	G5BFE6	432	460	0.0	28
Q9JLB4	PF00431	473	581	10.647651376146788	108	G5BFE6	470	578	11.523559633027515	108
Q9JLB4	PF00431	589	698	9.76248181818182	109	G5BFE6	586	695	11.037736363636368	109
Q9JLB4	PF00431	707	812	3.1893962264150937	105	G5BFE6	704	809	2.6724245283018857	105
Q9JLB4	PF00431	816	924	16.88453211009174	108	G5BFE6	813	921	21.50155963302752	108
Q9JLB4	PF00431	931	1038	10.836740740740746	107	G5BFE6	928	1035	5.562046296296296	107
Q9JLB4	PF00431	1047	1156	1.3183272727272732	109	G5BFE6	1044	1153	0.07187272727272727	109
Q9JLB4	PF00431	1164	1273	1.1487454545454547	109	G5BFE6	1162	1271	3.683445454545456	109
Q9JLB4	PF00431	1277	1384	8.100009259259258	107	G5BFE6	1275	1382	3.3818703703703714	107
Q9JLB4	PF00431	1390	1501	0.12678571428571433	111	G5BFE6	1388	1499	3.840642857142858	111
Q9JLB4	PF00431	1509	1615	3.073102803738317	106	G5BFE6	1507	1613	3.0376822429906545	106
Q9JLB4	PF00431	1619	1730	1.0311964285714288	111	G5BFE6	1622	1733	0.8094285714285713	111
Q9JLB4	PF00431	1737	1846	0.6652727272727272	109	G5BFE6	1740	1849	3.189645454545456	109
Q9JLB4	PF00431	1855	1958	0.2289615384615385	103	G5BFE6	1858	1961	1.376278846153846	103
Q9JLB4	PF00431	1977	2087	5.34383783783784	110	G5BFE6	1980	2090	3.1357207207207205	110
Q9JLB4	PF00431	2091	2209	2.7827647058823524	118	G5BFE6	2094	2213	5.989591666666665	119
Q9JLB4	PF00431	2225	2330	1.7081037735849056	105	G5BFE6	2229	2333	3.751409523809524	104
Q9JLB4	PF00431	2335	2444	0.1754181818181818	109	G5BFE6	2338	2447	0.09596363636363638	109
Q9JLB4	PF00431	2451	2561	10.458576576576576	110	G5BFE6	2454	2564	7.777450450450448	110
Q9JLB4	PF00431	2569	2683	1.132026086956522	114	G5BFE6	2572	2686	8.142434782608698	114
Q9JLB4	PF00431	2688	2796	5.277477064220181	108	G5BFE6	2691	2799	7.831321100917433	108
Q9JLB4	PF00431	2804	2915	8.507678571428574	111	G5BFE6	2807	2918	2.7595892857142847	111
Q9JLB4	PF00431	2919	3031	8.079522123893799	112	G5BFE6	2922	3034	7.540141592920353	112
Q9JLB4	PF00431	3036	3146	4.262693693693692	110	G5BFE6	3039	3148	5.379972727272729	109
Q9JLB4	PF00431	3156	3270	9.71654782608696	114	G5BFE6	3158	3272	10.535217391304348	114
Q9JLB4	PF00431	3277	3382	9.059707547169813	105	G5BFE6	3279	3384	11.303933962264152	105
Q9JLB4	PF00431	3394	3501	7.030675925925928	107	G5BFE6	3396	3503	2.720814814814816	107
Q9JLB4	PF00431	3510	3619	4.256554545454545	109	G5BFE6	3512	3621	11.94120909090909	109
Q9JLB4	PF07645	166	203	0.3513157894736841	37	G5BFE6	167	204	1.204921052631579	37
Q9JLB4	PF07645	259	298	0.0	39	G5BFE6	260	297	0.21923684210526315	37
Q9JLB4	PF07645	301	343	0.0	42	G5BFE6	301	343	0.2483720930232558	42
Q9JLB4	PF12661	403	423	0.7714285714285716	20	G5BFE6	400	420	0.5558571428571429	20
Q9JLB4	PF12947	349	386	0.0375	37	G5BFE6	349	383	0.031285714285714285	34
Q0KK56	PF15665	49	245	2.8470050761421315	196	G5APR0	50	246	1.1408934010152287	196
B2RVL6	PF13696	128	148	0.11433333333333333	20	G5BRK2	48	68	0.11466666666666665	20
B2RVL6	PF17180	163	229	0.0	66	G5BRK2	83	149	0.0	66
A2AUC9	PF00651	22	128	15.213682242990652	106	G5C8Q5	23	129	17.199588785046725	106
A2AUC9	PF01344	386	433	9.69752083333333	47	G5C8Q5	387	434	9.694666666666668	47
A2AUC9	PF01344	437	480	0.8071136363636363	43	G5C8Q5	438	481	0.8060454545454544	43
A2AUC9	PF01344	483	526	4.505863636363637	43	G5C8Q5	484	527	4.535613636363637	43
A2AUC9	PF07707	134	236	8.488378640776697	102	G5C8Q5	135	237	4.728582524271843	102
Q9EQW7	PF16183	390	467	7.696948717948718	77	G5AXT5	563	640	7.697743589743589	77
Q9EQW7	PF00225	72	351	6.6468785714285685	279	G5AXT5	193	524	5.784307228915661	331
Q9EQW7	PF12423	747	791	4.831022222222223	44	G5AXT5	920	964	6.149311111111111	44
Q9EQW7	PF12473	1003	1268	2.7069022556390983	265	G5AXT5	1176	1454	2.5803154121863803	278
Q60670	PF00069	26	277	6.941876984126984	251	G5B2U8	27	278	6.591968253968253	251
Q5NCQ5	PF01866	75	376	8.29950662251657	301	G5BCU6	97	398	8.385500000000006	301
Q64514	PF00082	55	499	2.2267483146067413	444	G5B9M8	35	479	2.6048561797752816	444
Q64514	PF12580	776	962	3.4093850267379664	186	G5B9M8	756	942	3.9345508021390367	186
P02830	PF00046	129	185	0.07882456140350877	56	G5BD55	131	187	0.07864912280701752	56
O88878	PF01428	153	190	0.0941842105263158	37	G5AY61	154	191	0.0941842105263158	37
O88878	PF01754	11	34	0.029	23	G5AY61	12	35	0.029	23
Q80TL7	PF09324	849	927	5.848139240506329	78	G5ARJ0	852	930	6.085911392405063	78
Q80TL7	PF12783	210	383	10.870563218390801	173	G5ARJ0	212	385	10.929258620689657	173
Q80TL7	PF16206	931	1705	4.520530322580641	774	G5ARJ0	934	1710	5.076000000000001	776
Q80TL7	PF16213	8	183	11.421727272727274	175	G5ARJ0	9	184	11.42003977272727	175
Q99KS2	PF06413	72	292	0.04427149321266967	220	G5CAA9	73	290	0.030184331797235026	217
Q9D4H7	PF02190	549	743	5.6464974358974365	194	G5BX15	394	588	6.060287179487179	194
Q9D4H7	PF13445	158	185	0.4128214285714284	27	G5BX15	305	331	0.0	26
Q9D4H7	PF13923	459	497	0.0	38	G5BX15	304	342	0.0	38
Q9CWG8	PF02636	94	347	2.620137795275588	253	G5BZ84	102	355	4.175311023622046	253
P97346	PF13905	33	139	6.409401869158878	106	G5BVK0	147	233	8.979103448275858	86
P97346	PF13905	194	286	8.202290322580646	92	G5BVK0	146	238	8.709741935483867	92
Q9Z2U4	PF00178	209	288	5.217149999999998	79	G5B2Q7	209	288	4.971387500000001	79
Q9Z2U4	PF12310	1	102	1.038313725490196	101	G5B2Q7	2	103	0.14151960784313725	101
P0C6F1	PF03028	3861	3974	7.485140350877195	113	G5B5D9	3834	3947	7.689982456140351	113
P0C6F1	PF08385	276	427	7.1701842105263225	151	G5B5D9	242	393	4.031078947368422	151
P0C6F1	PF08385	448	757	4.100254838709681	309	G5B5D9	414	723	4.526783870967744	309
P0C6F1	PF08393	1255	1662	1.580377450980393	407	G5B5D9	1221	1629	2.340616136919316	408
P0C6F1	PF12774	1793	2119	9.541568807339457	326	G5B5D9	1766	2092	9.889431192660561	326
P0C6F1	PF12775	2405	2585	11.197618784530388	180	G5B5D9	2378	2558	7.2034861878453045	180
P0C6F1	PF12777	3034	3366	6.832714714714721	332	G5B5D9	3007	3339	5.800036036036032	332
P0C6F1	PF12780	2760	3020	7.871283524904213	260	G5B5D9	2733	2993	7.902295019157092	260
P0C6F1	PF12781	3393	3614	5.576977477477474	221	G5B5D9	3366	3587	5.3587252252252195	221
P0C6F1	PF17852	2281	2399	10.22110084033614	118	G5B5D9	2254	2372	8.648176470588236	118
P0C6F1	PF17857	2617	2706	2.656755555555556	89	G5B5D9	2590	2679	3.7718777777777777	89
P0C6F1	PF18198	3989	4145	11.491840764331211	156	G5B5D9	3962	4118	9.637471337579612	156
P0C6F1	PF18199	4152	4451	7.008816666666665	299	G5B5D9	4125	4425	5.5412491694352175	300
Q9D114	PF13328	10	135	4.403547619047618	125	G5CAB4	11	135	4.456936	124
Q9WUK2	PF00076	44	110	0.4715074626865672	66	G5BG89	25	91	0.37379104477611946	66
Q60641	PF00104	298	471	6.292074712643678	173	G5BBI4	298	471	6.279735632183906	173
Q60641	PF00105	136	202	0.05446268656716419	66	G5BBI4	137	203	0.1032686567164179	66
Q8K5B2	PF13499	101	141	0.6278048780487805	40	G5C9S7	181	221	0.6118292682926829	40
Q91VT4	PF13561	10	231	3.69535135135135	221	G5BC18	11	233	3.42298206278027	222
Q9D2G5	PF02383	60	339	6.3532142857142855	279	G5B2S4	70	349	7.917935714285713	279
Q9D2G5	PF03372	534	807	8.430689781021893	273	G5B2S4	544	817	8.235744525547446	273
Q9D2G5	PF08952	862	1007	5.42273287671233	145	G5B2S4	872	1017	5.4869520547945205	145
O35857	PF04280	296	443	13.357195945945946	147	G5B4M9	297	444	13.220614864864864	147
F8VPN2	PF15326	1583	1786	1.496671568627452	203	G5C9Y8	1532	1744	0.2760281690140845	212
F8VPN2	PF15326	1994	2113	0.9191250000000007	119	G5C9Y8	1954	2073	0.4026833333333333	119
Q8C0P5	PF00400	79	110	0.044437500000000005	31	G5AZ22	80	111	0.042375	31
Q8C0P5	PF00400	171	206	1.7436111111111108	35	G5AZ22	172	207	1.7493611111111107	35
Q8C0P5	PF08953	6	69	8.941156250000002	63	G5AZ22	7	70	9.824843749999998	63
Q8C0P5	PF16300	349	391	0.030116279069767438	42	G5AZ22	350	392	1.1378837209302326	42
O55196	PF15362	215	413	0.0	198	G5BMZ8	207	404	0.010666666666666666	197
O55196	PF15362	540	1248	0.1299985895627644	708	G5BMZ8	389	1104	0.1266997206703911	715
P50615	PF07742	0	110	9.754054054054047	110	G5BAA1	1	111	12.847189189189182	110
Q505D1	PF00023	470	502	0.0	32	G5BMH4	441	473	0.0	32
Q505D1	PF00023	685	715	0.0	30	G5BMH4	647	677	0.0	30
Q505D1	PF12796	11	103	3.979838709677421	92	G5BMH4	42	134	3.8343225806451606	92
Q505D1	PF12796	278	364	2.8498735632183902	86	G5BMH4	242	335	6.585851063829787	93
Q505D1	PF12796	375	465	5.027824175824176	90	G5BMH4	346	436	5.028835164835165	90
Q505D1	PF12796	548	612	1.6066923076923076	64	G5BMH4	510	574	1.6529230769230767	64
Q505D1	PF12796	617	682	4.401045454545455	65	G5BMH4	579	644	4.404121212121212	65
Q505D1	PF12796	717	777	2.553967213114753	60	G5BMH4	679	739	2.5400491803278684	60
Q505D1	PF12796	820	886	0.16311940298507469	66	G5BMH4	782	848	0.16486567164179108	66
Q505D1	PF12796	889	952	8.34296875	63	G5BMH4	851	914	8.438296875000002	63
Q505D1	PF13637	139	192	6.496703703703703	53	G5BMH4	170	223	6.738981481481482	53
Q505D1	PF13637	206	250	8.215955555555556	44	G5BMH4	237	288	7.134096153846153	51
Q8K4G2	PF01391	107	160	0.0	53	G5BCC8	22	75	0.0	53
Q8K4G2	PF01391	148	204	0.0	56	G5BCC8	63	119	0.0	56
Q8K4G2	PF01391	241	295	0.0	54	G5BCC8	150	204	0.0	54
Q8K4G2	PF01391	312	366	0.0	54	G5BCC8	221	275	0.0	54
Q8K4G2	PF01391	330	385	0.0	55	G5BCC8	239	294	0.0	55
Q8K4G2	PF01391	406	459	0.0	53	G5BCC8	153	205	0.0	52
Q8K4G2	PF01391	454	511	0.0	57	G5BCC8	360	417	0.0	57
Q5ND19	PF15548	13	366	0.021056497175141242	353	G5BJU3	14	359	0.3954595375722544	345
Q5ND19	PF15548	368	508	3.1137446808510636	140	G5BJU3	390	531	3.308661971830986	141
P61965	PF00400	39	71	0.2838181818181818	32	G5B8I6	104	136	0.4133636363636364	32
P61965	PF00400	78	114	0.19613513513513514	36	G5B8I6	17	53	0.20575675675675675	36
P61965	PF00400	118	156	1.3013846153846151	38	G5B8I6	57	95	1.3172820512820511	38
P61965	PF00400	160	198	0.3481025641025642	38	G5B8I6	99	137	0.34976923076923083	38
P61965	PF00400	202	241	9.289900000000003	39	G5B8I6	141	180	9.309450000000004	39
P61965	PF00400	245	286	19.738261904761906	41	G5B8I6	184	225	20.382666666666672	41
P61965	PF00400	292	330	1.2462051282051287	38	G5B8I6	231	269	1.2389743589743587	38
Q8BJ37	PF06087	166	581	3.195882211538461	415	G5BK46	166	581	3.5034831730769227	415
Q7TN16	PF03024	37	219	2.6317814207650274	182	G5C7E9	38	220	0.2940437158469946	182
Q7TN16	PF07995	227	437	4.124113744075828	210	G5C7E9	228	438	4.324094786729857	210
P70175	PF00018	524	580	0.3786666666666666	56	G5B6C6	406	462	0.3273684210526316	56
P70175	PF00595	149	231	0.8484096385542169	82	G5B6C6	31	113	0.8491927710843374	82
P70175	PF00595	244	326	1.0109759036144574	82	G5B6C6	126	208	1.0118915662650594	82
P70175	PF00595	404	479	12.326552631578947	75	G5B6C6	286	361	12.84622368421052	75
P70175	PF00625	658	834	4.510824858757061	176	G5B6C6	540	716	4.512485875706213	176
P70175	PF10600	328	402	0.20975999999999995	74	G5B6C6	210	284	0.2099866666666667	74
P70175	PF10608	119	147	0.0	28	G5B6C6	1	29	0.0	28
Q3UIK4	PF05063	185	361	3.3267175141242964	176	G5BC36	186	362	3.3143276836158218	176
O35286	PF00270	148	295	9.391594594594595	147	G5BE32	149	296	9.397250000000003	147
O35286	PF00271	337	475	11.194769784172662	138	G5BE32	338	476	11.173769784172661	138
O35286	PF04408	538	626	2.441	88	G5BE32	539	627	2.6339101123595507	88
O35286	PF07717	688	764	8.324025974025973	76	G5BE32	689	765	8.296597402597403	76
Q8C088	PF07645	255	283	0.0	28	G5BVA5	169	197	0.005172413793103447	28
Q8C088	PF07645	331	367	0.25032432432432433	36	G5BVA5	253	289	0.3208918918918918	36
Q8C088	PF14670	167	202	0.021388888888888888	35	G5BVA5	122	157	0.021388888888888888	35
Q8C088	PF14670	294	329	0.03822222222222222	35	G5BVA5	216	251	0.0	35
Q8K4M5	PF07258	116	184	0.05289855072463768	68	G5C1Y3	116	184	0.053188405797101455	68
Q8K4M5	PF17221	5	105	0.2068910891089109	100	G5C1Y3	6	105	0.43132000000000015	99
Q99J77	PF03102	38	275	5.240382352941175	237	G5AZ24	39	276	4.030932773109243	237
Q99J77	PF08666	293	349	8.798456140350877	56	G5AZ24	294	350	12.62175438596491	56
Q9QXG2	PF00996	11	75	6.0049230769230775	64	G5BH17	1	65	4.975169230769232	64
Q9QXG2	PF00996	232	535	4.553911184210525	303	G5BH17	204	507	4.126779605263156	303
P58269	PF00628	318	362	0.012399999999999998	44	G5BP37	416	460	0.01833333333333333	44
P58269	PF14051	64	83	0.0	19	G5BP37	68	87	0.0	19
Q6DI86	PF06743	560	626	20.14898507462685	66	G5C8Q4	551	617	19.361149253731345	66
Q6DI86	PF08368	677	729	0.4354716981132076	52	G5C8Q4	624	676	2.966094339622641	52
Q6DI86	PF08373	762	820	0.03371186440677967	58	G5C8Q4	712	770	0.03325423728813559	58
Q7TMX5	PF04925	243	414	7.255494186046512	171	G5AVP5	245	397	9.663764705882352	152
Q3URV1	PF14961	11	1291	9.228311475409845	1280	G5B3X0	12	1300	8.93861365399534	1288
P08003	PF00085	56	157	0.4221862745098037	101	G5BET1	62	163	0.2343529411764705	101
P08003	PF00085	171	271	0.25413861386138625	100	G5BET1	177	277	2.7468019801980184	100
P08003	PF00085	519	625	4.197149532710281	106	G5BET1	525	631	3.43571028037383	106
P08003	PF13848	305	495	4.436617801047122	190	G5BET1	311	501	4.665638743455497	190
Q9QY93	PF12643	62	134	12.454232876712327	72	G5BYL6	54	125	12.86611267605634	71
Q9D4K4	PF15124	2	177	4.853318181818182	175	G5BX76	3	178	2.5936742857142856	175
Q923B1	PF00149	0	228	5.666078602620082	228	G5BPK6	1	229	5.5293275109170255	228
Q923B1	PF05011	246	377	2.871166666666668	131	G5BPK6	247	378	2.0571363636363653	131
O70230	PF00096	266	290	0.0	24	G5BRK9	267	291	0.0	24
O70230	PF00096	296	320	0.0	24	G5BRK9	297	321	0.0	24
O70230	PF00096	326	350	0.0	24	G5BRK9	327	351	0.0	24
O70230	PF00096	356	380	0.0	24	G5BRK9	357	381	0.0	24
O70230	PF00096	416	439	0.024166666666666663	23	G5BRK9	417	440	0.024166666666666663	23
Q6XP49	PF00096	412	435	0.0	23	G5C4T1	569	592	0.0	23
Q6XP49	PF00096	471	495	0.0	24	G5C4T1	628	652	0.0	24
Q07174	PF00069	145	385	8.249639004149378	240	G5C5F1	146	386	10.104004149377591	240
Q61663	PF00046	157	213	0.007543859649122806	56	G5AXE9	158	214	0.007543859649122806	56
O54784	PF00069	12	274	5.1945893536121694	262	G5BZB9	13	275	5.1982395437262365	262
P23950	PF00642	114	139	0.0	25	G5C7X0	115	140	0.0	25
P23950	PF00642	152	176	0.0	24	G5C7X0	153	177	0.0	24
P23950	PF04553	0	103	4.386269230769232	103	G5C7X0	1	104	4.386269230769232	103
Q62441	PF00400	580	604	3.1488400000000007	24	G5AN98	488	512	2.52088	24
Q62441	PF00400	610	646	0.0	36	G5AN98	518	554	0.0	36
Q62441	PF03920	47	84	6.833315789473683	37	G5AN98	74	110	7.018945945945947	36
Q9DCD5	PF15453	272	431	0.2858125000000001	159	G5BNM5	288	447	0.2833250000000001	159
Q9DCD5	PF15453	461	537	0.0	76	G5BNM5	482	558	0.0	76
Q07456	PF00014	229	280	0.0	51	G5B1Y4	231	282	0.01423076923076923	51
Q07456	PF00014	284	335	1.032173076923077	51	G5B1Y4	286	337	5.572557692307692	51
Q07456	PF00061	40	183	5.068020833333336	143	G5B1Y4	42	185	4.385791666666669	143
Q9Z2D7	PF01429	66	131	0.8698787878787878	65	G5BYE1	28	93	9.065030303030301	65
Q3U0D9	PF00632	603	837	5.157480851063831	234	G5BNS0	290	525	5.744982832618028	235
Q8CBD1	PF15687	26	330	1.128245901639345	304	G5B4Q0	27	330	1.1163848684210524	303
Q8CBD1	PF15688	411	736	1.4115184049079752	325	G5B4Q0	411	736	1.3927822085889574	325
Q8CBD1	PF15689	753	840	0.061465909090909085	87	G5B4Q0	753	840	0.3599659090909091	87
Q8CBD1	PF15690	848	1160	1.5676964856230033	312	G5B4Q0	848	1156	1.4911331168831168	308
Q62507	PF00092	166	313	15.693608108108105	147	G5CAM3	165	312	15.841148648648643	147
Q62507	PF00092	368	534	17.56211976047905	166	G5CAM3	367	533	16.699718562874256	166
Q62507	PF03815	39	122	6.36729761904762	83	G5CAM3	38	121	6.434630952380955	83
Q9D1P0	PF00572	15	132	6.43336440677966	117	G5C9Q8	8	125	3.869669491525425	117
Q3V3A1	PF00069	102	384	5.328985865724387	282	G5C1T2	106	388	5.065901060070672	282
Q8VC30	PF02733	19	333	7.045479365079364	314	G5AYG5	20	333	6.728499999999998	313
Q8VC30	PF02734	398	558	6.161304347826088	160	G5AYG5	400	545	0.8159315068493149	145
P63032	PF00071	20	186	7.231820359281437	166	G5BPF2	21	187	7.461562874251496	166
P12656	PF00007	19	124	0.9628962264150946	105	G5B092	20	125	0.7361981132075472	105
Q9DB90	PF10220	200	340	16.302943262411357	140	G5CBP4	201	341	16.301808510638303	140
O35130	PF03587	44	237	7.1923298969072125	193	G5CAS3	47	240	6.617989690721643	193
Q9R226	PF00013	58	115	0.0	57	G5C6R4	38	95	0.0	57
Q9R226	PF16274	21	52	1.2420937499999996	31	G5C6R4	1	32	2.7818125	31
Q9R226	PF16568	265	319	0.0	54	G5C6R4	245	299	0.0	54
Q9WV07	PF00305	265	691	6.701367681498837	426	G5B5F1	451	829	5.025189973614776	378
Q9WV07	PF01477	3	106	5.566346153846153	103	G5B5F1	189	292	5.1072596153846135	103
Q8R1K4	PF00202	31	432	4.022166666666665	401	G5BCC7	13	414	5.11578855721393	401
Q91VU6	PF00400	297	335	0.6027948717948719	38	G5B298	298	336	2.0396153846153844	38
Q91VU6	PF00400	345	382	0.17886842105263154	37	G5B298	346	383	0.18247368421052626	37
Q91VU6	PF00400	474	509	0.0	35	G5B298	475	510	0.0	35
Q8K3A6	PF04826	106	283	5.699033707865167	177	G5AL44	199	375	4.017016949152544	176
Q6RUU0	PF00354	271	448	5.0183426966292135	177	G5BY75	276	453	4.539078651685392	177
Q5U430	PF02207	141	186	0.0	45	G5C8P7	1	46	0.0	45
Q5U430	PF18995	1427	1871	13.427791011235955	444	G5C8P7	1260	1704	13.510975280898876	444
Q8BZN4	PF00069	56	314	7.5634980694980705	258	G5BX40	59	309	6.112067729083664	250
P0C242	PF00134	109	229	9.063537190082638	120	G5C6X1	70	190	6.861495867768591	120
P0C242	PF02984	232	328	3.125505154639176	96	G5C6X1	193	289	12.989422680412376	96
P97390	PF00995	22	545	6.730851145038165	523	G5BH28	23	546	6.636291984732822	523
Q9DCA2	PF00411	81	189	0.17063302752293574	108	G5CA80	83	191	0.19884403669724776	108
Q9Z2W0	PF02127	21	459	3.1556309794988637	438	G5AKJ4	48	486	2.8104829157175413	438
Q6IS41	PF00153	1	78	7.554884615384616	77	G5B4B3	2	78	7.354999999999999	76
Q6IS41	PF00153	99	207	9.839844036697249	108	G5B4B3	100	205	10.723377358490566	105
Q6IS41	PF00153	226	304	21.394063291139236	78	G5B4B3	206	284	18.182037974683553	78
Q9WVM3	PF13181	339	369	0.4737096774193548	30	G5AWM6	337	367	0.3858064516129031	30
Q9WVM3	PF13432	448	507	4.805366666666665	59	G5AWM6	446	505	4.805699999999998	59
Q9D7E4	PF15136	5	102	0.9005204081632654	97	G5BW46	6	103	0.7513877551020413	97
Q9JKD8	PF00907	137	324	8.670180851063831	187	G5BY27	40	233	7.922726804123712	193
A2AIL4	PF00494	98	309	1.8905471698113208	211	G5C4B5	28	239	3.0881037735849057	211
Q8VC60	PF01301	34	349	4.780433544303795	315	G5AKK0	38	353	4.080332278481016	315
Q6PFX9	PF00023	428	458	0.7024193548387098	30	G5AV65	436	466	0.7020645161290322	30
Q6PFX9	PF12796	178	271	3.931223404255319	93	G5AV65	186	279	3.9305425531914895	93
Q6PFX9	PF12796	331	424	2.8931702127659573	93	G5AV65	339	432	2.8922021276595755	93
Q6PFX9	PF12796	532	610	0.2771139240506329	78	G5AV65	540	618	0.2936202531645569	78
Q6PFX9	PF12796	647	739	0.12489247311827953	92	G5AV65	655	747	0.1271505376344086	92
Q6PFX9	PF00644	1108	1301	3.3095309278350538	193	G5AV65	1116	1309	3.5716030927835045	193
Q6PFX9	PF07647	1022	1078	0.0358421052631579	56	G5AV65	1030	1086	0.03575438596491229	56
Q6PFX9	PF13606	274	302	17.60703448275862	28	G5AV65	282	310	17.606034482758623	28
Q6PFX9	PF13637	744	781	0.0	37	G5AV65	752	789	0.0	37
Q6PFX9	PF13637	830	882	9.295981132075473	52	G5AV65	838	890	9.328679245283016	52
Q6PFX9	PF13857	888	935	4.569020833333334	47	G5AV65	896	943	4.565375	47
P48999	PF00305	218	657	5.8582318181818245	439	G5ATS6	219	658	6.174224999999999	439
P48999	PF01477	3	106	7.4815096153846214	103	G5ATS6	4	107	6.525240384615387	103
Q9JK42	PF02518	241	360	7.228324999999999	119	G5C4I6	242	361	7.282633333333334	119
Q9JK42	PF10436	29	191	2.8738895705521474	162	G5C4I6	30	192	2.8688404907975467	162
Q61194	PF00168	1571	1679	6.367357798165133	108	G5B0I5	1570	1678	6.250394495412843	108
Q61194	PF00454	1132	1345	6.971537383177568	213	G5B0I5	1131	1344	6.9402850467289685	213
Q61194	PF00613	868	1035	4.514458333333333	167	G5B0I5	867	1034	5.7623154761904765	167
Q61194	PF00787	1452	1532	3.2437160493827166	80	G5B0I5	1451	1531	3.2438395061728387	80
Q61194	PF00792	702	818	16.021598290598302	116	G5B0I5	701	816	13.557439655172415	115
Q61194	PF00794	414	510	8.722896907216494	96	G5B0I5	414	510	9.051948453608249	96
Q8CID0	PF00583	668	747	33.28220000000002	79	G5CBA8	671	758	39.16017045454548	87
Q80U57	PF00168	167	274	6.688675925925925	107	G5AQK2	169	276	8.945546296296293	107
Q99JB8	PF00611	21	95	1.2664933333333337	74	G5BPC1	22	96	1.26356	74
Q99JB8	PF14604	369	419	0.0	50	G5BPC1	375	425	0.0	50
Q5SQY2	PF05205	42	137	2.349583333333333	95	G5BGJ0	55	145	1.4535714285714287	90
Q8QZR1	PF00155	71	433	4.268774104683195	362	G5C1R1	70	432	3.7128264462809932	362
Q8QZR1	PF07706	0	39	0.15087499999999993	39	G5C1R1	1	38	0.0	37
Q4KWH5	PF00168	733	835	4.243815533980581	102	G5C2Z8	831	933	4.241446601941746	102
Q4KWH5	PF00387	601	711	2.545045045045045	110	G5C2Z8	699	809	2.541603603603603	110
Q4KWH5	PF00388	300	444	1.3401379310344823	144	G5C2Z8	399	543	1.330048275862069	144
Q4KWH5	PF09279	206	291	9.004302325581406	85	G5C2Z8	305	390	8.220534883720934	85
Q07832	PF00659	417	478	2.8661451612903246	61	G5BV68	418	479	2.5658548387096767	61
Q07832	PF00659	515	582	5.83104411764706	67	G5BV68	516	569	0.8752407407407409	53
Q07832	PF00069	52	304	7.450632411067193	252	G5BV68	53	305	7.4539051383399215	252
Q62108	PF00018	433	489	0.6057543859649122	56	G5B5A1	431	487	0.4843157894736842	56
Q62108	PF00595	64	148	2.106835294117648	84	G5B5A1	62	146	2.109270588235294	84
Q62108	PF00595	160	242	3.94589156626506	82	G5B5A1	158	240	3.5485421686746985	82
Q62108	PF00595	313	387	13.07204	74	G5B5A1	311	385	13.843920000000008	74
Q62108	PF00625	533	709	2.427350282485875	176	G5B5A1	531	707	2.4281864406779667	176
Q62108	PF10600	244	311	0.0	67	G5B5A1	242	309	0.0	67
Q62108	PF10608	24	63	0.14300000000000002	39	G5B5A1	25	61	0.15472972972972973	36
O88998	PF02191	229	474	6.829288617886179	245	G5B8J0	180	425	7.032487804878048	245
O88998	PF12308	54	151	0.6188775510204082	97	G5B8J0	5	102	0.6216020408163265	97
O35228	PF09294	128	205	0.454294871794872	77	G5BZB0	123	201	4.733544303797468	78
Q7TPQ9	PF00339	17	164	0.05765540540540541	147	G5BN38	18	165	0.016939189189189185	147
Q7TPQ9	PF02752	187	312	4.0031904761904755	125	G5BN38	188	313	6.59268253968254	125
Q8K158	PF08613	79	173	19.096284210526317	94	G5AKK7	80	174	16.95261052631579	94
Q9Z2E2	PF01429	1	69	0.0	68	G5BVS5	2	70	0.05459420289855073	68
Q9Z2E2	PF02008	186	232	0.22240425531914892	46	G5BVS5	169	215	0.2009574468085106	46
Q9Z2E2	PF02008	235	279	0.0	44	G5BVS5	218	262	0.0	44
Q9Z2E2	PF02008	352	394	0.0	42	G5BVS5	352	394	0.0	42
Q8BSF4	PF02666	161	403	4.782485596707819	242	G5BBV3	165	406	4.781636363636365	241
Q6JPI3	PF06333	1792	2195	5.030269801980193	403	G5AKS3	1693	2095	5.800151364764267	402
Q6JPI3	PF11597	103	222	5.601583333333334	119	G5AKS3	1	120	5.672141666666665	119
Q6JPI3	PF18296	1414	1756	6.896250728862975	342	G5AKS3	1312	1657	6.871130057803469	345
Q8BU11	PF00505	222	290	9.281898550724641	68	G5BFV0	223	291	9.281898550724641	68
Q8CFE2	PF10228	76	327	1.9517182539682536	251	G5BC23	76	327	2.168031746031746	251
Q8R4V5	PF00100	267	513	4.250570850202426	246	G5C2H7	277	523	2.112109311740892	246
Q8R4V5	PF14670	185	220	0.2223611111111111	35	G5C2H7	195	230	0.10444444444444444	35
Q8R4V5	PF14670	226	261	0.03958333333333333	35	G5C2H7	236	271	0.26166666666666666	35
O35671	PF10480	0	198	4.842738693467337	198	G5BEK5	1	199	2.987864321608038	198
P39655	PF00305	200	644	3.069732584269663	444	G5B660	201	645	4.3737528089887645	444
P39655	PF01477	3	101	8.275393939393938	98	G5B660	4	102	4.684414141414142	98
Q91ZM9	PF02174	135	229	5.929484210526314	94	G5C0M7	136	230	5.210442105263158	94
Q9QZQ1	PF00595	1011	1088	2.578935897435898	77	G5ANW3	1024	1101	1.859012820512821	77
Q9QZQ1	PF00788	42	132	0.3779120879120879	90	G5ANW3	1	92	0.3723369565217391	91
Q9QZQ1	PF00788	246	346	3.8938514851485153	100	G5ANW3	206	306	3.880099009900991	100
Q9QZQ1	PF00498	433	491	0.33132203389830506	58	G5ANW3	378	436	0.3300169491525424	58
Q9QZQ1	PF01843	784	886	6.953359223300963	102	G5ANW3	732	834	6.657776699029126	102
O35490	PF02574	22	312	2.4607250859106524	290	G5ASU0	23	313	2.9551786941580764	290
Q920N1	PF07004	25	57	0.02106060606060606	32	G5AUC3	26	58	0.02106060606060606	32
Q920N1	PF07004	99	128	0.0	29	G5AUC3	100	129	0.0	29
Q920N1	PF07004	135	167	0.0	32	G5AUC3	136	168	0.0	32
Q920N1	PF07004	215	243	0.7717241379310344	28	G5AUC3	218	246	0.7341379310344828	28
Q5IBH7	PF11357	67	197	13.893366412213744	130	G5C2Y3	66	196	13.891427480916034	130
Q8CDN8	PF13863	111	229	1.3817983193277308	118	G5C0T1	113	231	11.343394957983193	118
Q9Z0F6	PF04139	12	264	8.123841897233202	252	G5BSB0	13	265	6.958592885375492	252
O35841	PF05918	23	495	3.22276955602537	472	G5AS37	53	495	3.423839729119639	442
Q6RUT8	PF15450	54	434	1.2438608923884509	380	G5BXS9	62	425	2.644120879120879	363
Q9CR68	PF00355	156	259	6.9694615384615375	103	G5BL47	157	260	6.974865384615384	103
Q9CR68	PF02921	79	144	15.779454545454545	65	G5BL47	80	145	16.19365151515151	65
Q9CR68	PF09165	1	76	1.4271184210526318	75	G5BL47	2	77	0.4595789473684211	75
P16054	PF00069	408	666	4.882791505791506	258	G5C9T7	245	503	4.8841621621621565	258
P16054	PF00130	169	220	10.660980769230768	51	G5C9T7	20	71	10.665461538461528	51
P16054	PF00130	242	293	1.87775	51	G5C9T7	20	71	10.665461538461528	51
P16054	PF00433	690	729	1.6141250000000005	39	G5C9T7	527	566	1.7745749999999998	39
Q8K389	PF07989	58	128	0.07025352112676055	70	G5BHE6	58	128	0.06977464788732395	70
Q9WTJ2	PF00096	117	137	0.16952380952380952	20	G5B6J1	118	138	0.14885714285714288	20
Q9WTJ2	PF13465	159	184	0.0	25	G5B6J1	160	185	0.0	25
Q9ESW8	PF01470	10	171	2.029691358024692	161	G5B4D0	18	179	1.3325370370370366	161
Q569Z5	PF00270	395	567	7.027306358381502	172	G5BQ18	667	839	7.000161849710978	172
Q569Z5	PF00271	604	713	10.730172727272727	109	G5BQ18	876	985	10.712418181818183	109
Q8BGB2	PF13181	745	776	0.14234375	31	G5C9S6	724	755	0.113	31
Q8BGB2	PF13181	813	843	0.5589032258064516	30	G5C9S6	874	904	0.16048387096774194	30
Q9EP53	PF04388	6	715	3.2507661971830992	709	G5AT38	7	718	3.364435393258424	711
Q6P3A1	PF00836	138	195	0.0	57	G5AXT1	196	253	1.4211034482758618	57
P70371	PF00249	366	413	0.14895833333333333	47	G5B5U0	357	404	0.046250000000000006	47
P70371	PF08558	63	254	2.5529322916666675	191	G5B5U0	75	266	5.311921875	191
P12382	PF00365	29	187	4.6837106918239	158	G5BG13	1	153	4.361836601307188	152
P12382	PF00365	401	683	6.765798586572437	282	G5BG13	321	689	5.254493224932249	368
Q60649	PF07724	345	534	8.805389473684206	189	G5AVU0	397	586	8.347700000000001	189
Q60649	PF10431	543	615	5.6041917808219175	72	G5AVU0	595	667	5.594931506849315	72
Q60649	PF12796	128	195	11.973691176470588	67	G5AVU0	128	195	13.801970588235298	67
Q60649	PF13857	233	275	0.9753720930232559	42	G5AVU0	233	275	0.8285581395348838	42
Q9D0B8	PF05914	4	339	0.044041666666666666	335	G5BAY6	5	359	0.2517937853107344	354
Q8JZV7	PF01979	71	400	4.507545454545458	329	G5AQC8	1	330	4.392818181818181	329
Q9CXB8	PF02816	1028	1214	7.25348128342246	186	G5BME2	883	1069	7.453374331550803	186
Q80U16	PF15903	43	387	2.422115942028983	344	G5BJZ2	9	350	2.3114912280701763	341
P54130	PF00167	61	187	8.466551181102352	126	G5B443	62	188	8.466551181102352	126
Q8VEJ3	PF04706	40	90	2.924960784313725	50	G5BT42	46	95	0.0	49
Q6P3Z3	PF08768	413	565	0.5484575163398696	152	G5C3S1	196	348	0.5262679738562094	152
Q60931	PF01459	2	275	3.635737226277373	273	G5BT43	3	276	3.6331058394160585	273
Q8VHI7	PF14772	29	126	0.7699285714285713	97	G5AU39	27	124	0.25430612244897965	97
Q9Z0K8	PF00795	55	225	5.7204678362573125	170	G5BDB8	2	172	9.394263157894736	170
Q9Z0K8	PF19018	333	483	7.831602649006622	150	G5BDB8	280	430	4.239582781456954	150
Q8CIL4	PF15375	119	238	0.034208333333333334	119	G5BQJ2	127	240	0.07951754385964914	113
Q8JZP2	PF02078	89	188	6.707509999999997	99	G5BPE4	90	189	5.725159999999996	99
Q8JZP2	PF02750	191	393	1.7853940886699506	202	G5BPE4	192	394	3.5501428571428595	202
Q8JZP2	PF10581	0	28	0.0	28	G5BPE4	1	29	0.0	28
Q3U1J4	PF03178	790	1098	11.500993527508097	308	G5AYG6	791	1103	11.294690095846649	312
Q3U1J4	PF10433	74	542	7.058752665245201	468	G5AYG6	75	543	7.100771855010657	468
Q9JIQ3	PF09057	16	236	5.024583710407238	220	G5AWQ6	32	252	6.760068181818181	220
Q5SSW2	PF11919	1756	1842	1.5700574712643682	86	G5B8U9	1761	1847	1.5866162790697675	86
Q5SSW2	PF16507	329	827	5.0617535070140285	498	G5B8U9	327	825	5.757052104208423	498
P56480	PF00006	185	404	7.930222727272732	219	G5BB67	186	405	7.636668181818187	219
P56480	PF02874	62	128	13.100298507462686	66	G5BB67	63	129	11.778179104477616	66
P61407	PF00567	80	132	2.5834150943396224	52	G5BNF9	228	282	3.600309090909092	54
P61407	PF00567	247	378	1.2029166666666675	131	G5BNF9	147	282	1.7897794117647063	135
P61407	PF00567	495	608	0.12164912280701758	113	G5BNF9	399	512	0.05039473684210526	113
P61407	PF00567	772	889	3.680186440677967	117	G5BNF9	677	793	1.4193333333333331	116
P61407	PF00567	989	1104	4.0760689655172415	115	G5BNF9	892	1007	4.9039913793103445	115
P61407	PF00567	1310	1427	1.6609322033898295	117	G5BNF9	1211	1327	3.428273504273504	116
P61407	PF00567	1518	1640	2.5780325203252024	122	G5BNF9	1421	1543	3.347186991869917	122
P70275	PF00047	588	666	11.550215189873414	78	G5B0R8	531	608	11.777935897435894	77
P70275	PF01403	60	497	7.3910205479452085	437	G5B0R8	1	440	7.768199999999998	439
Q920F6	PF02463	3	512	3.3386215686274485	509	G5C7S2	4	466	0.7843974082073437	462
Q920F6	PF06470	513	628	7.176922413793104	115	G5C7S2	467	582	7.0810603448275815	115
Q0GA42	PF00571	498	559	1.095096774193549	61	G5C4U8	209	270	1.034903225806452	61
Q0GA42	PF01595	290	402	7.119876106194688	112	G5C4U8	1	113	8.971230088495583	112
A2AGT5	PF12348	284	460	5.67753107344633	176	G5ATC5	285	461	5.681254237288137	176
A2AGT5	PF12348	865	1041	2.5601807909604517	176	G5ATC5	866	1042	2.4870056497175144	176
A2AGT5	PF12348	1244	1421	10.593224719101123	177	G5ATC5	1245	1422	10.028893258426967	177
Q91VF5	PF01391	316	340	0.0	24	G5APX6	394	417	0.0	23
Q91VF5	PF01391	318	340	0.0	22	G5APX6	396	417	0.0	21
Q91VF5	PF07546	72	100	0.0	28	G5APX6	141	169	0.0	28
Q9WVI9	PF00640	562	695	2.054604477611941	133	G5ATA8	525	658	2.0650970149253727	133
Q9WVI9	PF14604	490	538	0.1986122448979592	48	G5ATA8	453	501	0.2663673469387755	48
Q80ZX8	PF00515	247	278	0.07931250000000001	31	G5ANZ4	247	278	0.04175	31
Q80ZX8	PF00515	641	671	0.08703225806451614	30	G5ANZ4	643	674	1.3111562499999994	31
Q80ZX8	PF13181	280	312	0.0	32	G5ANZ4	280	312	0.03075757575757576	32
Q80ZX8	PF13877	776	868	7.522634408602152	92	G5ANZ4	787	879	9.371741935483874	92
Q6KCD5	PF12765	1787	1828	0.6319285714285714	41	G5BTT2	1794	1835	0.7484047619047621	41
Q6KCD5	PF12830	2268	2448	13.129337016574588	180	G5BTT2	2275	2455	13.139812154696138	180
Q149S1	PF03148	55	437	0.013174934725848566	382	G5BXU1	56	438	0.33278328981723226	382
P97783	PF15017	6	78	2.4468493150684933	72	G5AJY8	7	78	2.5032499999999995	71
P23611	PF00605	8	112	1.811914285714286	104	G5BJG2	9	113	1.811571428571429	104
P23611	PF10401	202	378	8.471293785310728	176	G5BJG2	203	381	8.397430167597765	178
Q9R1K7	PF00091	1	212	3.561330188679244	211	G5C897	2	212	4.397834123222748	210
Q8K045	PF00069	550	806	8.181315175097284	256	G5ASE2	546	802	9.427066147859922	256
Q8K045	PF00433	831	869	0.0	38	G5ASE2	827	865	0.0	38
Q8K045	PF02185	18	74	0.0	56	G5ASE2	15	71	0.0	56
Q8K045	PF02185	100	161	0.017258064516129032	61	G5ASE2	97	158	0.017096774193548388	61
Q8K045	PF02185	173	221	0.018816326530612246	48	G5ASE2	170	217	0.0042291666666666675	47
Q9JKJ9	PF00067	33	418	10.157341968911917	385	G5BNF7	35	420	10.669735751295342	385
P06909	PF00084	25	76	0.08517307692307692	51	G5BM71	7	58	0.0	51
P06909	PF00084	84	140	0.7609649122807017	56	G5BM71	66	122	1.4420175438596488	56
P06909	PF00084	145	204	2.0898	59	G5BM71	127	185	0.5510847457627118	58
P06909	PF00084	209	261	0.0	52	G5BM71	190	242	0.0	52
P06909	PF00084	327	384	0.0	57	G5BM71	308	365	0.3888620689655173	57
P06909	PF00084	405	441	0.4087027027027028	36	G5BM71	387	423	0.0	36
P06909	PF00084	454	504	0.2731372549019608	50	G5BM71	436	486	9.323235294117648	50
P06909	PF00084	568	621	0.0	53	G5BM71	550	604	0.7388545454545454	54
P06909	PF00084	628	682	0.0	54	G5BM71	611	665	0.0	54
P06909	PF00084	689	742	0.025740740740740745	53	G5BM71	672	725	0.22238888888888889	53
P06909	PF00084	807	860	0.20392592592592595	53	G5BM71	792	845	0.34768518518518515	53
P06909	PF00084	866	930	0.2616923076923076	64	G5BM71	851	915	0.0	64
P06909	PF00084	935	988	1.0930555555555554	53	G5BM71	920	973	0.07885185185185185	53
P06909	PF00084	993	1047	0.06129090909090909	54	G5BM71	978	1032	2.5583636363636364	54
P06909	PF00084	1052	1106	0.10863636363636364	54	G5BM71	1037	1091	1.120854545454545	54
P06909	PF00084	1113	1167	0.0	54	G5BM71	1098	1152	0.0	54
Q3UZ18	PF10505	726	935	4.456490476190476	209	G5AWB9	722	931	4.5152714285714275	209
Q8R404	PF15884	24	105	5.344170731707317	81	G5C0Q7	25	105	1.1053580246913577	80
Q8BI17	PF00017	50	125	3.4831578947368413	75	G5AUL2	48	123	1.0336052631578947	75
Q61575	PF00250	275	355	9.26067901234568	80	G5BVH2	275	355	8.74524691358025	80
Q8C7H1	PF03308	97	378	5.247514184397162	281	G5C7E0	176	457	4.5174751773049655	281
Q99LW0	PF12796	67	120	10.728574074074077	53	G5AZ42	40	93	12.879629629629632	53
Q99LW0	PF13637	125	176	2.5139615384615386	51	G5AZ42	98	149	1.8616346153846155	51
Q06219	PF00104	399	577	10.197782122905023	178	G5BQN7	400	578	10.225240223463683	178
Q06219	PF00105	261	329	0.8093333333333332	68	G5BQN7	262	330	0.8123478260869564	68
Q3URQ7	PF01812	8	205	5.660808080808077	197	G5BF18	6	203	4.0497272727272735	197
Q8K5B1	PF00041	414	487	11.972608108108108	73	G5C416	429	502	6.5969729729729725	73
Q8BTZ7	PF00132	258	292	0.0	34	G5BZX1	259	293	0.0	34
Q8BTZ7	PF00483	1	227	6.4051409691629955	226	G5BZX1	2	228	7.7768942731277555	226
Q9Z0F7	PF01387	0	109	8.168299999999999	109	G5ATF6	1	114	10.331719298245613	113
Q8VCZ3	PF05485	4	92	3.2964494382022487	88	G5C034	5	93	3.2958202247191037	88
Q9DBX1	PF15151	26	136	0.0	110	G5BUT9	110	219	0.0	109
Q9Z2G1	PF12796	3	68	0.2325757575757576	65	G5C0R5	4	67	0.5506249999999999	63
Q9Z2G1	PF12796	93	178	0.4971511627906979	85	G5C0R5	52	137	0.6843837209302326	85
Q9Z2G1	PF12796	181	236	1.8498214285714287	55	G5C0R5	140	195	1.859142857142857	55
Q9Z2G1	PF13857	551	604	0.39448148148148143	53	G5C0R5	522	575	1.9291111111111108	53
Q920D3	PF11594	42	142	0.4333960396039603	100	G5APR1	43	143	0.4338712871287127	100
P61939	PF00079	48	414	8.440716621253403	366	G5BKR5	49	418	7.3585027027026975	369
P45952	PF00441	266	413	1.5781283783783775	147	G5AQ85	119	266	1.6455135135135133	147
P45952	PF02770	156	254	10.148383838383836	98	G5AQ85	9	107	10.143909090909087	98
P20612	PF00503	9	338	9.677	329	G5BZY4	10	339	10.356751515151517	329
Q8C4H2	PF00536	2	63	1.2702580645161283	61	G5C770	3	64	2.4038225806451625	61
Q9CR08	PF01868	128	210	9.504096385542164	82	G5BL45	125	207	9.948518072289161	82
Q7TS68	PF01189	227	399	5.558601156069366	172	G5BFD7	228	400	1.7824508670520227	172
Q0ZCJ7	PF02037	165	193	0.0	28	G5BAH8	163	191	0.0	28
Q0II04	PF00880	38	61	0.0	23	G5BTJ9	40	63	0.0	23
Q0II04	PF00880	285	311	0.0	26	G5BTJ9	288	314	0.0	26
Q0II04	PF00880	321	346	0.0	25	G5BTJ9	324	349	0.0	25
Q91YN1	PF13289	142	266	11.190144	124	G5BKI2	169	293	11.127336	124
Q7M760	PF00641	6	32	0.005222222222222222	26	G5C962	7	33	0.010444444444444444	26
Q7M760	PF00641	150	176	0.11566666666666668	26	G5C962	151	177	0.11585185185185184	26
Q7M760	PF02338	437	585	8.190261744966444	148	G5C962	410	558	8.272879194630871	148
Q7M760	PF18418	245	306	11.882822580645161	61	G5C962	246	306	12.082262295081966	60
Q640N3	PF00620	33	181	3.5721275167785227	148	G5BWJ0	34	182	5.0524765100671125	148
Q8BQ33	PF15292	210	1004	1.5017911949685532	794	G5CA95	211	1012	1.3790498753117215	801
Q7TMY4	PF05615	52	138	3.4394827586206898	86	G5AT74	1	87	3.4443103448275867	86
P62509	PF00104	265	439	8.610594285714287	174	G5C8V3	243	417	9.74749714285714	174
P62509	PF00105	126	194	0.2281884057971015	68	G5C8V3	105	173	0.18347826086956529	68
Q8R516	PF00569	85	123	0.0	38	G5ATN9	203	241	0.0	38
Q8R516	PF06701	11	77	3.1998805970149253	66	G5ATN9	129	195	3.1769402985074624	66
Q8R516	PF06701	159	223	1.1710153846153846	64	G5ATN9	277	341	1.159230769230769	64
Q8R516	PF12796	511	576	9.0124696969697	65	G5ATN9	632	697	5.504818181818184	65
Q8R516	PF12796	583	680	3.520010204081633	97	G5ATN9	704	801	0.41193877551020414	97
Q8R516	PF13637	685	728	0.017045454545454544	43	G5ATN9	806	849	0.016772727272727276	43
Q8R516	PF13920	847	889	14.38820930232558	42	G5ATN9	967	1031	1.7136461538461538	64
Q8R516	PF18346	256	321	0.0	65	G5ATN9	371	442	0.0	71
Q8R516	PF18346	327	391	2.351569230769231	64	G5ATN9	448	512	1.0263692307692307	64
Q9EP97	PF02902	393	564	3.0634534883720934	171	G5B5C7	398	569	3.0766918604651163	171
Q08297	PF08423	112	335	6.713160714285714	223	G5BLZ5	110	333	6.704098214285708	223
Q08297	PF14520	31	78	0.0	47	G5BLZ5	32	79	2.194020833333333	47
Q5HZK1	PF15007	4	127	1.7555161290322563	123	G5AKC8	5	128	2.0510322580645157	123
Q8JZP3	PF00651	45	151	2.6091214953271042	106	G5BD35	41	147	2.430196261682243	106
Q8JZP3	PF01344	308	339	10.2126875	31	G5BD35	306	333	8.845678571428572	27
Q8JZP3	PF01344	341	386	21.905	45	G5BD35	335	380	21.9055	45
Q8JZP3	PF01344	388	433	11.072347826086958	45	G5BD35	382	427	11.079782608695657	45
Q8JZP3	PF01344	435	482	17.766208333333335	47	G5BD35	429	476	17.771458333333328	47
Q8JZP3	PF01344	484	529	7.657021739130436	45	G5BD35	478	523	7.663782608695652	45
Q8JZP3	PF01344	532	575	14.592045454545454	43	G5BD35	526	569	14.635750000000002	43
Q8JZP3	PF07707	157	259	4.339912621359224	102	G5BD35	153	257	4.258590476190476	104
Q8BX07	PF03031	101	259	5.2126918238993705	158	G5BEB1	103	261	4.637503144654088	158
Q3UH60	PF00501	360	812	5.715545253863133	452	G5AU00	226	678	5.718481236203092	452
Q3UH60	PF00501	992	1466	7.834216842105267	474	G5AU00	858	1332	7.752479999999998	474
Q6NS60	PF12937	554	591	20.32613157894736	37	G5CBQ3	557	594	17.793631578947362	37
P97440	PF15247	129	198	0.16392857142857142	69	G5BCJ0	122	191	0.1608	69
P00920	PF00194	10	257	6.057209677419357	247	G5ATW7	3	250	5.420129032258066	247
Q9DCN2	PF00175	176	283	8.140953703703703	107	G5BPS3	176	283	2.5066759259259266	107
Q9DCN2	PF00970	44	150	9.867841121495324	106	G5BPS3	44	150	9.88900934579439	106
Q05915	PF01227	63	238	6.5906534090909075	175	G5BF79	54	229	5.8990909090909085	175
A2AS89	PF00491	77	348	3.1100110294117655	271	G5BRT0	60	331	1.5996507352941183	271
Q5HZJ0	PF00035	1259	1329	7.612999999999999	70	G5AJR5	1275	1345	7.6150140845070435	70
Q5HZJ0	PF00636	1142	1230	7.576539325842697	88	G5AJR5	1158	1246	7.5774719101123615	88
Q5HZJ0	PF14622	960	1068	5.4366238532110085	108	G5AJR5	919	1027	5.454311926605506	108
O08807	PF10417	236	263	0.21903571428571428	27	G5BCE5	233	260	0.15260714285714286	27
O08807	PF00578	83	215	6.316037593984968	132	G5BCE5	80	212	6.305135338345869	132
Q9DB16	PF08569	5	332	6.106670731707308	327	G5B9Y8	3	330	6.325890243902433	327
Q7TPM1	PF07001	0	188	0.5146878306878306	188	G5AT53	1	190	0.5171210526315789	189
A2AKG8	PF11229	1209	1797	8.372994906621393	588	G5BBT7	1194	1783	10.429604414261465	589
A2AKG8	PF12530	489	713	3.2734755555555552	224	G5BBT7	472	696	3.2717333333333336	224
Q9ERD6	PF00169	466	574	11.574788990825686	108	G5BIB5	442	550	11.568972477064216	108
Q9ERD6	PF00617	52	218	5.982916167664674	166	G5BIB5	35	201	5.984646706586824	166
O88425	PF00334	12	146	1.7433037037037031	134	G5BTF6	13	133	1.6963553719008269	120
Q9Z1S5	PF00735	58	330	2.925703296703297	272	G5BPR0	58	330	2.915721611721612	272
P56198	PF02017	42	116	9.63828	74	G5BX84	63	137	9.078653333333335	74
P86049	PF00076	62	125	7.580562500000003	63	G5C5K3	63	126	8.554531249999998	63
P86049	PF00076	142	203	1.8125967741935485	61	G5C5K3	143	204	0.4036451612903225	61
P86049	PF00076	237	300	4.005406249999999	63	G5C5K3	238	301	4.472890624999999	63
P86049	PF14709	391	467	5.415077922077923	76	G5C5K3	391	467	5.4357402597402595	76
Q9Z2A0	PF00069	85	332	9.174556451612897	247	G5AQC7	58	305	9.199862903225801	247
Q9Z2A0	PF14593	448	549	0.4087745098039215	101	G5AQC7	421	522	0.4108823529411766	101
Q9D4F8	PF04130	349	654	3.150647058823529	305	G5BM48	421	733	4.393399361022364	312
Q9D4F8	PF17681	1	346	3.3539190751445114	345	G5BM48	84	418	3.448970149253732	334
P37889	PF01821	434	469	0.05363888888888889	35	G5BAI3	430	465	0.09388888888888887	35
P37889	PF07645	708	748	1.272878048780488	40	G5BAI3	733	773	0.2594390243902439	40
P37889	PF07645	755	793	0.016820512820512817	38	G5BAI3	733	772	0.231025	39
P37889	PF07645	800	844	0.0	44	G5BAI3	780	824	0.0	44
P37889	PF07645	846	892	0.016829787234042555	46	G5BAI3	826	872	0.017574468085106383	46
P37889	PF07645	894	929	0.0	35	G5BAI3	956	993	0.0	37
P37889	PF07645	1061	1109	0.0	48	G5BAI3	956	1004	0.0	48
P37889	PF12662	959	982	3.4742083333333333	23	G5BAI3	893	916	0.00475	23
P37889	PF12662	998	1021	0.0095	23	G5BAI3	893	916	0.00475	23
P37889	PF14670	605	633	0.06724137931034482	28	G5BAI3	630	658	0.06724137931034482	28
Q9WTV7	PF13639	544	586	0.08565116279069768	42	G5C985	412	454	0.013139534883720931	42
Q9JIB4	PF04056	63	254	6.82468229166667	191	G5C0I1	64	255	6.085572916666666	191
Q9JIB4	PF07975	345	385	11.050634146341462	40	G5C0I1	345	385	0.8314634146341461	40
Q810B3	PF00046	110	166	0.05063157894736843	56	G5BS01	111	167	0.05063157894736843	56
Q8BM39	PF02840	189	330	4.575718309859153	141	G5C5E6	168	309	4.560302816901409	141
Q8BM39	PF08799	83	110	0.0	27	G5C5E6	62	89	0.0	27
P08113	PF00183	256	771	1.9555232558139537	515	G5AR38	257	771	1.9921359223300967	514
P08113	PF02518	95	253	10.921176100628932	158	G5AR38	96	254	10.921955974842767	158
Q569L8	PF07202	1158	1186	0.10810344827586206	28	G5B1A7	1162	1190	0.10310344827586206	28
Q569L8	PF07202	1226	1259	0.0	33	G5B1A7	1230	1263	0.0	33
Q569L8	PF07202	1263	1296	0.027058823529411764	33	G5B1A7	1267	1300	0.027058823529411764	33
Q569L8	PF07202	1301	1330	0.0	29	G5B1A7	1305	1334	0.0	29
Q9QZ10	PF00191	33	85	8.71767924528302	52	G5BQN3	51	103	2.65788679245283	52
Q9QZ10	PF00191	92	157	0.19357575757575754	65	G5BQN3	110	175	0.23222727272727275	65
Q9QZ10	PF00191	174	240	14.083268656716418	66	G5BQN3	192	258	16.749089552238804	66
Q9QZ10	PF00191	250	315	3.1939848484848485	65	G5BQN3	268	333	2.1187424242424244	65
Q9EP52	PF04668	86	220	3.2825407407407403	134	G5C061	88	222	2.3508444444444447	134
Q99J08	PF00650	78	243	0.5855060240963854	165	G5APU9	231	396	0.5578192771084339	165
Q91WD9	PF13202	253	266	0.9432142857142856	13	G5C0V1	255	268	1.4642142857142857	13
Q91WD9	PF13499	109	176	0.2892205882352942	67	G5C0V1	111	178	0.23944117647058835	67
Q05920	PF00364	1110	1176	0.6071343283582088	66	G5BWZ7	668	734	0.3577761194029852	66
Q05920	PF00682	564	835	1.3329264705882355	271	G5BWZ7	122	393	1.333463235294116	271
Q05920	PF02436	860	1060	0.3435721393034826	200	G5BWZ7	418	618	0.34372139303482585	200
Q05920	PF02785	454	482	0.3589655172413793	28	G5BWZ7	12	40	0.3544137931034482	28
Q9Z1K5	PF01485	254	314	0.18024590163934426	60	G5BHB5	132	192	0.18178688524590167	60
Q9Z1K5	PF01485	335	379	5.284777777777777	44	G5BHB5	213	257	5.300666666666667	44
Q9JHE7	PF15264	90	206	1.863521367521368	116	G5C2E7	10	126	1.9602905982905985	116
P13297	PF00046	172	228	0.9119298245614036	56	G5B312	57	113	0.15182456140350878	56
Q9D8Z1	PF00013	60	118	0.2713389830508474	58	G5C2I4	62	120	0.3771525423728813	58
Q9D8Z1	PF10469	131	354	7.113660714285714	223	G5C2I4	133	356	6.148624999999996	223
P83870	PF03660	0	91	0.0	91	G5BJG6	1	87	0.0	86
O35491	PF00069	161	477	3.0537854889589906	316	G5BDF8	163	479	3.016419558359621	316
P70406	PF00153	12	108	3.291814432989689	96	G5AS97	13	109	3.300134020618556	96
P70406	PF00153	115	206	4.0137717391304335	91	G5AS97	116	207	4.0139456521739145	91
P70406	PF00153	215	298	10.459321428571426	83	G5AS97	216	299	10.622321428571428	83
O35350	PF00648	55	351	3.807700336700342	296	G5B6L3	56	352	3.8209730639730664	296
O35350	PF01067	372	512	4.967319148936171	140	G5B6L3	373	522	4.674346666666667	149
O35350	PF13833	556	612	1.847438596491228	56	G5B6L3	573	629	1.7731929824561399	56
Q8C2K1	PF00169	216	311	0.17741666666666664	95	G5BCF0	217	312	0.25446875	95
Q6ZQ73	PF08623	1043	1203	3.5975403726708066	160	G5BYD7	953	1113	5.807111801242236	160
Q99JP4	PF10471	0	54	0.0	54	G5BWQ6	1	55	0.0	54
Q3U308	PF10288	346	469	0.18641935483870967	123	G5C2U1	348	472	0.9988	124
Q8C7D2	PF03226	322	435	1.8588596491228075	113	G5BKR9	320	433	1.9052105263157897	113
Q8C7D2	PF02190	82	319	5.505836134453782	237	G5BKR9	80	317	5.197949579831933	237
Q91WA4	PF02008	251	290	0.0	39	G5BCQ3	255	294	0.0	39
Q8CB14	PF15792	160	223	0.34240625	63	G5B2E0	158	218	0.02327868852459016	60
Q8CB14	PF15792	332	386	1.0591636363636363	54	G5B2E0	330	384	1.060218181818182	54
Q6PB66	PF01535	749	777	6.5906551724137925	28	G5AL84	189	217	0.7479655172413793	28
Q6PB66	PF17177	233	292	11.144733333333333	59	G5AL84	189	250	7.328225806451613	61
P40336	PF03643	7	282	6.1966304347826116	275	G5B862	8	286	6.052401433691758	278
Q9D3S9	PF00450	118	442	9.519710769230773	324	G5C2A9	1	324	7.567243827160488	323
Q924X2	PF00755	172	760	3.2690203735144303	588	G5B2G0	173	761	3.9969660441426162	588
Q924X2	PF16484	0	46	6.555	46	G5B2G0	1	47	6.5439148936170195	46
Q8BH97	PF13202	124	139	0.0	15	G5B8P5	125	140	0.0	15
Q8BH97	PF13202	206	224	0.0	18	G5B8P5	207	225	0.0	18
O35927	PF00514	578	616	0.7418974358974361	38	G5BI17	473	511	0.7432051282051283	38
O35927	PF00514	621	662	12.600619047619045	41	G5BI17	516	557	6.394809523809522	41
O35927	PF00514	831	871	5.524390243902439	40	G5BI17	849	889	5.529512195121951	40
O35927	PF00514	906	941	15.015194444444445	35	G5BI17	924	959	15.021166666666668	35
Q99JW1	PF12146	109	215	4.685130841121493	106	G5BBB2	110	216	4.5122710280373814	106
I7HJS4	PF00096	300	322	0.0	22	G5AUR5	216	238	0.0	22
I7HJS4	PF00096	328	350	0.0	22	G5AUR5	244	266	0.0	22
I7HJS4	PF00096	356	378	0.0	22	G5AUR5	272	294	0.05586956521739131	22
Q8BVF2	PF02114	37	180	7.214138888888888	143	G5B792	38	181	7.911152777777778	143
Q4KML4	PF14705	2	78	5.887753246753249	76	G5AUD5	3	79	3.403194805194805	76
Q3U3T8	PF00400	101	140	0.5888000000000001	39	G5BK12	102	141	0.6134750000000002	39
Q3U3T8	PF00400	362	386	9.78904	24	G5BK12	358	382	7.393039999999997	24
Q3U3T8	PF00400	406	440	1.2749142857142854	34	G5BK12	402	436	0.5882571428571429	34
Q3U3T8	PF12894	642	723	1.8362682926829248	81	G5BK12	640	721	1.5832804878048778	81
Q99P27	PF06951	19	194	2.7020227272727277	175	G5C2H6	20	195	2.5783599999999995	175
O35207	PF09806	22	112	0.7886483516483516	90	G5AWS5	8	98	0.7945164835164835	90
Q6NZG4	PF08646	9	92	15.199273809523811	83	G5BWT6	10	93	13.103035714285722	83
P22935	PF00061	23	137	0.5471304347826087	114	G5AR81	82	196	0.5400701754385966	114
Q8QZR5	PF00155	85	483	3.2118370927318285	398	G5C5R8	86	484	2.7516315789473698	398
Q99LQ4	PF15674	3	65	0.1130952380952381	62	G5AQH9	4	66	0.11491935483870967	62
Q8R5H6	PF02205	494	519	0.0	25	G5BGD8	495	520	0.0	25
Q8QZS3	PF11704	104	264	13.574826086956525	160	G5C331	107	267	13.558944099378884	160
Q8QZS3	PF16692	345	565	2.7334298642533947	220	G5C331	348	568	2.166515837104072	220
Q09XV5	PF00176	826	1102	1.7300974729241874	276	G5BFV2	690	966	1.4719314079422374	276
Q09XV5	PF00271	1135	1248	6.598508771929825	113	G5BFV2	999	1112	6.603842105263156	113
Q09XV5	PF00385	644	704	0.3770163934426229	60	G5BFV2	508	568	0.3549344262295083	60
Q09XV5	PF00385	726	778	11.130830188679244	52	G5BFV2	590	642	11.131056603773585	52
Q09XV5	PF07533	2310	2353	0.02943181818181818	43	G5BFV2	2182	2225	0.2606363636363636	43
Q2YDW7	PF00856	223	333	6.416747747747746	110	G5AWS6	183	293	6.409909909909909	110
Q61045	PF00010	5	50	0.0	45	G5BH57	6	51	0.0	45
Q61045	PF00989	80	141	9.298387096774192	61	G5BH57	81	142	9.29998387096774	61
Q61045	PF06621	358	667	0.07680967741935485	309	G5BH57	347	657	0.08602572347266879	310
Q61045	PF08447	242	328	15.2343908045977	86	G5BH57	231	317	15.977862068965516	86
Q3UUJ4	PF00069	68	378	7.317408360128615	310	G5BDJ4	69	379	7.316221864951774	310
Q61410	PF00027	191	267	7.169844155844157	76	G5AME9	192	268	7.152376623376624	76
Q61410	PF00027	304	389	10.456965116279068	85	G5AME9	305	390	10.452116279069767	85
Q61410	PF00069	454	710	9.213237354085605	256	G5AME9	455	711	7.554560311284042	256
Q9JI20	PF00035	134	186	9.328132075471697	52	G5B8U3	195	247	9.335471698113206	52
Q9JI20	PF00035	294	344	13.040254901960793	50	G5B8U3	355	405	13.052470588235293	50
Q9JI20	PF02137	414	734	2.3110685358255445	320	G5B8U3	475	795	3.243551401869161	320
P62305	PF01423	23	87	6.218061538461543	64	G5BML6	24	88	4.510276923076926	64
O35657	PF13088	81	371	6.77240206185567	290	G5C3G7	118	408	6.836628865979383	290
Q80Y24	PF00412	129	188	13.495999999999999	59	G5B0Q5	130	189	13.3559	59
Q80Y24	PF00412	194	248	0.01718181818181818	54	G5B0Q5	195	249	0.016909090909090912	54
Q80Y24	PF00412	254	307	0.0	53	G5B0Q5	255	308	0.0	53
Q80Y24	PF06297	34	118	0.0	84	G5B0Q5	35	119	0.0	84
O55055	PF00145	4	386	4.77674673629243	382	G5BFE5	5	395	1.830611253196932	390
Q64337	PF16577	390	440	0.0	50	G5C7B1	288	337	0.0	49
Q64337	PF00564	84	99	4.8496875	15	G5C7B1	2	17	4.3399375	15
Q64337	PF00569	122	162	0.0	40	G5C7B1	40	80	0.0	40
P00688	PF00128	81	324	3.456745901639344	243	G5BKY2	82	325	3.6449549180327874	243
P00688	PF02806	421	503	4.209686746987951	82	G5BKY2	422	504	4.176457831325301	82
Q8BGG7	PF00300	424	586	3.1247791411042947	162	G5BRZ8	382	544	3.1341717791411035	162
Q8BGG7	PF00627	43	61	0.0	18	G5BRZ8	1	19	0.0	18
Q8BGG7	PF14604	249	303	0.2007636363636364	54	G5BRZ8	207	261	0.1848545454545455	54
Q9JMB7	PF02171	555	847	8.783365187713308	292	G5AWP4	556	848	8.267290102389076	292
Q9JMB7	PF02170	280	412	5.4575488721804515	132	G5AWP4	281	413	5.361127819548872	132
Q9JMB7	PF05831	0	106	0.026074766355140184	106	G5AWP4	1	107	0.0	106
Q9JMB7	PF08699	227	273	0.5265106382978725	46	G5AWP4	228	274	0.5265106382978725	46
Q9DCQ2	PF01958	175	263	7.1141348314606745	88	G5B8T0	165	253	5.947494382022473	88
Q9DCQ2	PF03447	16	126	5.128036036036035	110	G5B8T0	6	116	4.633513513513512	110
P56382	PF04627	2	47	0.0	45	G5AKZ7	3	48	0.0	45
Q9WTR2	PF00069	653	906	1.8414645669291327	253	G5AUT4	650	868	2.605689497716896	218
Q9WTR2	PF13281	129	507	6.704622691292876	378	G5AUT4	125	503	6.58972031662269	378
Q9WTR2	PF19039	523	619	11.091	96	G5AUT4	520	615	7.600770833333333	95
Q8K3A2	PF01885	20	197	2.200865168539327	177	G5B6F4	26	203	2.0519662921348325	177
Q8CFK2	PF00382	92	160	21.433391304347825	68	G5AWJ7	54	122	29.012608695652165	68
Q8CFK2	PF00382	186	259	7.814864864864863	73	G5AWJ7	148	221	7.829932432432432	73
Q8CFK2	PF07741	448	545	0.06837755102040816	97	G5AWJ7	411	508	0.06238775510204082	97
Q3UPR9	PF19028	74	121	0.0	47	G5B5T9	35	82	0.0	47
Q8BID8	PF12937	9	45	15.841837837837842	36	G5C5Q0	10	46	15.842594594594596	36
Q8BID8	PF13516	117	134	0.0	17	G5C5Q0	118	135	0.0	17
Q8BID8	PF13516	168	190	0.023260869565217397	22	G5C5Q0	169	191	0.0	22
Q8BID8	PF13516	230	249	0.1059	19	G5C5Q0	230	249	0.1065	19
Q8BID8	PF13516	253	274	0.0	21	G5C5Q0	253	274	0.0	21
Q8BID8	PF13516	330	351	0.0	21	G5C5Q0	330	351	0.0	21
Q9D2E2	PF00642	298	320	0.1729565217391304	22	G5ARU0	299	321	0.030782608695652174	22
Q9D2E2	PF04857	40	165	8.40306349206349	125	G5ARU0	42	167	8.193992063492063	125
Q9D2E2	PF04857	169	291	6.2178617886178875	122	G5ARU0	171	292	4.6706721311475405	121
Q9CWS1	PF00622	297	404	8.839555555555558	107	G5BVM3	257	363	9.753485981308412	106
Q9Z1W9	PF00069	81	348	8.951522388059711	267	G5C5J5	25	358	8.604443113772454	333
Q9Z1W9	PF12202	462	519	11.059034482758618	57	G5C5J5	462	496	1.4132285714285713	34
Q8VE95	PF14956	33	207	7.4642914285714275	174	G5C5R3	23	194	7.604279069767438	171
Q99NE5	PF00168	592	701	3.717499999999999	109	G5ALU1	515	624	3.6947272727272713	109
Q99NE5	PF00168	1321	1428	10.745481481481486	107	G5ALU1	1205	1312	10.7385	107
Q99NE5	PF00595	440	521	0.7350121951219512	81	G5ALU1	363	444	0.7336219512195121	81
Q99NE5	PF02318	118	202	6.951388235294122	84	G5ALU1	41	121	3.57658024691358	80
Q66JX5	PF09398	53	133	10.287234567901232	80	G5BEN8	54	134	10.292851851851854	80
Q9CX00	PF03398	12	175	1.6531463414634144	163	G5BNT8	13	176	1.6527134146341464	163
Q52KB6	PF00168	808	889	1.6490121951219514	81	G5AS95	803	884	3.786658536585368	81
Q52KB6	PF00168	1182	1324	6.2750909090909115	142	G5AS95	1177	1289	2.0931415929203534	112
Q52KB6	PF00168	1621	1726	5.6027830188679255	105	G5AS95	1587	1692	4.9348207547169824	105
Q3HNM7	PF16748	69	114	0.15058695652173912	45	G5BUD7	71	116	0.15039130434782605	45
Q9D112	PF15021	16	203	0.7958085106382977	187	G5BY76	1	190	2.2698473684210523	189
Q9JHS3	PF03259	7	93	5.983827586206898	86	G5ARA4	8	94	6.3330574712643655	86
P05063	PF00274	14	362	4.5582664756446984	348	G5BVH5	15	364	4.6997421203438385	349
Q9QYE3	PF00096	378	398	0.028809523809523813	20	G5C201	379	399	0.028809523809523813	20
Q9QYE3	PF00096	404	426	0.0	22	G5C201	405	427	0.0	22
Q9DBB1	PF00581	19	140	2.78327868852459	121	G5BSI5	20	141	3.1910000000000003	121
Q9DBB1	PF00782	213	344	6.481166666666668	131	G5BSI5	214	345	6.3605530303030315	131
Q3V0G7	PF00780	515	820	6.179222222222222	305	G5BLH5	493	796	5.942486842105263	303
Q3V0G7	PF02145	242	421	7.5886	179	G5BLH5	220	399	7.369477777777778	179
Q8BU25	PF00008	238	269	0.0	31	G5B138	238	269	0.0	31
Q8BU25	PF00084	303	341	13.656435897435902	38	G5B138	303	341	13.324410256410255	38
Q8BU25	PF00084	398	441	0.0	43	G5B138	398	441	0.0	43
Q8BU25	PF00089	459	714	7.126195312499995	255	G5B138	459	714	5.671937499999998	255
Q8BU25	PF00431	127	232	0.689254716981132	105	G5B138	127	232	6.297867924528301	105
P35980	PF17135	1	187	3.1024010695187183	186	G5B890	2	188	3.1593602150537627	186
Q8VCX5	PF13202	227	247	1.7052380952380957	20	G5C2H9	228	248	1.3145238095238096	20
Q8VCX5	PF13833	396	440	13.96262222222222	44	G5C2H9	400	444	13.96124444444444	44
Q8CHB8	PF03133	115	394	7.547982142857144	279	G5B692	91	370	7.882167857142857	279
Q9D119	PF12796	55	122	0.7278235294117646	67	G5BJ76	56	123	0.7310882352941178	67
Q8CDF7	PF01612	147	248	9.563235294117648	101	G5BM09	55	148	7.532308510638296	93
Q3THS6	PF00438	17	114	4.5596326530612235	97	G5BU79	18	115	4.488081632653062	97
Q3THS6	PF02772	129	249	6.4688181818181825	120	G5BU79	130	250	6.483752066115702	120
Q3THS6	PF02773	251	387	3.600642335766424	136	G5BU79	252	388	3.600642335766424	136
O55033	PF00017	284	358	0.5279066666666665	74	G5CB80	282	356	0.6631999999999998	74
O55033	PF00018	7	52	4.167782608695651	45	G5CB80	8	53	2.169130434782609	45
O55033	PF00018	202	248	0.02725531914893617	46	G5CB80	200	246	0.07440425531914892	46
O55033	PF14604	117	164	5.358	47	G5CB80	117	164	4.9204374999999985	47
P97457	PF13405	28	54	7.113185185185188	26	G5BYL9	30	56	7.155222222222222	26
P15656	PF00167	84	213	4.5225	129	G5AWK7	88	217	4.1318230769230775	129
Q99KJ8	PF04912	15	399	0.05842337662337663	384	G5BED0	16	400	0.3256831168831169	384
P00375	PF00186	4	184	4.210872928176796	180	G5BK75	5	185	5.233348066298343	180
Q3UWW6	PF00307	51	168	9.390737288135591	117	G5BBI5	85	202	5.856762711864405	117
Q3UWW6	PF02187	214	282	0.2690144927536232	68	G5BBI5	248	316	0.4819275362318841	68
Q02788	PF00092	60	233	7.829988505747128	173	G5C7V8	48	220	7.0224566473988475	172
Q02788	PF00092	629	804	10.961051136363627	175	G5C7V8	616	791	10.91347727272727	175
Q02788	PF00092	847	1021	6.354137142857143	174	G5C7V8	834	1008	6.919057142857143	174
Q02788	PF01391	270	327	0.0	57	G5C7V8	257	314	0.0	57
Q02788	PF01391	324	381	0.0	57	G5C7V8	311	368	0.0	57
Q02788	PF01391	366	423	0.0	57	G5C7V8	353	409	0.0	56
Q02788	PF01391	433	481	0.0	48	G5C7V8	420	468	0.0	48
Q02788	PF01391	555	595	0.0	40	G5C7V8	542	581	0.0	39
Q6PAR5	PF00616	309	351	10.061511627906977	42	G5B6V6	366	408	3.6592325581395353	42
Q6PAR5	PF02204	1353	1454	11.738499999999993	101	G5B6V6	1484	1585	11.104039215686269	101
Q6PAR5	PF18151	1242	1305	5.462999999999999	63	G5B6V6	1307	1370	1.7087656249999996	63
Q8R4E6	PF04845	59	323	0.8966679245283017	264	G5C9Z0	65	329	0.9055018867924534	264
Q3UNU4	PF15039	0	96	5.934865979381443	96	G5AZS2	1	96	3.5683437500000013	95
B2RRE7	PF02338	52	121	1.539157142857143	69	G5C7E4	1	70	0.5046142857142858	69
Q00PI9	PF00622	291	413	0.35891869918699193	122	G5AYI8	153	275	0.3845121951219512	122
Q00PI9	PF02037	15	25	0.0	10	G5AYI8	523	532	0.0	9
Q00PI9	PF13671	451	596	4.4810479452054786	145	G5AYI8	313	458	4.086102739726028	145
Q5NCC3	PF00622	484	619	1.7956250000000005	135	G5B7J8	487	606	1.990699999999998	119
Q5NCC3	PF00643	222	262	4.011268292682926	40	G5B7J8	225	265	4.001219512195123	40
Q5NCC3	PF13765	432	480	0.0	48	G5B7J8	435	483	0.0	48
Q5NCC3	PF15227	19	53	1.6111142857142855	34	G5B7J8	20	54	1.5513428571428571	34
Q9CQ65	PF01048	18	179	3.8539135802469127	161	G5BU32	32	192	2.3603975155279513	160
Q8BTT6	PF06862	291	766	5.9681953781512584	475	G5BAM6	270	745	5.37466176470588	475
Q8VCM7	PF00147	176	412	5.573291139240505	236	G5BML1	184	420	4.863814345991561	236
Q8VCM7	PF08702	29	170	0.37911267605633797	141	G5BML1	31	172	0.0569225352112676	141
Q5SSH7	PF00569	1778	1809	0.0196875	31	G5B927	1691	1722	0.02625	31
Q5SSH7	PF00569	1825	1866	0.017	41	G5B927	1738	1779	0.017	41
Q5SSH7	PF03256	245	379	3.9592888888888913	134	G5B927	129	263	3.951896296296296	134
Q9D8U8	PF00787	56	168	2.932495575221238	112	G5CBA4	41	153	2.932654867256637	112
Q9D8U8	PF09325	179	390	1.0927075471698118	211	G5CBA4	164	375	1.4330754716981122	211
O70546	PF02373	1132	1240	1.3889816513761466	108	G5BKE2	1131	1239	1.3751559633027528	108
O70546	PF13181	206	234	0.0	28	G5BKE2	203	231	0.0	28
O70546	PF13432	108	162	20.102018181818192	54	G5BKE2	105	159	20.100090909090927	54
Q6ZPI0	PF10513	40	180	0.6711560283687943	140	G5B439	40	180	0.6577163120567376	140
Q6ZPI0	PF13831	218	251	0.057735294117647065	33	G5B439	218	251	0.057735294117647065	33
Q6ZPI0	PF13832	257	368	2.520696428571429	111	G5B439	257	368	2.434901785714286	111
O35711	PF00536	562	623	7.785419354838713	61	G5B7C6	556	617	12.002064516129034	61
O35711	PF00536	639	695	6.4663508771929825	56	G5B7C6	633	689	6.473824561403508	56
O35711	PF07647	720	789	1.8422571428571437	69	G5B7C6	714	783	1.8578142857142856	69
Q91W78	PF09749	45	264	2.4106954545454538	219	G5AUG0	46	265	2.347222727272728	219
Q8BYG9	PF00041	463	532	0.5701571428571429	69	G5C6H5	347	416	0.5002857142857142	69
Q8BYG9	PF01404	36	210	3.030274285714286	174	G5C6H5	37	211	3.940388571428571	174
Q8BYG9	PF07647	931	993	0.0584920634920635	62	G5C6H5	892	954	0.15430158730158725	62
Q8BYG9	PF07714	644	898	2.3418666666666663	254	G5C6H5	602	859	2.339697674418605	257
Q8BYG9	PF14575	569	640	14.663305555555565	71	G5C6H5	453	556	13.252923076923087	103
Q9CWT6	PF00270	151	336	2.7980537634408598	185	G5C685	149	334	1.7434462365591399	185
Q9CWT6	PF00271	376	491	6.965862068965517	115	G5C685	374	489	7.429637931034484	115
Q3ZT31	PF00615	287	399	2.0969026548672574	112	G5B2W7	306	418	9.683486725663716	112
Q3ZT31	PF00787	543	622	3.0601249999999998	79	G5B2W7	562	603	5.654880952380951	41
Q3ZT31	PF02194	4	82	9.003582278481012	78	G5B2W7	55	132	15.710461538461539	77
Q3ZT31	PF08628	700	805	13.60433018867924	105	G5B2W7	681	786	15.414084905660381	105
Q04857	PF00092	35	218	4.859891304347825	183	G5ATA7	37	220	7.293331521739131	183
Q04857	PF00092	613	773	11.889577639751554	160	G5ATA7	621	781	10.11729813664596	160
Q04857	PF00092	825	1008	5.6494728260869564	183	G5ATA7	834	1017	6.261565217391301	183
Q04857	PF01391	255	310	0.0	55	G5ATA7	257	312	0.0	55
Q04857	PF01391	303	359	0.0	56	G5ATA7	305	361	0.0	56
Q04857	PF01391	363	419	0.0	56	G5ATA7	365	421	0.0	56
Q04857	PF01391	456	510	0.0	54	G5ATA7	464	518	0.0	54
Q04857	PF01391	502	555	0.0	53	G5ATA7	510	563	0.0	53
Q5SXA9	PF00397	7	36	0.1663666666666667	29	G5BP46	8	37	0.10119999999999997	29
Q5SXA9	PF00168	697	783	2.625252873563217	86	G5BP46	697	783	0.6861494252873565	86
Q8BFY7	PF07326	0	220	0.0	220	G5BW87	1	225	0.0809511111111111	224
Q9D1P2	PF01853	234	411	11.917056179775285	177	G5BYC4	171	348	11.922247191011238	177
Q9D1P2	PF11717	70	109	6.882575	39	G5BYC4	7	46	6.875324999999999	39
Q9D1P2	PF17772	175	229	0.04872727272727273	54	G5BYC4	112	166	0.04872727272727273	54
Q61234	PF00595	81	159	1.9667721518987344	78	G5BPU9	88	166	2.3159113924050634	78
Q61234	PF18012	202	259	0.0	57	G5BPU9	209	266	0.0	57
Q61234	PF00169	291	396	3.66177358490566	105	G5BPU9	298	399	2.0192450980392156	101
Q8BT07	PF12180	171	203	1.532848484848485	32	G5BE81	162	194	1.7337272727272723	32
Q9D6T1	PF00091	69	217	4.458798657718117	148	G5AUB6	1	149	3.557583892617451	148
Q9D6T1	PF03953	293	365	10.79076712328767	72	G5AUB6	225	296	6.113478873239436	71
Q91WD1	PF05132	263	388	0.7870158730158733	125	G5B9Q2	261	386	0.7783809523809524	125
Q71LX4	PF00373	207	315	5.88726605504587	108	G5AWB5	208	316	6.7790733944954145	108
Q71LX4	PF01608	663	764	2.552735294117648	101	G5AWB5	663	764	2.5503039215686285	101
Q71LX4	PF01608	1470	1556	2.4815632183908045	86	G5AWB5	1509	1595	2.4794712643678163	86
Q71LX4	PF01608	2296	2374	0.4339620253164557	78	G5AWB5	2544	2637	0.5605531914893619	93
Q71LX4	PF08913	1800	1823	4.339833333333334	23	G5AWB5	1930	1953	4.1607916666666656	23
Q71LX4	PF08913	1823	1884	11.091467741935485	61	G5AWB5	1993	2054	10.925322580645163	61
Q71LX4	PF09141	494	655	1.4121975308641972	161	G5AWB5	494	655	1.4178271604938262	161
Q71LX4	PF16511	3	84	0.15443902439024387	81	G5AWB5	4	85	0.13728048780487806	81
Q8K3A0	PF07743	156	227	0.012083333333333331	71	G5APY5	158	229	0.03034722222222223	71
Q8K3A0	PF18256	37	63	0.0	26	G5APY5	39	65	0.0	26
Q8R001	PF00307	82	157	1.1446052631578951	75	G5C289	1	76	1.184421052631579	75
Q8R001	PF03271	260	297	0.033236842105263155	37	G5C289	179	216	0.036236842105263165	37
Q60575	PF00169	1702	1795	7.94101063829787	93	G5C531	1703	1796	7.905436170212765	93
Q60575	PF00225	10	353	5.162616279069766	343	G5C531	11	354	5.162924418604653	343
Q60575	PF00498	557	626	2.9819714285714287	69	G5C531	558	627	2.9607142857142854	69
Q60575	PF12423	844	891	0.0	47	G5C531	845	892	0.0	47
Q60575	PF12473	1265	1411	10.97894557823129	146	G5C531	1266	1412	11.01667346938776	146
Q60575	PF16183	357	554	2.3840404040404035	197	G5C531	358	555	2.3596313131313127	197
Q04841	PF02245	108	303	8.684780612244897	195	G5BXY7	190	384	7.070215384615384	194
Q8CIE0	PF00079	55	420	6.6504535519125705	365	G5B495	61	426	7.1304972677595595	365
Q921I2	PF07646	295	342	8.251916666666666	47	G5BF23	176	223	1.0947708333333332	47
Q921I2	PF13418	74	116	7.805720930232557	42	G5BF23	66	108	9.004069767441859	42
Q921I2	PF13854	173	215	8.986837209302328	42	G5BF23	54	96	8.967790697674417	42
Q921I2	PF13964	122	168	3.3729148936170215	46	G5BF23	3	49	3.5890638297872344	46
Q9JLZ6	PF00096	536	558	0.0	22	G5BKG9	517	539	0.0	22
Q9JLZ6	PF00096	564	586	0.0	22	G5BKG9	545	567	0.0	22
Q9JLZ6	PF00096	592	614	0.0	22	G5BKG9	573	595	0.0	22
Q9JLZ6	PF00651	39	140	6.086480392156863	101	G5BKG9	22	123	6.017627450980392	101
Q9JLZ6	PF13894	508	530	0.0	22	G5BKG9	489	511	0.0	22
Q62264	PF07084	0	147	5.9102837837837825	147	G5AW67	1	161	5.5718260869565235	160
Q6PEV3	PF02205	36	59	0.0	23	G5BRV8	33	56	0.0	23
P52825	PF00755	48	646	2.8612921535893188	598	G5C9K6	49	647	3.166492487479133	598
Q9CYA0	PF07645	227	261	0.0	34	G5B2J1	282	316	0.0	34
Q9CYA0	PF07645	287	327	0.6209512195121951	40	G5B2J1	342	382	0.5827560975609756	40
Q9CYA0	PF11938	28	83	0.0	55	G5B2J1	35	90	0.0	55
P55264	PF00294	43	246	7.968171568627449	203	G5C7I5	24	226	5.242920792079207	202
O08584	PF00096	199	223	0.0	24	G5AUV5	175	199	0.0	24
O08584	PF00096	229	253	0.0	24	G5AUV5	205	229	0.0	24
O08584	PF00096	259	281	0.0	22	G5AUV5	235	257	0.0	22
Q9ES28	PF16614	613	710	0.566173469387755	97	G5AZ41	632	729	0.5511836734693878	97
Q9ES28	PF07653	167	218	0.04709615384615385	51	G5AZ41	186	237	0.041923076923076924	51
Q9ES28	PF00169	473	555	4.557891566265057	82	G5AZ41	492	574	4.311361445783131	82
Q9ES28	PF00307	3	109	8.738299065420563	106	G5AZ41	4	128	7.992848000000002	124
Q9ES28	PF00621	253	426	4.4846551724137935	173	G5AZ41	272	445	4.3842068965517225	173
Q9ES28	PF16615	116	161	0.0	45	G5AZ41	135	180	0.0	45
P48281	PF00104	223	395	10.624832369942196	172	G5BWD3	224	396	10.655624277456642	172
P48281	PF00105	22	90	0.015507246376811596	68	G5BWD3	23	91	0.012405797101449276	68
Q9WTN0	PF00348	9	249	6.5737593360995845	240	G5AKC4	10	250	7.238576763485475	240
Q8BG40	PF13925	495	653	4.442981132075469	158	G5AUF5	481	637	2.7001910828025437	156
Q8BG40	PF00400	12	48	0.5795405405405405	36	G5AUF5	1	37	0.5857567567567571	36
Q8BG40	PF00400	53	90	0.1938684210526316	37	G5AUF5	42	79	0.1944210526315789	37
Q8BG40	PF00400	96	132	0.0	36	G5AUF5	85	121	0.0	36
Q8BG40	PF00400	138	174	0.054351351351351364	36	G5AUF5	127	163	0.054351351351351364	36
Q8BG40	PF00400	179	216	0.08807894736842105	37	G5AUF5	168	205	0.09510526315789476	37
A2ACG1	PF07534	61	196	6.780551470588233	135	G5B829	81	216	5.4948161764705885	135
Q9DC69	PF05368	56	187	6.139515151515149	131	G5ARZ9	57	188	5.461136363636364	131
Q07643	PF01391	43	79	0.0	36	G5CBJ1	44	80	0.0	36
Q07643	PF01391	58	100	0.0	42	G5CBJ1	59	100	0.0	41
Q07643	PF01391	114	160	0.0	46	G5CBJ1	248	294	0.0	46
Q07643	PF01391	177	233	0.0	56	G5CBJ1	189	245	0.0	56
Q07643	PF01391	458	515	0.0	57	G5CBJ1	470	527	0.0	57
Q07643	PF01391	562	606	1.073177777777778	44	G5CBJ1	574	618	1.0730666666666666	44
Q9JM55	PF07145	128	143	0.0	15	G5BVD2	129	144	0.0	15
Q9JM55	PF07145	249	264	0.101875	15	G5BVD2	250	265	0.101875	15
Q9JM55	PF07742	0	110	7.9503153153153105	110	G5BVD2	1	111	7.775288288288291	110
Q6PFQ7	PF00168	5	79	6.737253333333333	74	G5AXA3	6	79	4.523135135135135	73
Q6PFQ7	PF00168	133	233	0.03534653465346535	100	G5AXA3	191	291	0.5086732673267327	100
Q6PFQ7	PF00169	566	670	2.1419333333333337	104	G5AXA3	624	728	1.1597809523809524	104
Q6PFQ7	PF00616	321	509	7.005576719576718	188	G5AXA3	379	567	4.813693121693119	188
Q6PFQ7	PF00779	679	708	0.0	29	G5AXA3	737	766	0.0	29
Q8C4X1	PF09415	8	75	13.70441176470588	67	G5BJ89	10	76	13.312417910447762	66
D3YWP0	PF10294	37	194	4.49234810126582	157	G5BEB4	38	195	4.345537974683547	157
Q8VIL2	PF05773	2	110	7.138954128440367	108	G5AW34	3	111	7.739733944954126	108
Q91YJ3	PF01878	55	218	0.18308536585365856	163	G5B2N7	56	219	1.6729451219512197	163
Q9WVJ9	PF07645	53	80	0.0	27	G5B6I8	54	81	0.0	27
Q9WVJ9	PF07645	122	158	0.0	36	G5B6I8	123	159	0.0	36
Q9WVJ9	PF07645	282	326	0.0	44	G5B6I8	283	327	0.0	44
Q9WVJ9	PF12662	182	205	0.0	23	G5B6I8	183	206	0.0	23
Q9WVJ9	PF12662	223	245	0.056217391304347816	22	G5B6I8	224	246	0.031217391304347825	22
P0DJE0	PF09803	9	70	9.676935483870963	61	G5B7I1	1	62	12.908951612903225	61
Q5S003	PF14874	2172	2271	1.3835500000000005	99	G5B2R8	2040	2139	0.9258400000000002	99
Q9D9V7	PF08616	250	355	5.664641509433963	105	G5B2H7	194	299	4.092462264150943	105
Q9D9V7	PF09794	57	178	5.222073770491802	121	G5B2H7	1	122	4.807122950819669	121
P19324	PF00079	45	407	7.356597796143252	362	G5AS72	47	409	7.814944903581266	362
Q9JL26	PF02181	627	992	2.7690655737704906	365	G5BIY9	512	903	3.5313061224489783	391
Q9JL26	PF06367	282	406	11.049216000000005	124	G5BIY9	307	430	9.20090322580645	123
Q9JL26	PF06371	40	155	0.208948275862069	115	G5BIY9	65	180	0.2569396551724137	115
Q9JL26	PF06371	221	279	13.87866101694915	58	G5BIY9	246	304	15.158491525423727	58
Q61127	PF04904	36	112	2.9105454545454537	76	G5BB57	36	112	2.9102077922077925	76
Q61127	PF04905	236	363	0.322359375	127	G5BB57	236	363	0.269546875	127
P12388	PF00079	56	414	4.871005571030639	358	G5B600	1	359	4.136108938547483	358
Q61702	PF00092	288	469	6.429703296703298	181	G5BUN2	291	472	5.572675824175824	181
Q61702	PF06668	701	886	7.232559139784949	185	G5BUN2	707	892	4.471688172043012	185
Q61702	PF08487	49	160	1.3653482142857138	111	G5BUN2	52	163	1.9084642857142848	111
Q8CFQ3	PF13086	801	1109	3.5163365695792868	308	G5BZS3	802	1106	3.549291803278686	304
Q8CFQ3	PF13087	1118	1308	11.799895287958114	190	G5BZS3	1115	1305	11.805450261780102	190
Q8CFQ3	PF16399	19	801	4.143164750957856	782	G5BZS3	20	802	4.122934865900383	782
Q8K0P3	PF07534	265	409	5.764282758620691	144	G5BJF0	281	425	3.9184758620689655	144
O55125	PF07978	184	281	0.2878775510204081	97	G5APW6	151	248	0.4231428571428572	97
Q9DB26	PF05721	11	258	5.3471653225806435	247	G5ASD1	12	255	6.610204918032785	243
P97299	PF01392	57	148	0.3880978260869565	91	G5BMK4	1	92	0.3934021739130434	91
P97299	PF01759	187	284	2.8891224489795917	97	G5BMK4	131	228	2.9157040816326534	97
Q0VDT2	PF00096	185	208	0.0	23	G5BK35	57	80	0.0	23
Q0VDT2	PF13912	157	178	0.0	21	G5BK35	29	50	0.0	21
Q69ZB3	PF00956	239	374	2.4369558823529416	135	G5B8X8	344	479	4.093691176470586	135
Q8C180	PF02174	17	106	2.2271777777777766	89	G5AQS3	18	107	2.2219444444444445	89
B2RXC5	PF00096	324	346	0.0	22	G5BK02	295	317	0.0	22
B2RXC5	PF00096	352	374	0.3423913043478261	22	G5BK02	323	345	0.3423913043478261	22
B2RXC5	PF00096	380	402	0.02869565217391305	22	G5BK02	351	373	0.0	22
B2RXC5	PF00096	408	430	0.0	22	G5BK02	379	401	0.0	22
B2RXC5	PF00096	436	458	0.09282608695652177	22	G5BK02	407	429	0.0441304347826087	22
B2RXC5	PF00096	464	486	0.044347826086956525	22	G5BK02	407	429	0.0441304347826087	22
B2RXC5	PF00096	492	514	2.329869565217391	22	G5BK02	463	485	2.2497826086956523	22
B2RXC5	PF00096	522	542	0.0	20	G5BK02	493	513	0.0	20
B2RXC5	PF00096	548	570	0.0	22	G5BK02	519	541	0.026086956521739132	22
B2RXC5	PF01352	41	81	2.06909756097561	40	G5BK02	7	47	0.2572439024390244	40
Q6DFW4	PF01798	167	395	1.2465938864628825	228	G5C1S7	125	353	1.2013886462882104	228
Q6DFW4	PF08156	40	65	3.669307692307693	25	G5C1S7	1	23	0.17578260869565218	22
P97314	PF00412	9	64	1.3324999999999998	55	G5C9I3	10	65	1.3377678571428568	55
P97314	PF00412	118	174	0.05049122807017544	56	G5C9I3	119	175	0.050789473684210516	56
Q91ZD1	PF00096	171	193	2.0298695652173917	22	G5ALF5	172	194	2.0352173913043483	22
Q91ZD1	PF00096	199	221	0.0	22	G5ALF5	200	222	0.0	22
Q91ZD1	PF00096	227	249	0.0	22	G5ALF5	228	250	0.0	22
Q91ZD1	PF00096	255	277	0.0	22	G5ALF5	256	278	0.0	22
Q91ZD1	PF00096	283	305	0.0	22	G5ALF5	284	306	0.0	22
Q8R5L3	PF00780	21	289	4.715591078066918	268	G5BM25	22	290	5.237226765799254	268
Q8R5L3	PF10366	459	561	15.950650485436896	102	G5BM25	460	562	15.834825242718447	102
Q8R5L3	PF10367	771	878	3.90987037037037	107	G5BM25	772	877	3.9822830188679235	105
Q9CQN1	PF00183	291	702	1.1089320388349515	411	G5B1G7	292	703	0.9941456310679616	411
Q9CQN1	PF13589	111	223	9.044274336283188	112	G5B1G7	112	224	9.480336283185837	112
A2AF47	PF00169	165	270	4.690405660377358	105	G5BX18	101	206	1.4375377358490573	105
A2AF47	PF06920	1509	2027	2.7696589595375736	518	G5BX18	1415	1933	2.762468208092487	518
A2AF47	PF11878	65	146	1.518463414634147	81	G5BX18	1	82	1.511804878048781	81
A2AF47	PF14429	636	825	6.682989473684208	189	G5BX18	572	761	6.683642105263162	189
Q8BG99	PF05920	305	344	2.2647249999999994	39	G5APE6	306	345	2.264975	39
Q8BG99	PF16493	95	178	0.05261904761904762	83	G5APE6	96	179	0.05261904761904762	83
Q78JT3	PF06052	1	148	1.172540540540541	147	G5AL90	2	147	3.3846369863013703	145
Q91XU0	PF00004	258	370	5.986026548672567	112	G5BKF3	44	156	5.394823008849559	112
Q91XU0	PF12002	506	656	7.853834437086093	150	G5BKF3	351	501	7.832867549668872	150
Q91XU0	PF16193	416	491	0.8447368421052629	75	G5BKF3	202	276	0.8468133333333334	74
P08152	PF00096	336	360	0.0	24	G5C604	337	361	0.0	24
P08152	PF00096	366	388	0.0	22	G5C604	367	389	0.0	22
P08152	PF00096	394	416	0.0	22	G5C604	395	417	0.0	22
P08152	PF11928	93	183	2.863945054945056	90	G5C604	94	184	2.9040219780219783	90
Q30KN4	PF13841	34	62	1.1585862068965511	28	G5AQ97	39	67	0.01996551724137931	28
Q68FL4	PF00670	371	531	6.1850993788819855	160	G5BH87	249	409	6.195142857142858	160
Q68FL4	PF05221	186	321	3.3446911764705867	135	G5BH87	64	199	3.3465220588235303	135
P13020	PF00626	73	154	9.90212195121951	81	G5AXS0	82	163	10.332487804878047	81
P13020	PF00626	196	267	0.0738611111111111	71	G5AXS0	205	276	0.07237500000000001	71
P13020	PF00626	314	386	0.0	72	G5AXS0	323	395	0.0	72
P13020	PF00626	452	533	7.64373170731707	81	G5AXS0	461	542	9.614585365853657	81
P13020	PF00626	574	639	6.777181818181818	65	G5AXS0	583	648	6.686166666666668	65
P13020	PF00626	678	753	7.786092105263157	75	G5AXS0	687	762	8.851605263157895	75
O54967	PF07714	125	384	4.053784615384616	259	G5ALB1	181	440	3.724288461538461	259
O54967	PF09027	449	513	0.029876923076923082	64	G5ALB1	605	669	0.013384615384615384	64
O54967	PF11555	788	853	0.0	65	G5ALB1	932	997	0.0	65
O54967	PF14604	418	443	1.1505	25	G5ALB1	574	599	1.5265769230769228	25
Q9CQX8	PF10937	8	97	0.5282777777777778	89	G5BKN7	10	98	0.5372159090909091	88
Q3TDE8	PF00096	82	104	4.886652173913044	22	G5AQH7	84	106	0.0	22
Q3TDE8	PF00096	110	132	0.0	22	G5AQH7	112	134	0.0	22
Q3TDE8	PF00096	138	160	0.0	22	G5AQH7	140	162	0.0	22
Q3TDE8	PF00096	166	188	0.06521739130434782	22	G5AQH7	168	190	0.4911304347826087	22
Q3TDE8	PF00096	194	216	0.0	22	G5AQH7	196	218	0.0	22
Q3TDE8	PF00096	222	244	0.0	22	G5AQH7	224	246	0.0	22
Q3TDE8	PF00096	250	272	0.0	22	G5AQH7	252	274	0.0	22
P98203	PF00514	393	429	12.584351351351351	36	G5CA24	392	428	12.588648648648649	36
P98203	PF00514	434	474	2.227878048780488	40	G5CA24	433	473	2.227512195121951	40
P98203	PF00514	658	692	11.42082857142857	34	G5CA24	658	692	11.419942857142859	34
P98203	PF00514	702	737	1.7366944444444443	35	G5CA24	702	737	1.7361111111111112	35
Q0VBK2	PF00038	81	392	1.1140416666666673	311	G5BL95	82	393	1.27322435897436	311
Q0VBK2	PF16208	25	77	0.0	52	G5BL95	26	78	0.0	52
Q8K2C6	PF02146	57	255	4.101085427135678	198	G5BN47	58	256	2.7125075376884418	198
Q8K2T8	PF03985	29	428	3.0492174999999992	399	G5BJE1	30	429	3.0498899999999995	399
Q9DAQ4	PF15479	6	570	0.1981823008849556	564	G5AXG0	27	598	0.8911748251748247	571
Q8VIG0	PF00098	914	929	0.0	15	G5BF22	1057	1072	0.0	15
Q8K013	PF01018	15	131	3.919230769230768	116	G5BD65	6	122	3.930641025641026	116
Q8K013	PF01926	149	278	8.323453846153843	129	G5BD65	140	269	8.294969230769233	129
Q80XL6	PF00441	616	764	1.0480671140939597	148	G5BKR2	613	761	0.09730872483221477	148
Q80XL6	PF01636	43	295	5.43205138339921	252	G5BKR2	39	291	6.641806324110672	252
Q80XL6	PF02770	502	593	3.9550326086956495	91	G5BKR2	499	590	5.666608695652172	91
Q80XL6	PF02771	379	497	0.19374789915966384	118	G5BKR2	376	494	0.14647899159663866	118
O88673	PF00130	206	254	0.5891428571428571	48	G5BB97	265	313	0.08744897959183674	48
O88673	PF00130	270	321	0.2946730769230769	51	G5BB97	329	380	0.3811730769230769	51
O88673	PF00609	515	695	0.6252541436464087	180	G5BB97	580	760	0.6319005524861877	180
O88673	PF00781	371	481	5.443864864864869	110	G5BB97	435	546	6.3621517857142855	111
O88673	PF13499	113	179	0.7594776119402983	66	G5BB97	172	238	0.7242686567164182	66
O88673	PF14513	6	86	10.343604938271607	80	G5BB97	67	146	0.375675	79
Q64318	PF00096	219	241	0.0	22	G5BE31	181	203	0.0	22
Q64318	PF00096	247	267	0.0	20	G5BE31	209	229	0.0	20
Q64318	PF00096	909	931	0.0	22	G5BE31	874	896	0.0	22
Q64318	PF00096	937	957	0.0	20	G5BE31	902	922	0.0	20
Q64318	PF05605	149	201	0.5064905660377359	52	G5BE31	111	163	0.5081509433962266	52
Q8K4K4	PF00069	135	337	9.599517241379306	202	G5AYA1	32	234	10.005591133004923	202
Q80V53	PF03567	138	364	1.5362951541850234	226	G5BLZ1	94	320	2.348669603524227	226
Q60809	PF04857	16	131	2.020310344827586	115	G5B8F1	17	132	2.0183879310344826	115
Q60809	PF04857	150	237	8.142386363636364	87	G5B8F1	151	238	8.405352272727274	87
Q9QXW2	PF00400	84	119	0.0	35	G5BEI5	85	120	0.0	35
Q9QXW2	PF00400	505	540	0.404	35	G5BEI5	502	537	0.4043888888888889	35
Q9QXW2	PF12937	6	49	21.667227272727274	43	G5BEI5	7	50	17.93222727272727	43
P25425	PF00046	382	438	1.5875087719298246	56	G5AQ47	387	443	1.5879824561403508	56
P25425	PF00157	284	354	0.1258028169014085	70	G5AQ47	289	359	0.1254225352112676	70
Q3TTL0	PF15008	3	272	4.9451592592592535	269	G5C284	4	274	5.6090516605166085	270
Q64279	PF00010	94	145	9.621576923076924	51	G5AY09	32	83	10.419057692307693	51
Q9EPU0	PF04851	490	544	3.2749090909090914	54	G5C5B2	437	491	3.283981818181818	54
Q9EPU0	PF09416	115	266	10.058296052631578	151	G5C5B2	73	224	10.065467105263156	151
Q9EPU0	PF13086	578	676	2.62379797979798	98	G5C5B2	525	623	2.628858585858586	98
Q9EPU0	PF13087	685	873	8.262751322751326	188	G5C5B2	632	819	8.074664893617022	187
Q9EPU0	PF18141	318	419	5.949745098039216	101	G5C5B2	276	366	0.23709890109890105	90
Q91WG4	PF00400	51	89	0.3124102564102565	38	G5C757	45	83	0.711974358974359	38
Q91WG4	PF00400	102	142	1.1693902439024388	40	G5C757	96	136	5.9981951219512215	40
Q91WG4	PF00400	202	235	1.274911764705882	33	G5C757	196	229	2.974764705882352	33
Q91WG4	PF00400	380	412	2.4501212121212115	32	G5C757	374	406	12.21118181818182	32
Q91WG4	PF00400	604	641	12.028342105263159	37	G5C757	597	634	12.387710526315784	37
Q91WG4	PF00400	664	695	6.332968749999997	31	G5C757	657	688	7.303625	31
Q05922	PF00581	21	139	2.3743613445378147	118	G5APU1	18	102	9.595388235294116	84
Q05922	PF00782	183	312	6.7709	129	G5APU1	146	275	7.194107692307693	129
Q5XJE5	PF04004	374	535	0.02790123456790124	161	G5C9D5	374	535	0.026493827160493817	161
Q99PU5	PF00501	107	566	10.830200000000017	459	G5AUK9	111	597	8.994767967145794	486
B1AQ75	PF00038	91	402	0.4002435897435897	311	G5B0N1	92	405	0.5033280254777073	313
Q6P8Y1	PF13499	43	100	4.979672413793104	57	G5C9G7	44	101	6.176793103448276	57
Q6P8Y1	PF13499	112	184	0.055068493150684926	72	G5C9G7	113	185	0.06928767123287671	72
Q6PGG2	PF00620	563	722	2.3775499999999994	159	G5AN48	558	722	2.307921212121213	164
Q9D5V2	PF00651	28	133	2.2991320754716984	105	G5B0L6	29	134	2.333669811320756	105
Q9D5V2	PF01344	292	320	13.962793103448274	28	G5B0L6	273	300	12.729214285714288	27
Q9D5V2	PF01344	343	371	6.905103448275861	28	G5B0L6	229	257	0.0	28
Q9D5V2	PF01344	374	418	25.026666666666674	44	G5B0L6	218	257	1.280275	39
Q9D5V2	PF01344	422	460	0.28474358974358965	38	G5B0L6	261	298	13.902368421052635	37
Q9D5V2	PF01344	484	512	0.2577931034482759	28	G5B0L6	229	257	0.0	28
Q9D5V2	PF01344	515	559	11.736911111111114	44	G5B0L6	260	304	11.739777777777784	44
Q9D5V2	PF07707	140	229	6.627611111111111	89	G5B0L6	141	229	7.255505617977527	88
Q9ER97	PF00042	6	112	5.535383177570091	106	G5B681	7	113	5.871850467289722	106
P09027	PF00046	195	251	0.05877192982456141	56	G5BU20	195	251	0.05877192982456141	56
P09027	PF13293	370	430	0.017131147540983604	60	G5BU20	370	430	0.017049180327868854	60
Q91VD9	PF00384	300	627	6.575317073170731	327	G5C5M0	301	628	6.29871951219512	327
Q91VD9	PF09326	657	709	0.0179622641509434	52	G5C5M0	658	710	0.0179622641509434	52
Q91VD9	PF10588	112	151	0.049125	39	G5C5M0	113	152	0.049	39
Q91VD9	PF13510	31	105	0.1508533333333333	74	G5C5M0	32	106	0.20453333333333326	74
Q9WUN8	PF00046	84	140	7.090649122807018	56	G5AXF1	84	140	7.100192982456139	56
P60041	PF03002	98	115	0.0	17	G5BTD2	99	116	0.0	17
P05524	PF00167	74	178	6.703780952380952	104	G5BSS3	53	157	10.883380952380953	104
Q6PAV2	PF00415	1	48	7.235291666666666	47	G5B7Z0	2	49	9.04125	47
Q6PAV2	PF00415	51	98	5.396708333333334	47	G5B7Z0	52	99	1.6469375000000002	47
Q6PAV2	PF00415	101	151	2.0455686274509803	50	G5B7Z0	102	152	1.0391176470588237	50
Q6PAV2	PF00415	156	204	5.747020408163265	48	G5B7Z0	157	205	7.196122448979591	48
Q6PAV2	PF00415	207	256	13.127179999999996	49	G5B7Z0	208	257	11.948479999999995	49
Q6PAV2	PF00415	259	307	2.584489795918368	48	G5B7Z0	260	308	2.5479183673469388	48
Q6PAV2	PF00415	312	374	0.11646031746031747	62	G5B7Z0	313	375	0.11646031746031747	62
Q6PAV2	PF00632	759	1055	12.313417508417515	296	G5B7Z0	760	1056	11.9794276094276	296
Q99MV1	PF00567	254	377	2.394112903225808	123	G5BKA6	255	378	2.213096774193549	123
Q99MV1	PF00567	486	605	2.660016666666666	119	G5BKA6	487	606	2.5562250000000004	119
Q99MV1	PF00567	705	823	3.555638655462184	118	G5BKA6	701	819	2.9526974789915954	118
Q99MV1	PF00567	928	1050	1.8567073170731712	122	G5BKA6	926	1048	0.7103495934959352	122
Q99MV1	PF01753	162	198	0.0195945945945946	36	G5BKA6	164	200	0.019864864864864863	36
Q80XI6	PF07714	117	376	7.573673076923077	259	G5B6J9	117	376	7.752661538461536	259
Q80XI6	PF14604	48	100	2.18488679245283	52	G5B6J9	48	100	1.4321886792452831	52
Q9DCW4	PF01012	28	212	1.6748702702702702	184	G5BR85	51	235	1.62544864864865	184
Q9QXT6	PF06083	95	178	0.11226190476190477	83	G5C3A4	96	179	0.06385714285714286	83
Q9QZ41	PF07535	289	332	0.4572272727272727	43	G5C4X6	276	319	4.400568181818182	43
Q80UU1	PF00023	556	586	2.230580645161291	30	G5AKK1	537	567	20.153322580645163	30
Q80UU1	PF18716	708	745	0.018157894736842102	37	G5AKK1	689	726	0.018157894736842102	37
Q80UU1	PF18826	230	373	4.4688402777777805	143	G5AKK1	209	351	3.579447552447553	142
Q810A3	PF07719	107	140	2.2472352941176474	33	G5AYI9	105	138	2.212500000000001	33
Q62414	PF00010	122	171	4.63954	49	G5BRW8	143	192	6.1705999999999985	49
Q62414	PF12533	180	204	5.64712	24	G5BRW8	201	224	5.806750000000001	23
Q80TE7	PF00595	1405	1484	4.187487500000003	79	G5C4T4	1227	1306	4.186737500000003	79
Q80TE7	PF13855	45	101	1.0145087719298245	56	G5C4T4	96	152	0.16307017543859653	56
Q80TE7	PF13855	161	218	0.0	57	G5C4T4	51	108	0.07758620689655173	57
Q80TE7	PF13855	345	401	3.9728245614035087	56	G5C4T4	120	176	3.967245614035088	56
Q9CPY4	PF09806	72	125	0.2462962962962963	53	G5BS99	73	126	0.2462962962962963	53
P03958	PF00962	10	344	1.9745104477611917	334	G5BB34	76	474	1.8544837092731816	398
Q9CX60	PF15317	17	102	0.023662790697674418	85	G5C2X4	18	103	0.023662790697674418	85
Q9D0R2	PF00587	398	606	4.129033492822966	208	G5BJ35	479	687	4.189971291866028	208
Q9D0R2	PF02824	81	141	0.13304918032786886	60	G5BJ35	162	222	0.13381967213114754	60
Q9D0R2	PF03129	618	708	6.303999999999999	90	G5BJ35	699	789	6.303483516483516	90
Q9D0R2	PF07973	248	296	0.02412244897959184	48	G5BJ35	329	377	0.020428571428571428	48
Q61477	PF03045	29	120	0.2125326086956522	91	G5BZL2	31	122	0.13689130434782604	91
Q8JZV9	PF13561	24	243	6.104063636363637	219	G5BXB0	124	343	6.147145454545454	219
Q9D1F3	PF04266	5	91	5.068908045977012	86	G5ALZ9	6	92	7.055850574712643	86
Q8CIE2	PF02891	595	643	0.0	48	G5BIL2	483	531	0.0	48
Q6PDM1	PF15275	475	592	0.1984915254237288	117	G5BRV6	218	335	0.1998813559322034	117
Q8CD15	PF08007	50	360	0.8273504823151129	310	G5BXD4	51	359	0.9542686084142392	308
P02525	PF00030	14	98	0.39514117647058794	84	G5BVJ5	32	116	1.2293882352941177	84
P02525	PF00030	107	195	1.3824157303370783	88	G5BVJ5	125	213	1.0269550561797751	88
Q8CCK0	PF00125	5	84	10.7831625	79	G5B190	6	85	11.650325	79
Q8CCK0	PF01661	215	328	0.02083333333333333	113	G5B190	216	329	0.02083333333333333	113
Q8CCK0	PF16211	88	121	0.056176470588235314	33	G5B190	89	122	0.056176470588235314	33
Q61161	PF00069	29	271	4.268123456790123	242	G5B6N8	1	243	4.236106995884775	242
Q61161	PF00780	492	788	7.3226498316498265	296	G5B6N8	462	758	7.224818181818176	296
O55042	PF01387	0	117	7.094618644067798	117	G5BZ66	1	117	7.135786324786329	116
P50429	PF00884	45	362	6.6816383647798725	317	G5ASU3	16	333	6.0866132075471695	317
P70169	PF00168	141	244	0.1434519230769231	103	G5BVL2	54	157	0.17850961538461535	103
P70169	PF00168	282	385	7.696221153846158	103	G5BVL2	195	336	5.185359154929576	141
P29595	PF00240	5	73	3.4507826086956523	68	G5B286	1	69	3.442623188405797	68
Q8K199	PF08583	0	69	5.591971428571428	69	G5B1X9	1	70	5.491128571428572	69
P97315	PF00412	9	64	2.817749999999999	55	G5B399	10	65	2.817749999999999	55
P97315	PF00412	118	174	0.5093508771929824	56	G5B399	119	175	0.5093508771929824	56
Q64331	PF16521	1147	1237	3.795054945054945	90	G5AL56	1177	1267	3.804406593406594	90
Q64331	PF00063	58	761	3.5034346590909045	703	G5AL56	59	759	3.7061697574893024	700
Q8K4E0	PF15309	3124	3246	0.7031626016260162	122	G5CBQ1	3711	3832	0.13442622950819672	121
Q8K4E0	PF18727	439	476	0.0	37	G5CBQ1	1867	1903	0.0	36
Q8K4E0	PF18727	518	557	0.0155	39	G5CBQ1	1026	1064	0.0	38
Q8K4E0	PF18727	638	680	0.004790697674418604	42	G5CBQ1	602	644	0.017255813953488373	42
Q8K4E0	PF18727	684	730	0.21687234042553186	46	G5CBQ1	1023	1069	0.019978723404255317	46
Q8K4E0	PF18727	731	776	0.053413043478260855	45	G5CBQ1	1210	1256	1.2864680851063832	46
Q8K4E0	PF18727	777	823	0.1448723404255319	46	G5CBQ1	1023	1069	0.019978723404255317	46
Q8K4E0	PF18727	831	870	2.2542500000000003	39	G5CBQ1	1264	1303	2.413425	39
Q8K4E0	PF18727	874	916	6.5997674418604655	42	G5CBQ1	1213	1256	1.2744318181818182	43
Q8K4E0	PF18727	972	1004	0.027272727272727268	32	G5CBQ1	897	929	0.0	32
Q8K4E0	PF18727	1163	1206	0.0037727272727272726	43	G5CBQ1	1867	1911	0.0	44
Q8K4E0	PF18727	1315	1358	0.0	43	G5CBQ1	1868	1911	0.0	43
P50446	PF00038	150	463	0.3105	313	G5ALS1	162	475	0.3015031847133758	313
P50446	PF16208	14	147	0.0	133	G5ALS1	16	159	0.0	143
Q9JJV0	PF00030	12	96	0.8409882352941177	84	G5BGM8	13	97	0.8673999999999998	84
Q9JJV0	PF00030	106	148	0.05311627906976744	42	G5BGM8	107	141	0.0	34
Q9Z1J1	PF00505	341	408	4.597455882352942	67	G5BRQ6	159	226	4.555514705882356	67
Q9Z1J1	PF08347	184	246	0.05055555555555556	62	G5BRQ6	1	63	0.049523809523809526	62
Q9QZ23	PF01106	172	238	0.6532089552238803	66	G5BNZ2	148	214	0.2265522388059701	66
Q9QZ23	PF08712	58	145	2.5049999999999994	87	G5BNZ2	36	123	2.1860227272727277	87
F6W8I0	PF03853	41	201	3.0364534161490706	160	G5AN46	21	184	2.9484601226993865	163
Q9EQC7	PF07648	117	160	0.0	43	G5C5W7	212	254	0.009069767441860466	42
Q9EQC7	PF07648	197	240	0.4218636363636363	43	G5C5W7	294	337	0.4320227272727273	43
Q9EQC7	PF09289	96	116	0.0	20	G5C5W7	191	211	0.0	20
G3UYX5	PF00615	845	969	0.4815519999999999	124	G5ANZ1	763	887	0.08852	124
G3UYX5	PF00615	1014	1119	8.073113207547168	105	G5ANZ1	1112	1217	10.29911320754717	105
Q0P5Y3	PF05517	5	160	0.8665576923076926	155	G5BFW3	6	160	0.5934709677419351	154
Q9Z129	PF00270	93	261	2.8429349112426	168	G5BEF7	129	297	3.099313609467456	168
Q9Z129	PF00271	301	406	11.751103773584909	105	G5BEF7	337	442	11.766518867924528	105
Q9Z129	PF16124	420	478	2.1832203389830505	58	G5BEF7	456	513	2.108137931034483	57
Q8BTI7	PF00023	175	202	5.368714285714287	27	G5BB80	168	195	5.370321428571428	27
Q8BTI7	PF00023	338	365	4.738071428571429	27	G5BB80	331	358	4.7395	27
Q8BTI7	PF00023	963	990	9.07825	27	G5BB80	955	982	9.08082142857143	27
Q8BTI7	PF12796	77	167	6.622934065934065	90	G5BB80	70	160	6.6237032967032965	90
Q8BTI7	PF12796	209	300	0.493021739130435	91	G5BB80	202	293	1.4328369565217394	91
Q8BTI7	PF12796	375	484	9.087009090909092	109	G5BB80	368	477	9.07714545454546	109
Q8BTI7	PF12796	588	680	3.371817204301076	92	G5BB80	580	672	3.372301075268818	92
Q8BTI7	PF12796	684	745	4.491161290322581	61	G5BB80	676	737	4.815693548387098	61
Q8BTI7	PF12796	752	812	0.024704918032786887	60	G5BB80	744	804	0.024704918032786887	60
Q8BTI7	PF12796	823	887	0.2278153846153846	64	G5BB80	815	879	0.2278153846153846	64
Q8BTI7	PF12796	890	949	5.63725	59	G5BB80	882	941	5.629250000000001	59
Q8BTI7	PF13637	10	60	7.677333333333333	50	G5BB80	3	53	8.194333333333333	50
Q8BTI7	PF13637	528	569	1.846428571428572	41	G5BB80	520	561	1.540714285714286	41
D3Z6Q9	PF03114	26	235	2.335447619047619	209	G5ATY6	1	210	2.2939095238095244	209
Q9CYL5	PF00188	13	129	1.0544273504273505	116	G5B0H4	101	217	1.1155128205128204	116
P97290	PF00079	186	501	6.838218354430382	315	G5BLJ5	182	511	7.37800606060606	329
P99029	PF08534	52	195	2.3619722222222217	143	G5B6P7	5	148	2.629986111111112	143
Q5DTT3	PF12480	93	165	8.15353424657534	72	G5B3J2	79	151	8.093260273972604	72
Q5DTT3	PF12509	546	698	1.300718954248366	152	G5B3J2	538	691	0.8356168831168831	153
O09043	PF00026	71	387	8.44314826498423	316	G5B8S4	74	390	9.489274447949528	316
Q8VHG0	PF00743	2	529	6.109719696969697	527	G5BGT2	3	534	7.191043233082709	531
P09671	PF00081	24	105	1.229670731707317	81	G5BC70	25	106	1.1527073170731708	81
P09671	PF02777	112	215	2.839269230769231	103	G5BC70	113	216	2.8378557692307687	103
Q9Z1Q5	PF13409	23	85	13.309761904761901	62	G5C3G0	24	80	14.005999999999995	56
Q9Z1Q5	PF13410	123	209	1.146	86	G5C3G0	118	204	1.160080459770115	86
Q80WQ4	PF08241	49	138	7.938433333333332	89	G5ANJ3	50	139	9.044933333333333	89
P11985	PF03645	94	188	20.494452631578948	94	G5C7R4	97	192	14.765812499999996	95
Q61810	PF00683	287	318	0.02328125	31	G5B6K5	235	266	0.02328125	31
Q61810	PF00683	410	454	0.0	44	G5B6K5	357	401	0.0	44
Q61810	PF00683	925	970	0.11967391304347826	45	G5B6K5	875	920	0.013152173913043477	45
Q61810	PF00683	1096	1131	0.0	35	G5B6K5	1093	1128	0.0	35
Q61810	PF07645	351	390	0.0	39	G5B6K5	298	337	0.0	39
Q61810	PF07645	612	654	0.0	42	G5B6K5	560	602	0.0	42
Q61810	PF07645	656	689	0.0	33	G5B6K5	604	637	0.0	33
Q61810	PF07645	699	738	0.0	39	G5B6K5	647	686	0.0	39
Q61810	PF07645	740	779	0.0	39	G5B6K5	688	727	0.0	39
Q61810	PF07645	781	820	0.0	39	G5B6K5	729	768	0.0	39
Q61810	PF07645	822	853	0.0	31	G5B6K5	770	801	0.0	31
Q61810	PF07645	862	903	0.15523809523809526	41	G5B6K5	812	853	0.15535714285714286	41
Q61810	PF07645	989	1022	0.125	33	G5B6K5	939	972	0.0	33
Q61810	PF07645	1032	1071	0.0	39	G5B6K5	982	1021	0.0	39
Q61810	PF07645	1203	1246	0.0	43	G5B6K5	1200	1243	0.0	43
Q5SF07	PF00013	188	252	4.423615384615384	64	G5BT98	131	195	4.4102000000000015	64
Q5SF07	PF00013	270	334	0.10366153846153847	64	G5BT98	132	236	2.7301238095238096	104
Q5SF07	PF00013	422	484	5.925650793650794	62	G5BT98	324	386	6.32268253968254	62
Q5SF07	PF00013	505	569	0.4346769230769231	64	G5BT98	407	471	0.4350307692307692	64
Q5SF07	PF00076	85	147	6.042238095238097	62	G5BT98	21	83	5.419698412698414	62
Q811F1	PF00096	360	381	0.0	21	G5BM74	359	380	0.0	21
Q811F1	PF00096	387	409	0.0	22	G5BM74	386	408	0.0	22
Q811F1	PF00096	465	483	0.0	18	G5BM74	442	460	0.0	18
Q811F1	PF00096	516	535	0.0	19	G5BM74	493	512	0.0	19
Q811F1	PF00096	601	623	0.0	22	G5BM74	386	408	0.0	22
Q811F1	PF00096	629	651	0.030869565217391308	22	G5BM74	540	561	0.0	21
Q811F1	PF00096	694	716	0.0	22	G5BM74	568	590	0.0	22
Q811F1	PF00651	81	174	11.762255319148927	93	G5BM74	79	172	11.768287234042552	93
Q811F1	PF12874	667	686	0.0	19	G5BM74	541	560	0.0	19
Q3TLR7	PF00400	89	125	0.7741891891891891	36	G5AYL4	90	126	0.7764864864864864	36
Q3TLR7	PF00400	129	168	0.09815000000000003	39	G5AYL4	130	169	0.179375	39
Q3TLR7	PF00400	217	243	22.31711111111111	26	G5AYL4	218	244	21.91577777777778	26
Q3TLR7	PF00400	306	344	2.8802820512820513	38	G5AYL4	307	345	3.921871794871794	38
Q3TLR7	PF00400	353	387	0.5598000000000001	34	G5AYL4	354	388	0.5161714285714285	34
Q8BMQ3	PF00096	1064	1085	0.018954545454545457	21	G5BZ22	1055	1076	0.012636363636363638	21
Q8BMQ3	PF12874	469	488	0.0	19	G5BZ22	460	479	0.0	19
Q80TE4	PF00595	952	1021	6.05871428571429	69	G5AN04	954	1023	6.075814285714286	69
Q80TE4	PF02145	624	806	6.2398688524590185	182	G5AN04	626	808	6.246153005464477	182
Q80TE4	PF11881	1425	1665	0.20003734439834034	240	G5AN04	1426	1666	0.2151576763485477	240
Q9CQU5	PF15556	34	233	2.8388449999999987	199	G5AYB7	67	266	2.297495	199
Q99NB8	PF00240	36	83	14.363625	47	G5ARA5	4	51	14.366895833333334	47
Q99NB8	PF00627	554	589	0.5809722222222224	35	G5ARA5	616	651	0.5811666666666668	35
P52787	PF01122	16	306	5.299862542955327	290	G5AP16	17	307	5.875742268041235	290
P52787	PF14478	339	414	8.937763157894743	75	G5AP16	340	415	9.337578947368415	75
Q924H5	PF08423	76	270	9.505328205128206	194	G5AXY9	78	271	4.640572164948454	193
O70126	PF00069	81	331	5.527203187250998	250	G5B5F5	76	326	5.447788844621517	250
Q5SRX1	PF00790	7	147	14.04278014184397	140	G5BMW7	8	148	14.12304964539007	140
Q5SRX1	PF03127	231	306	0.07313157894736844	75	G5BMW7	232	307	0.07313157894736844	75
P97865	PF00400	62	90	1.1600689655172411	28	G5C1B1	61	89	1.1797931034482758	28
P97865	PF00400	97	135	0.04846153846153845	38	G5C1B1	96	134	0.04871794871794872	38
P97865	PF00400	140	178	11.3715641025641	38	G5C1B1	139	177	11.38453846153846	38
P97865	PF00400	227	265	0.5559743589743591	38	G5C1B1	226	264	0.5666410256410257	38
A2ADF7	PF00153	19	105	3.6830000000000025	86	G5BRT3	20	106	1.7177241379310342	86
A2ADF7	PF00153	132	210	1.2488227848101263	78	G5BRT3	133	211	1.5232784810126587	78
A2ADF7	PF00153	218	309	16.787913043478255	91	G5BRT3	219	309	14.705802197802198	90
Q9CR55	PF10571	13	36	5.3300833333333335	23	G5C3N2	14	37	5.656041666666668	23
Q9EST3	PF10477	28	709	0.15111290322580645	681	G5BBV1	30	710	0.18647577092511025	680
Q91WT8	PF00076	72	136	5.405200000000002	64	G5C3T9	73	137	5.279384615384615	64
Q91WT8	PF00076	152	213	12.463161290322578	61	G5C3T9	153	210	3.3006551724137934	57
Q91WT8	PF00076	247	310	1.11828125	63	G5C3T9	244	307	1.985578125	63
A4Q9E8	PF03133	105	386	3.9649078014184393	281	G5C4M8	172	453	4.4582978723404265	281
Q08775	PF00853	189	315	9.401409448818901	126	G5BNF2	178	304	9.3938031496063	126
Q08775	PF08504	515	606	0.2020434782608696	91	G5BNF2	504	595	0.2017032967032968	91
G5E8K5	PF00023	744	774	11.39367741935484	30	G5BXS3	762	792	11.424612903225805	30
G5E8K5	PF00531	1537	1558	8.713545454545454	21	G5BXS3	2392	2413	8.742681818181817	21
G5E8K5	PF00791	986	1083	4.3496836734693884	97	G5BXS3	986	1083	3.43104081632653	97
G5E8K5	PF12796	30	118	2.702730337078652	88	G5BXS3	48	136	2.7158876404494383	88
G5E8K5	PF12796	186	245	4.337283333333335	59	G5BXS3	204	263	4.347250000000002	59
G5E8K5	PF12796	249	308	0.0	59	G5BXS3	267	326	0.0	59
G5E8K5	PF12796	314	378	0.8607692307692308	64	G5BXS3	332	396	0.8662307692307696	64
G5E8K5	PF12796	485	574	3.2841444444444448	89	G5BXS3	503	592	2.103544444444444	89
G5E8K5	PF12796	578	641	8.672031249999996	63	G5BXS3	596	659	8.802453125	63
G5E8K5	PF12796	651	741	6.114648351648352	90	G5BXS3	669	759	6.136615384615384	90
G5E8K5	PF13606	448	474	0.2933703703703704	26	G5BXS3	466	492	0.2955555555555556	26
G5E8K5	PF13637	124	175	7.288846153846152	51	G5BXS3	142	193	9.666211538461537	51
G5E8K5	PF13637	384	431	1.014520833333333	47	G5BXS3	402	449	1.1078541666666664	47
G5E8K5	PF17809	1308	1437	7.726846153846152	129	G5BXS3	1308	1437	8.571907692307693	129
Q9CQ69	PF02939	3	78	12.961052631578946	75	G5BFF6	4	79	13.286105263157895	75
Q61495	PF00028	55	146	11.991	91	G5C311	44	135	12.031293478260867	91
Q61495	PF00028	163	259	0.9687938144329896	96	G5C311	152	248	0.372917525773196	96
Q61495	PF00028	273	376	14.764721153846152	103	G5C311	262	364	10.046359223300973	102
Q61495	PF01049	661	778	0.2414406779661017	117	G5C311	650	766	1.0014957264957265	116
Q80U28	PF02141	173	400	8.805877192982457	227	G5BPC5	175	402	8.733039473684208	227
Q80U28	PF03456	30	95	13.517878787878793	65	G5BPC5	32	97	13.56374242424242	65
Q8R3Q2	PF04499	128	363	8.974084745762713	235	G5B2H3	129	365	10.432852320675106	236
Q8R3Q2	PF04499	363	532	5.589176470588236	169	G5B2H3	365	534	5.5867235294117625	169
Q8R2X8	PF08227	183	228	0.0	45	G5CB49	185	230	0.0	45
Q8CAA7	PF00408	548	584	8.141486486486484	36	G5AS92	550	586	8.120783783783782	36
Q8CAA7	PF02878	64	207	6.414166666666668	143	G5AS92	65	208	5.705847222222217	143
Q8CAA7	PF02879	237	344	8.052490740740739	107	G5AS92	238	345	2.9754907407407414	107
Q8CAA7	PF02880	353	477	11.388864000000002	124	G5AS92	354	479	11.801134920634933	125
Q9CQE5	PF00615	40	153	9.04980701754386	113	G5BVX0	37	121	6.184211764705883	84
Q50L41	PF00168	44	137	4.360829787234042	93	G5BM24	45	138	1.582393617021277	93
Q50L41	PF01735	354	569	4.361791666666663	215	G5BM24	357	574	2.126403669724773	217
Q50L41	PF18695	180	300	0.4383305785123967	120	G5BM24	182	304	3.4638861788617885	122
Q91X88	PF03071	300	558	7.749305019305022	258	G5AX50	301	559	7.925131274131278	258
Q91X88	PF15711	128	216	13.150696629213488	88	G5AX50	129	217	13.124213483146074	88
P51141	PF00778	2	80	6.193430379746835	78	G5ATQ2	3	81	7.443708860759494	78
P51141	PF02377	89	201	0.005398230088495575	112	G5ATQ2	90	201	0.007633928571428572	111
P51141	PF00595	303	334	0.535	31	G5ATQ2	192	223	0.574625	31
P51141	PF00610	427	496	6.465142857142855	69	G5ATQ2	316	385	6.517828571428571	69
P51141	PF12316	502	684	0.3301475409836065	182	G5ATQ2	391	566	0.06775568181818183	175
P68254	PF00244	8	228	5.638140271493208	220	G5BEK1	9	229	5.638140271493208	220
P04104	PF00038	186	499	1.2766910828025475	313	G5ALS8	191	504	0.6655382165605095	313
P04104	PF16208	152	183	0.0	31	G5ALS8	157	188	0.0	31
P04104	PF16210	500	508	0.2378888888888889	8	G5ALS8	505	512	0.2575	7
Q9ERG2	PF00400	468	506	0.6685384615384614	38	G5CAM2	429	467	0.6716923076923077	38
Q9ERG2	PF00400	522	559	4.696736842105265	37	G5CAM2	484	521	4.693315789473685	37
Q9ERG2	PF00400	578	612	6.794371428571429	34	G5CAM2	540	574	6.124514285714286	34
Q9ERG2	PF00400	712	749	0.6252894736842106	37	G5CAM2	674	711	0.6282105263157894	37
Q9ERG2	PF00400	754	789	0.0	35	G5CAM2	716	751	0.0	35
Q9ERG2	PF08232	63	192	0.19031538461538464	129	G5CAM2	23	152	0.19120769230769227	129
Q811J3	PF00330	69	131	0.0	62	G5AUK5	119	181	0.0	62
Q811J3	PF00330	209	638	5.320572093023257	429	G5AUK5	259	688	5.116960465116276	429
Q811J3	PF00694	767	893	2.567362204724409	126	G5AUK5	817	943	2.565251968503937	126
Q6P7W5	PF01974	333	417	6.865823529411764	84	G5APJ2	319	403	7.68245882352941	84
Q6P7W5	PF02778	271	323	24.153301886792445	52	G5APJ2	257	309	24.757056603773584	52
P04202	PF00019	291	388	6.411908163265308	97	G5AZS7	255	352	6.417520408163267	97
P04202	PF00688	37	259	4.482188340807175	222	G5AZS7	1	223	4.993309417040358	222
A2AQ07	PF00091	2	210	0.8919617224880388	208	G5AKZ6	3	211	0.6280813397129189	208
A2AQ07	PF03953	260	381	3.680532786885246	121	G5AKZ6	261	382	3.907147540983608	121
P49718	PF00493	318	539	4.169297297297297	221	G5BPF1	265	486	3.951333333333333	221
P49718	PF14551	55	129	0.39966666666666667	74	G5BPF1	1	75	0.40166666666666667	74
P49718	PF17207	136	271	1.7831397058823528	135	G5BPF1	82	218	3.654072992700729	136
P49718	PF17855	557	646	0.34030000000000005	89	G5BPF1	504	593	0.3555666666666667	89
Q9D0I9	PF00750	173	519	6.252703170028818	346	G5BP47	174	520	3.5097896253602285	346
Q9D0I9	PF03485	78	165	0.5506931818181816	87	G5BP47	79	166	0.5152613636363635	87
Q9D0I9	PF05746	533	659	5.878354330708662	126	G5BP47	534	660	5.20359523809524	126
P10923	PF00865	21	293	0.12297069597069595	272	G5BSU2	22	302	0.17142500000000002	280
O35632	PF01630	28	360	5.698429429429425	332	G5BZZ3	29	361	6.7520480480480485	332
O35437	PF00010	79	131	0.0	52	G5AS64	80	132	0.0	52
Q9CWU4	PF15559	25	124	0.0	99	G5C917	28	127	0.00137	99
Q9QY66	PF04438	2	35	0.0	33	G5B6L7	3	36	0.0	33
Q64441	PF00067	58	504	5.800472035794179	446	G5C0M8	47	493	6.895275167785231	446
Q9Z120	PF02390	70	246	7.964271186440675	176	G5BEB5	61	237	6.56009604519774	176
Q9DBW3	PF14542	26	99	5.884094594594597	73	G5BKN1	30	103	5.873202702702705	73
P28076	PF00227	23	197	7.617868571428571	174	G5BB07	1	175	9.49866857142857	174
A6H6A4	PF00612	544	559	0.13568750000000002	15	G5AXZ8	435	449	0.0	14
A6H6A4	PF13855	84	141	0.1328793103448276	57	G5AXZ8	33	90	0.0	57
A6H6A4	PF13855	156	212	0.0	56	G5AXZ8	105	161	0.11140350877192984	56
A6H6A4	PF13855	316	372	6.238894736842103	56	G5AXZ8	265	321	0.2954385964912281	56
A6H6A4	PF13855	434	491	0.0	57	G5AXZ8	325	382	0.035896551724137936	57
Q14B46	PF00169	285	383	0.35802020202020185	98	G5BQK8	271	370	0.6831100000000002	99
Q14B46	PF08174	93	240	3.9744527027027057	147	G5BQK8	78	226	7.5493154362416055	148
A2BH40	PF01388	1021	1104	3.922357142857144	83	G5AUR9	773	856	3.9270119047619056	83
A2BH40	PF12031	1973	2228	4.71828125	255	G5AUR9	1681	1936	4.7190976562500015	255
A0A0M3U1B0	PF18584	306	379	16.101243243243243	73	G5BN58	9	80	9.574958333333337	71
P18872	PF00503	53	342	5.850579310344825	289	G5BMR4	1	290	5.842868965517244	289
P43431	PF03039	48	214	2.3515568862275447	166	G5BVX5	42	194	2.7891381578947367	152
Q5ND34	PF00400	1633	1667	0.34179999999999994	34	G5BCV2	1636	1670	0.09557142857142856	34
Q5ND34	PF02138	348	568	2.810018099547512	220	G5BCV2	349	569	2.8018823529411794	220
Q810D6	PF00400	253	289	0.019864864864864863	36	G5B8A8	254	290	0.019864864864864863	36
Q810D6	PF00400	302	335	1.1300000000000003	33	G5B8A8	303	336	1.9698529411764705	33
Q810D6	PF00400	342	381	0.14540000000000006	39	G5B8A8	343	382	0.145875	39
Q810D6	PF12265	44	111	3.5171176470588232	67	G5B8A8	45	112	5.435250000000003	67
P30882	PF00048	32	87	13.902999999999993	55	G5B743	33	88	8.743535714285715	55
Q8CG46	PF02463	52	1052	2.9452157842157862	1000	G5AVH2	50	1035	3.2018255578093284	985
Q9Z0Y2	PF00068	23	137	0.1539391304347826	114	G5B779	24	138	0.1469217391304348	114
Q99ML1	PF15826	1	77	0.31836363636363635	76	G5AV07	2	72	0.13185915492957748	70
O88643	PF00069	269	520	2.7669920634920637	251	G5AW75	270	521	2.7530753968253965	251
O88643	PF00786	73	131	0.0	58	G5AW75	74	132	0.0	58
Q99KS6	PF00149	17	280	5.6477196969696974	263	G5B5I7	18	281	7.202367424242424	263
Q6PFX2	PF10523	190	262	1.1451780821917807	72	G5AKH2	195	267	1.1458219178082192	72
Q9JLK3	PF13499	30	92	0.029285714285714286	62	G5B898	31	93	0.03047619047619048	62
Q9JLK3	PF13499	108	171	0.0	63	G5B898	109	172	0.0	63
Q80WQ2	PF12755	67	162	3.1884062500000017	95	G5C1Q3	68	184	4.613376068376066	116
P46062	PF00595	682	752	0.6659859154929577	70	G5B6J7	689	759	0.6763802816901407	70
P46062	PF02145	344	527	8.403853260869562	183	G5B6J7	351	534	7.997934782608695	183
P40124	PF01213	6	60	0.052727272727272734	54	G5BZ60	7	63	0.016350877192982456	56
P40124	PF08603	317	470	4.474376623376622	153	G5BZ60	318	471	5.900980519480518	153
P17919	PF00046	202	255	0.03064814814814815	53	G5C4L8	207	260	0.030740740740740742	53
Q7TPE5	PF08574	191	254	0.0	63	G5C691	193	256	0.0	63
Q8BK26	PF04300	71	249	2.897391061452515	178	G5C513	162	340	4.1245754189944135	178
Q8BK26	PF12937	5	51	3.3625319148936166	46	G5C513	96	142	3.310127659574468	46
O54774	PF01602	31	580	5.6245818181818095	549	G5BBC0	32	608	4.1298006932409015	576
O54774	PF06375	660	802	0.0	142	G5BBC0	688	845	0.0	157
Q8CB77	PF06881	566	661	0.00321875	95	G5BHY4	546	641	0.006458333333333332	95
Q8CB77	PF08711	27	75	0.03	48	G5BHY4	4	52	0.030102040816326524	48
Q9CR88	PF00253	74	125	0.0	51	G5ARS1	75	126	0.0	51
Q4VAB4	PF11938	2	84	2.5454698795180715	82	G5AVD1	1	83	1.5063373493975902	82
Q9DB42	PF12171	60	85	0.0	25	G5AUQ8	61	86	0.0	25
Q8CIP4	PF00069	58	309	7.387873015873012	251	G5BKT9	76	325	7.582919999999995	249
Q8CIP4	PF00627	332	365	16.968294117647062	33	G5BKT9	348	381	19.330970588235296	33
Q8CIP4	PF02149	712	751	0.13962500000000005	39	G5BKT9	682	721	0.14294871794871794	39
P83741	PF00069	225	478	2.0299685039370083	253	G5BWP5	171	424	2.0302637795275587	253
P83741	PF12202	499	561	0.008285714285714283	62	G5BWP5	445	507	0.008285714285714283	62
Q8K1S5	PF00096	383	407	0.0	24	G5B585	395	419	0.0	24
Q8K1S5	PF00096	413	437	0.1862	24	G5B585	425	449	0.0	24
Q8K1S5	PF00096	443	465	0.0	22	G5B585	455	477	0.0	22
Q8K3Q3	PF00250	196	281	2.860453488372092	85	G5BL20	193	278	2.846581395348838	85
Q811D0	PF00018	586	642	0.35768421052631577	56	G5ALD4	586	642	0.30708771929824563	56
Q811D0	PF00595	223	306	1.1805119047619048	83	G5ALD4	223	306	1.1837142857142855	83
Q811D0	PF00595	319	401	1.882843373493976	82	G5ALD4	319	401	5.68321686746988	82
Q811D0	PF00595	466	541	13.89031578947369	75	G5ALD4	466	541	14.453868421052626	75
Q811D0	PF00625	714	890	2.0812937853107347	176	G5ALD4	736	912	2.1215762711864405	176
Q811D0	PF09058	1	61	5.6111311475409815	60	G5ALD4	2	62	5.619524590163932	60
Q811D0	PF10600	403	464	0.051451612903225814	61	G5ALD4	403	464	0.05169354838709677	61
Q811D0	PF10608	105	222	0.024406779661016956	117	G5ALD4	106	222	0.0247008547008547	116
P48985	PF00010	156	207	0.7605000000000002	51	G5C884	157	208	0.7677115384615386	51
Q9JK30	PF07034	65	349	10.45804561403509	284	G5B6Y6	114	399	11.185975524475525	285
Q9JK30	PF18137	602	711	7.861081818181818	109	G5B6Y6	613	725	6.302353982300884	112
Q75NR7	PF00098	393	409	0.0	16	G5C5R6	392	408	0.0	16
Q75NR7	PF00270	499	662	4.705847560975612	163	G5C5R6	462	624	4.1496687116564415	162
Q75NR7	PF00271	762	829	10.881852941176467	67	G5C5R6	725	792	12.351147058823528	67
Q75NR7	PF11719	5	107	0.01529126213592233	102	G5C5R6	6	108	0.0	102
P53564	PF00046	1239	1295	2.5555789473684207	56	G5AXB2	1211	1267	2.562421052631579	56
P53564	PF02376	545	617	0.7123561643835615	72	G5AXB2	541	613	0.7416027397260275	72
P53564	PF02376	934	1002	0.06579710144927536	68	G5AXB2	906	974	0.0660144927536232	68
P53564	PF02376	1118	1192	0.17033333333333325	74	G5AXB2	1090	1164	0.2441333333333333	74
O88910	PF00595	138	213	2.528618421052631	75	G5BN83	141	216	3.155210526315789	75
O88910	PF00625	384	559	5.686806818181813	175	G5BN83	387	561	4.325817142857144	174
O88910	PF02828	12	62	1.1307450980392155	50	G5BN83	13	63	0.9050784313725491	50
O88910	PF02828	69	119	6.4136274509803926	50	G5BN83	70	122	2.247811320754717	52
Q9CRD2	PF14559	98	160	0.02	62	G5BSL5	85	147	0.01984126984126984	62
Q149G0	PF10573	8	125	3.298627118644068	117	G5BU85	9	125	3.3356923076923075	116
Q8CI11	PF01926	250	305	1.812821428571429	55	G5BUM8	249	304	0.5664821428571428	55
Q8CI11	PF08701	15	87	0.0	72	G5BUM8	12	84	0.0	72
Q8BXQ6	PF01433	434	651	1.7662798165137614	217	G5B6H2	433	650	2.2487935779816515	217
Q8BXQ6	PF09127	722	815	0.6330425531914893	93	G5B6H2	727	820	0.6776702127659576	93
Q4V9W2	PF13917	9	29	0.0	20	G5BNS8	8	28	0.0	20
B1AY10	PF01422	448	463	0.0	15	G5B044	446	461	0.0	15
B1AY10	PF01422	499	517	0.0	18	G5B044	497	515	0.07484210526315789	18
B1AY10	PF01422	560	578	0.0	18	G5B044	558	576	0.0	18
B1AY10	PF01422	625	647	0.0	22	G5B044	623	652	19.4141	29
B1AY10	PF01422	687	697	0.0	10	G5B044	692	702	0.0	10
B1AY10	PF01422	714	732	0.0	18	G5B044	719	737	0.0	18
B1AY10	PF01422	825	849	0.0	24	G5B044	830	854	0.0	24
B1AY10	PF01424	988	1052	3.802015384615385	64	G5B044	993	1057	4.757138461538461	64
Q9CQB2	PF14799	62	156	0.01735789473684211	94	G5B457	63	157	0.6555368421052633	94
P13346	PF00170	152	210	0.015627118644067798	58	G5BKU7	153	211	0.023440677966101692	58
Q69Z38	PF00069	1465	1647	3.2876830601092912	182	G5AL21	1476	1658	3.2200218579234954	182
Q9ERG0	PF00412	387	421	0.2052	34	G5BDI7	79	112	0.5209411764705882	33
P58463	PF00250	502	579	7.859205128205128	77	G5ARD7	465	542	7.859538461538461	77
P58463	PF16159	340	408	0.016594202898550726	68	G5ARD7	303	371	0.016594202898550726	68
P62627	PF03259	3	84	4.554195121951219	81	G5BPT4	4	84	4.648575	80
O88623	PF00443	275	603	2.120617021276596	328	G5BHP7	275	603	3.106328267477205	328
Q922G2	PF16046	3	296	4.957741496598639	293	G5AUU2	4	316	4.653111821086262	312
Q80W03	PF00505	253	321	9.235579710144926	68	G5BLU8	219	287	9.255695652173918	68
Q9WV92	PF00373	200	308	7.47762385321101	108	G5B1L2	195	303	7.472009174311928	108
Q9WV92	PF04382	555	603	0.0	48	G5B1L2	713	761	0.0	48
Q9WV92	PF05902	814	920	0.3049065420560747	106	G5B1L2	968	1074	0.30314953271028044	106
Q9WV92	PF08736	405	446	0.034166666666666665	41	G5B1L2	400	441	0.03404761904761905	41
Q9WV92	PF09379	121	183	1.7854126984126983	62	G5B1L2	116	178	1.7967936507936508	62
Q9WV92	PF09380	312	396	5.525364705882354	84	G5B1L2	307	391	5.507305882352943	84
Q9DB05	PF14938	8	287	1.4622785714285718	279	G5AV15	9	288	1.2832571428571429	279
Q2M2N2	PF00651	191	295	1.492428571428572	104	G5C8M0	192	296	0.8036857142857143	104
Q2M2N2	PF00917	64	160	9.017577319587627	96	G5C8M0	65	161	9.010855670103092	96
Q8K2A1	PF00640	26	153	7.170320312500002	127	G5AQB5	27	154	5.491984375000001	127
Q9WUB4	PF00132	99	130	2.9300625	31	G5B4H4	149	180	2.91640625	31
Q0VGY8	PF12796	935	1019	6.877070588235292	84	G5BZZ9	919	1003	10.15821176470588	84
Q0VGY8	PF12796	1046	1138	0.22515053763440854	92	G5BZZ9	1030	1122	2.0655806451612917	92
Q0VGY8	PF12796	1156	1234	12.978607594936712	78	G5BZZ9	1140	1218	12.982126582278486	78
Q499E5	PF10264	62	140	3.946645569620253	78	G5CAL1	1	79	3.9643164556962014	78
P61087	PF00179	7	146	4.467728571428572	139	G5AVR4	15	154	4.5443928571428565	139
P61087	PF00627	161	196	13.470472222222224	35	G5AVR4	169	204	13.759555555555556	35
Q9JL61	PF02257	89	165	0.2012337662337662	76	G5AK01	91	167	0.1462987012987013	76
Q9JL61	PF14621	450	655	0.15387864077669908	205	G5AK01	425	630	0.0	205
Q9JL61	PF18326	26	84	6.8545593220339	58	G5AK01	28	86	6.864813559322036	58
Q6PIJ4	PF14465	378	477	5.183579999999999	99	G5ALV9	391	490	7.716379999999999	99
P55098	PF00097	243	282	36.724625	39	G5BUW0	244	283	22.346925	39
P55098	PF04757	27	223	14.188370558375635	196	G5BUW0	28	224	13.791177664974613	196
P58465	PF03031	106	265	3.3678875	159	G5ATL3	187	346	3.367018750000001	159
Q8R2U0	PF00400	10	39	0.0	29	G5C082	11	40	0.0	29
Q8R2U0	PF00400	272	305	1.1343529411764706	33	G5C082	273	306	1.0583823529411762	33
P40142	PF00456	47	268	7.518477477477477	221	G5BUP0	1	245	7.792751020408164	244
P40142	PF02779	313	474	3.329351851851849	161	G5BUP0	290	451	3.281030864197529	161
P40142	PF02780	492	611	1.2602500000000003	119	G5BUP0	469	588	0.9646833333333336	119
Q3UMC0	PF00004	389	521	9.24944360902256	132	G5C798	383	515	6.763157894736841	132
Q3UMC0	PF00004	663	795	2.989977443609023	132	G5C798	657	789	4.157969924812028	132
Q3UMC0	PF17862	548	580	0.0	32	G5C798	542	574	0.01975757575757576	32
Q3UMC0	PF17862	818	862	3.276311111111112	44	G5C798	812	856	2.9886	44
Q80UN9	PF01715	57	310	7.152736220472446	253	G5C408	77	301	2.0066888888888887	224
Q80UN9	PF12171	394	418	0.0	24	G5C408	360	384	0.0	24
Q8C1B2	PF00644	472	648	4.7157909604519785	176	G5B0N8	292	468	4.841338983050849	176
Q99N50	PF00168	659	770	0.7087946428571429	111	G5CAD4	1454	1565	0.6979285714285712	111
Q99N50	PF00168	808	912	0.09286666666666664	104	G5CAD4	1603	1708	0.12065094339622642	105
P35441	PF00090	382	427	0.0	45	G5BM62	1064	1109	0.0	45
P35441	PF00090	438	488	0.0	50	G5BM62	1120	1170	0.0	50
P35441	PF00090	495	545	0.0	50	G5BM62	1177	1227	0.0	50
P35441	PF00093	317	371	0.0	54	G5BM62	999	1053	0.0	54
P35441	PF02412	726	761	0.0	35	G5BM62	1408	1443	0.0	35
P35441	PF02412	762	784	0.0	22	G5BM62	1444	1466	0.0	22
P35441	PF02412	786	820	0.3247142857142857	34	G5BM62	1468	1502	0.3281428571428571	34
P35441	PF02412	821	843	0.0	22	G5BM62	1503	1525	0.0	22
P35441	PF02412	845	881	0.0	36	G5BM62	1527	1563	0.0	36
P35441	PF02412	883	917	0.0	34	G5BM62	1565	1599	0.0	34
P35441	PF02412	918	948	0.0	30	G5BM62	1600	1630	0.0	30
P35441	PF05735	971	1168	7.074505050505053	197	G5BM62	1653	1849	7.188309644670051	196
P70338	PF00096	255	278	0.0	23	G5AZW8	253	276	0.0	23
P70338	PF00096	284	306	0.0	22	G5AZW8	282	304	0.0	22
P70338	PF00096	312	334	0.0	22	G5AZW8	310	332	0.0	22
P70338	PF00096	340	362	0.0	22	G5AZW8	338	360	0.0	22
P70338	PF00096	368	390	0.0	22	G5AZW8	366	388	0.0	22
P70338	PF00096	398	419	0.0	21	G5AZW8	396	417	0.0	21
Q8BYH7	PF00566	314	515	12.733440594059415	201	G5B8R3	308	508	12.125194999999998	200
Q8BYH7	PF12068	6	203	8.656186868686866	197	G5B8R3	1	199	8.796125628140704	198
O09012	PF13181	556	587	0.0345	31	G5CAS9	547	578	0.0345	31
O09012	PF13432	341	403	6.155412698412702	62	G5CAS9	330	392	6.159365079365081	62
O09012	PF13432	500	553	2.209203703703704	53	G5CAS9	491	544	2.660962962962962	53
P70191	PF00097	44	81	0.0	37	G5BAN3	45	82	0.245	37
P70191	PF02176	127	182	1.9463571428571431	55	G5BAN3	151	206	10.169785714285718	55
Q8BTS4	PF13874	312	439	0.1216953125	127	G5BJR1	317	443	0.12162992125984252	126
Q8BTS4	PF18437	455	492	7.624447368421053	37	G5BJR1	459	496	7.591605263157895	37
Q9CWS4	PF07521	377	437	1.2495081967213115	60	G5ATQ5	451	511	1.2884262295081963	60
Q9CWS4	PF10996	244	362	5.362697478991596	118	G5ATQ5	318	436	5.347983193277312	118
Q9CWS4	PF16661	21	193	1.343947976878613	172	G5ATQ5	95	267	1.2389190751445094	172
Q8K3Z0	PF00619	13	94	6.989317073170728	81	G5C251	73	153	7.218419753086421	80
Q8K3Z0	PF05729	272	441	7.148799999999992	169	G5C251	332	501	6.965135294117651	169
Q8K3Z0	PF13516	798	811	12.435142857142855	13	G5C251	858	870	0.016153846153846154	12
Q8K3Z0	PF13516	849	871	0.02517391304347826	22	G5C251	909	931	0.06456521739130434	22
Q8K3Z0	PF13516	906	927	3.2134545454545456	21	G5C251	966	987	1.4675454545454545	21
Q8K3Z0	PF13516	961	982	0.12118181818181817	21	G5C251	993	1014	0.0	21
Q8K3Z0	PF17776	582	736	14.893916129032256	154	G5C251	642	796	14.539374193548396	154
Q8K3Z0	PF17779	525	568	8.214954545454544	43	G5C251	585	628	17.446045454545455	43
P34057	PF13499	99	173	18.479533333333325	74	G5B5H6	100	174	17.83297333333334	74
P34057	PF13833	39	86	3.404208333333333	47	G5B5H6	40	87	5.146041666666666	47
Q8K1Y2	PF00069	578	830	8.674588932806328	252	G5BZ85	580	832	8.674703557312252	252
Q8K1Y2	PF00130	154	204	3.9300784313725496	50	G5BZ85	155	205	3.931705882352942	50
Q8K1Y2	PF00130	271	320	0.0	49	G5BZ85	272	321	0.0	49
Q8K1Y2	PF00169	416	495	5.514950000000002	79	G5BZ85	417	496	4.7527624999999984	79
P53349	PF00069	1225	1488	2.6691856060606067	263	G5AU77	1078	1341	2.672329545454545	263
P53349	PF04434	332	358	31.859222222222208	26	G5AU77	175	201	31.432148148148144	26
Q8CJF7	PF13934	721	943	9.774753363228696	222	G5ALP6	537	759	10.240089686098656	222
Q8CJF7	PF16687	185	488	7.203996710526319	303	G5ALP6	1	304	8.66088815789474	303
Q80X53	PF15774	17	216	0.10684499999999998	199	G5BKG6	18	218	0.3226965174129353	200
Q61818	PF13771	1806	1837	29.31471875	31	G5BMW5	1832	1862	28.976322580645146	30
P62334	PF00004	170	301	0.5371666666666666	131	G5BLP5	185	316	0.5358712121212122	131
P62334	PF16450	56	111	1.1431071428571429	55	G5BLP5	71	126	1.1374821428571429	55
P62334	PF17862	325	367	0.5236046511627908	42	G5BLP5	340	382	0.5222325581395348	42
Q9JIK5	PF00270	281	451	3.820877192982456	170	G5B803	204	373	4.183276470588234	169
Q9JIK5	PF00271	507	603	6.52734020618557	96	G5B803	430	526	4.146216494845361	96
Q9JIK5	PF08152	691	786	5.4762916666666674	95	G5B803	614	709	6.374822916666666	95
Q8CIE4	PF00644	775	953	7.185502793296091	178	G5C5U5	783	960	3.3026292134831463	177
Q7TNG8	PF01565	65	201	0.5083065693430657	136	G5B5X3	66	202	0.8199489051094888	136
Q7TNG8	PF02913	242	482	2.487352697095436	240	G5B5X3	243	440	3.411833333333333	197
D3YWJ0	PF00350	103	323	6.184402714932128	220	G5B4Z6	106	330	6.103644444444446	224
P60824	PF00076	7	77	9.05460563380282	70	G5AZK4	8	78	8.915000000000003	70
Q8CF02	PF15825	45	87	0.10800000000000001	42	G5ATF8	61	103	0.0	42
Q38HM4	PF00643	119	151	1.812515151515152	32	G5AUQ4	120	152	1.8004545454545453	32
Q38HM4	PF13445	22	75	0.1987037037037037	53	G5AUQ4	23	76	0.19722222222222227	53
Q9D752	PF02301	17	102	14.766558139534881	85	G5C511	18	103	14.767837209302325	85
O35250	PF03081	313	689	4.634005305039792	376	G5AQV6	337	713	4.521519893899201	376
O70166	PF00836	38	174	0.05557664233576643	136	G5C8C5	94	263	0.043705882352941185	169
Q61066	PF00104	254	450	2.166751269035533	196	G5BQK0	217	405	0.7071904761904757	188
Q61066	PF14046	0	46	5.622978723404256	46	G5BQK0	1	50	1.62626	49
Q61066	PF14046	67	115	2.9821428571428568	48	G5BQK0	71	117	1.1886382978723409	46
Q61066	PF14046	135	181	8.527617021276598	46	G5BQK0	138	183	8.468956521739129	45
Q61066	PF14046	202	245	0.01375	43	G5BQK0	138	184	8.288765957446806	46
Q9Z2W1	PF00069	19	269	5.5565378486055765	250	G5C3R9	12	262	5.554402390438251	250
P11499	PF00183	190	701	2.8914160156250013	511	G5BNN8	191	703	2.8858518518518537	512
P11499	PF02518	34	187	9.541577922077924	153	G5BNN8	35	188	9.53538311688312	153
Q5SVR0	PF00566	512	715	24.022313725490193	203	G5C7A9	480	683	24.02280882352941	203
Q5SVR0	PF02893	142	247	23.324971698113213	105	G5C7A9	104	209	24.30889622641511	105
Q5SVR0	PF02893	290	395	3.2860094339622634	105	G5C7A9	252	357	3.2873113207547173	105
Q9R112	PF07992	43	159	9.798196581196578	116	G5BR25	44	160	10.192931623931623	116
Q91YM2	PF00071	170	246	13.166519480519481	76	G5AV02	171	247	13.167051948051947	76
Q91YM2	PF00620	1261	1409	0.8341409395973151	148	G5AV02	1263	1411	0.8341006711409392	148
Q91YM2	PF01846	486	546	0.0	60	G5AV02	487	547	0.015868852459016394	60
Q91YM2	PF16512	260	339	0.223025	79	G5AV02	261	340	0.26948749999999994	79
Q8VC88	PF13833	66	121	5.578857142857144	55	G5AKB2	68	123	5.8452142857142855	55
Q64669	PF02525	4	211	8.403783653846148	207	G5AK39	4	211	6.007192307692307	207
O08856	PF07303	493	594	0.0	101	G5B069	450	551	0.2428529411764706	101
O08856	PF10390	61	288	0.7532149122807019	227	G5B069	16	245	0.6620347826086957	229
P59326	PF04146	389	522	7.401977611940298	133	G5C8D8	390	523	7.403947761194027	133
Q921G7	PF01946	63	114	5.182384615384618	51	G5AXY1	18	69	5.254096153846157	51
Q921G7	PF05187	510	613	0.09087499999999997	103	G5AXY1	465	568	0.14809615384615385	103
Q9CVD2	PF02099	107	165	19.8616779661017	58	G5AZL7	127	185	19.86522033898305	58
Q9CVD2	PF02809	223	238	0.0	15	G5AZL7	243	258	0.0	15
Q9CVD2	PF02809	243	258	0.0	15	G5AZL7	263	278	0.0	15
Q9CVD2	PF02809	328	343	0.6615624999999999	15	G5AZL7	347	362	0.287125	15
Q9CVD2	PF16619	263	321	0.0	58	G5AZL7	282	341	0.0	59
P27773	PF00085	26	129	0.12905769230769232	103	G5BM53	27	130	0.129125	103
P27773	PF00085	377	480	2.4865096153846147	103	G5BM53	378	481	2.4639903846153848	103
P27773	PF13848	168	354	1.1339090909090914	186	G5BM53	169	355	2.8110053475935826	186
Q9CQS5	PF01163	107	278	2.5513662790697675	171	G5C338	108	279	2.9401511627906967	171
Q9CQS5	PF09202	8	90	3.372987951807228	82	G5C338	9	91	3.3568313253012048	82
Q5U4D9	PF00400	160	195	0.30436111111111114	35	G5B1J1	137	172	0.3045555555555556	35
Q6PFD5	PF03359	625	976	0.10403124999999998	351	G5BJM9	628	979	0.1043105413105413	351
P22366	PF00531	29	105	2.209688311688312	76	G5C5P6	30	105	0.7218026315789478	75
P22366	PF01582	172	262	6.846065934065938	90	G5C5P6	173	263	6.839780219780216	90
Q3TNA1	PF00370	147	301	6.907025806451613	154	G5C5P4	133	287	8.429219354838704	154
Q3TNA1	PF02782	310	493	4.43425	183	G5C5P4	296	479	3.725385869565215	183
Q6PDJ6	PF07646	230	273	3.5223863636363637	43	G5BRU7	231	274	3.1500227272727277	43
Q6PDJ6	PF12937	47	81	7.776542857142857	34	G5BRU7	48	82	7.7700857142857105	34
Q6PDJ6	PF13415	130	181	8.145692307692308	51	G5BRU7	131	182	9.606923076923078	51
Q8CGA2	PF00566	405	628	13.01483482142857	223	G5B2Z6	405	628	13.032325892857143	223
Q3TQI7	PF07052	100	196	0.0	96	G5ASB6	101	197	0.0	96
Q9D439	PF13868	156	488	0.0	332	G5BVS4	153	484	0.030439759036144563	331
O88291	PF04988	336	471	0.7321985294117648	135	G5AN33	316	450	0.7737407407407408	134
P11032	PF00089	28	251	3.636678571428571	223	G5C6X5	29	254	4.311393805309733	225
Q3U1Y4	PF02141	314	431	12.378279661016945	117	G5BES0	340	450	7.647909909909908	110
Q3U1Y4	PF03455	602	651	6.45766	49	G5BES0	495	544	0.028860000000000004	49
Q3U1Y4	PF03456	213	277	11.1934	64	G5BES0	239	303	11.23975384615384	64
Q9WVG7	PF00096	174	196	2.0260869565217394	22	G5AZB0	176	198	2.0256521739130435	22
Q9WVG7	PF00096	202	224	0.0	22	G5AZB0	204	226	0.0	22
Q9WVG7	PF00096	230	252	0.0	22	G5AZB0	232	254	0.0	22
Q8BZ60	PF00928	556	870	0.7117460317460319	314	G5AJR9	570	884	0.9088444444444448	314
Q8BZ60	PF12016	27	336	0.1365612903225807	309	G5AJR9	42	350	0.07076699029126214	308
O08983	PF19036	1	158	19.446177215189874	157	G5C4V2	2	159	16.692544303797472	157
O08983	PF19037	203	407	9.94829268292683	204	G5C4V2	204	414	9.86122274881517	210
O08983	PF19038	543	696	9.215136363636358	153	G5C4V2	551	704	7.939324675324674	153
Q07105	PF00019	338	439	0.9330196078431372	101	G5BFF5	346	447	2.277186274509804	101
P62754	PF01092	2	107	1.8123679245283015	105	G5B2J7	16	122	0.007850467289719627	106
Q9Z1L3	PF01335	25	105	14.495827160493825	80	G5BWI6	26	106	14.493543209876542	80
Q9WV32	PF00400	41	78	3.5426578947368426	37	G5AX89	42	79	4.5089736842105275	37
Q9WV32	PF00400	143	168	7.019961538461539	25	G5AX89	144	169	8.317538461538463	25
Q9D4G9	PF08585	14	203	1.6660578947368423	189	G5ARM8	15	204	1.7659315789473675	189
Q9D4G9	PF16099	478	613	10.761551470588243	135	G5ARM8	477	612	13.630860294117648	135
Q7TSV4	PF00408	547	580	11.942264705882357	33	G5C3W5	514	547	11.970117647058823	33
Q7TSV4	PF02878	62	207	4.6466438356164375	145	G5C3W5	29	174	3.945506849315066	145
Q7TSV4	PF02879	235	340	8.702037735849057	105	G5C3W5	202	307	6.995377358490567	105
Q7TSV4	PF02880	351	478	11.274828125	127	G5C3W5	318	445	11.272023437500005	127
Q8BTG7	PF03096	7	288	4.984748226950353	281	G5AUG9	48	329	5.14057446808511	281
O88697	PF00069	21	286	3.931436090225564	265	G5AKJ9	22	287	7.62161654135338	265
B2RQC2	PF00443	110	407	6.2831879194630895	297	G5BF38	95	392	6.725395973154364	297
P35700	PF00578	7	140	6.619179104477613	133	G5ARW1	8	141	6.606365671641793	133
P35700	PF10417	161	196	0.3791111111111111	35	G5ARW1	162	197	0.29697222222222225	35
A2AJL3	PF00370	11	267	8.020789883268485	256	G5APN7	11	267	8.549669260700394	256
A2AJL3	PF02782	290	496	10.733913043478266	206	G5APN7	290	527	12.522424369747903	237
Q8CFV9	PF01687	4	128	10.137695999999998	124	G5BLA1	5	129	10.116031999999997	124
Q8C437	PF13181	300	333	9.160264705882351	33	G5BX61	317	350	9.167235294117646	33
Q8C437	PF13181	483	514	4.1350625	31	G5BX61	500	531	4.1395625	31
Q8C437	PF13432	428	480	0.7205849056603774	52	G5BX61	445	497	0.7215283018867923	52
Q09M02	PF00246	238	323	1.960290697674419	85	G5BYZ0	239	324	1.9581279069767443	85
Q09M02	PF18027	9	140	6.9907121212121215	131	G5BYZ0	10	141	6.0752424242424246	131
Q9EQQ9	PF07555	74	345	3.5607904411764713	271	G5CAG2	1	272	3.563055147058824	271
O89033	PF09079	467	544	6.665	77	G5BRV9	466	543	5.91028205128205	77
O89033	PF13401	194	317	10.955862903225805	123	G5BRV9	191	314	11.328637096774195	123
O89033	PF17872	369	406	0.0666842105263158	37	G5BRV9	366	404	0.013717948717948718	38
P27577	PF00178	335	414	1.6532749999999996	79	G5BRN7	380	459	1.5758375	79
P27577	PF02198	53	134	5.090499999999998	81	G5BRN7	98	179	5.048353658536584	81
P17225	PF00076	453	513	0.06222950819672132	60	G5C5X1	473	535	0.04841269841269842	62
P17225	PF11835	176	256	2.2577283950617297	80	G5C5X1	167	247	2.2350493827160505	80
P17225	PF13893	57	140	1.4043095238095242	83	G5C5X1	47	130	1.384952380952381	83
P17225	PF13893	311	429	8.115159663865548	118	G5C5X1	328	448	7.9686942148760345	120
Q66JT0	PF00069	209	477	5.966159851301116	268	G5B579	229	498	8.143240740740747	269
Q8C170	PF00063	148	689	8.032298892988926	541	G5C6U1	149	690	8.239267527675281	541
Q8C170	PF00063	879	1004	1.2230555555555556	125	G5C6U1	879	1004	1.1540793650793648	125
Q8C170	PF00612	1043	1063	0.5045714285714286	20	G5C6U1	1043	1063	3.4779047619047616	20
Q8C170	PF00612	1076	1094	3.379105263157895	18	G5C6U1	1076	1094	6.7198947368421065	18
Q8C170	PF00612	1116	1136	0.0	20	G5C6U1	1116	1136	0.0	20
Q8C170	PF00612	1140	1158	6.7535263157894745	18	G5C6U1	1140	1157	15.740166666666665	17
Q8C170	PF00620	2077	2224	8.322614864864864	147	G5C6U1	2155	2302	8.330641891891894	147
Q8C170	PF00788	14	110	0.5997422680412371	96	G5C6U1	15	111	0.0	96
Q07230	PF00096	221	243	0.0	22	G5B1S4	220	242	0.0	22
Q07230	PF00096	249	271	0.0	22	G5B1S4	248	270	0.0	22
Q07230	PF00096	277	299	0.0	22	G5B1S4	276	298	0.0	22
Q07230	PF00096	305	327	0.0	22	G5B1S4	304	326	0.0	22
Q07230	PF00096	333	355	0.0	22	G5B1S4	332	354	0.0	22
Q07230	PF00096	361	383	0.0	22	G5B1S4	360	382	0.0	22
Q07230	PF00096	389	411	0.026086956521739132	22	G5B1S4	388	410	0.026304347826086955	22
Q07230	PF00096	417	439	0.0	22	G5B1S4	416	438	0.0	22
Q07230	PF00096	445	467	0.0	22	G5B1S4	444	466	0.0	22
Q07230	PF00096	473	495	0.0	22	G5B1S4	472	494	0.0	22
Q07230	PF00096	501	523	0.02717391304347826	22	G5B1S4	500	522	0.02739130434782609	22
Q07230	PF00096	529	551	0.8638260869565219	22	G5B1S4	528	550	0.4185217391304348	22
Q07230	PF00096	557	579	13.018086956521733	22	G5B1S4	556	578	13.050521739130433	22
Q07230	PF00096	589	607	0.0	18	G5B1S4	585	603	0.0	18
Q07230	PF02023	67	130	0.2365312500000001	63	G5B1S4	71	134	0.052890625	63
Q80ZM3	PF06325	105	177	0.7643424657534246	72	G5AUP4	108	180	0.6718493150684933	72
P60003	PF05129	1	78	0.4693717948717948	77	G5AJT6	2	79	0.4693717948717948	77
P63277	PF02948	27	209	0.6575846994535519	182	G5C947	28	210	1.1678791208791208	182
Q9R059	PF00412	39	96	0.01939655172413793	57	G5C6I1	40	97	0.0	57
Q9R059	PF00412	100	157	0.0	57	G5C6I1	101	158	0.0	57
Q9R059	PF00412	161	214	0.1961851851851852	53	G5C6I1	162	215	0.13901851851851849	53
Q9R059	PF00412	220	285	0.0	65	G5C6I1	221	277	0.0	56
Q9CPY3	PF09666	87	226	0.07614285714285714	139	G5B6M2	76	198	0.0	122
Q8BJ73	PF15913	38	134	4.109278350515466	96	G5AJQ8	39	135	3.135123711340207	96
Q9EQH2	PF01433	269	478	3.8862142857142836	209	G5C345	270	479	1.4557523809523814	209
Q9EQH2	PF11838	585	904	5.4724999999999975	319	G5C345	586	905	7.264003124999999	319
Q9EQH2	PF17900	48	234	5.9697379679144404	186	G5C345	49	235	5.999983957219253	186
Q8BFW3	PF10472	27	392	1.0299153005464483	365	G5BMM3	30	408	1.789395778364116	378
Q8BFW3	PF10488	396	681	0.594437062937063	285	G5BMM3	413	699	0.3052822299651569	286
O89019	PF00023	47	77	12.000451612903225	30	G5AZ29	48	78	2.5221935483870968	30
O89019	PF00023	488	509	1.452590909090909	21	G5AZ29	489	510	1.6132272727272727	21
O89019	PF00612	557	575	0.3949473684210527	18	G5AZ29	558	576	0.34410526315789475	18
O89019	PF00612	915	933	0.2421052631578948	18	G5AZ29	909	927	0.18105263157894733	18
O89019	PF12796	84	176	0.7897956989247311	92	G5AZ29	85	177	0.7951290322580644	92
O89019	PF12796	178	248	0.033239436619718316	70	G5AZ29	179	249	0.05211267605633802	70
O89019	PF12796	255	310	3.3702678571428564	55	G5AZ29	256	311	2.518267857142857	55
O89019	PF12796	318	386	0.14007246376811594	68	G5AZ29	319	387	0.1361159420289855	68
O89019	PF12796	393	485	1.6341612903225813	92	G5AZ29	394	486	2.2926881720430106	92
Q62481	PF05764	6	215	0.027780952380952382	209	G5AJZ6	7	218	0.02931132075471698	211
Q62481	PF08265	294	322	0.0	28	G5AJZ6	292	320	0.0	28
Q9QYZ8	PF04706	77	127	0.0	50	G5AQK5	78	128	0.0	50
Q99MR8	PF00289	44	152	1.974394495412844	108	G5ALA3	48	156	1.9004862385321102	108
Q99MR8	PF00364	646	708	8.483253968253969	62	G5ALA3	633	695	10.441619047619048	62
Q99MR8	PF02785	378	485	3.951185185185184	107	G5ALA3	394	501	4.5397592592592595	107
Q99MR8	PF02786	158	364	2.3843913043478264	206	G5ALA3	162	380	2.0774748858447487	218
Q8K337	PF00620	914	968	30.486890909090906	54	G5C6H9	983	1036	30.97029629629629	53
Q8K337	PF03372	349	628	5.0729892857142875	279	G5C6H9	493	772	5.099389285714287	279
Q8K337	PF16776	0	146	6.575013605442178	146	G5C6H9	122	312	9.090565445026176	190
Q5SVT3	PF15350	87	864	0.32612210796915164	777	G5BA12	1	781	0.7636056338028172	780
P57748	PF00045	300	341	2.5350238095238096	41	G5BUC0	302	343	2.564238095238095	41
P57748	PF00045	345	386	10.095642857142854	41	G5BUC0	347	388	6.908571428571428	41
P57748	PF00045	392	436	11.629244444444444	44	G5BUC0	394	438	11.562088888888884	44
P57748	PF00045	441	481	19.832439024390236	40	G5BUC0	443	483	20.452075	40
P57748	PF00413	114	269	1.9288461538461537	155	G5BUC0	116	271	1.9552243589743592	155
P57748	PF01471	35	92	5.113068965517241	57	G5BUC0	37	94	1.9759137931034485	57
Q61214	PF00069	158	478	3.1944080996884683	320	G5AXI1	159	479	3.194570093457942	320
P51163	PF02602	18	251	1.4631880341880334	233	G5C969	19	252	1.5985769230769225	233
Q60787	PF00017	421	504	15.613071428571436	83	G5B469	422	505	14.742392857142885	83
Q60787	PF07647	12	73	0.1370967741935484	61	G5B469	13	74	0.12999999999999998	61
O08919	PF00640	79	200	5.195483606557375	121	G5C9X3	60	181	5.145795081967214	121
O08919	PF06311	287	370	0.0	83	G5C9X3	268	351	0.0	83
Q9DBM1	PF01585	153	178	0.23199999999999998	25	G5AUZ2	154	179	0.17307692307692307	25
Q9DBM1	PF07713	31	115	0.2689882352941177	84	G5AUZ2	32	116	1.840505882352941	84
Q8BG81	PF00076	283	343	6.667721311475412	60	G5BPS2	159	219	6.690901639344264	60
Q9JMC2	PF00096	230	252	0.0	22	G5B119	122	144	0.0	22
Q9JMC2	PF00096	353	375	0.0	22	G5B119	254	276	0.0	22
Q61048	PF00397	126	153	0.0	27	G5BN28	124	151	0.0	27
Q61048	PF00397	169	194	0.6770384615384616	25	G5BN28	165	190	0.045	25
Q61048	PF06220	7	42	0.0	35	G5BN28	7	42	0.0	35
B2RQE8	PF00169	232	334	1.3382524271844658	102	G5BUA8	267	369	1.4320873786407768	102
B2RQE8	PF00620	362	511	6.006093333333332	149	G5BUA8	397	546	6.094853333333331	149
B2RQE8	PF14604	789	837	0.6123061224489796	48	G5BUA8	823	871	0.785265306122449	48
B2RQE8	PF16746	5	128	2.9982661290322588	123	G5BUA8	6	128	2.7445853658536588	122
Q5DU09	PF00096	244	266	0.0	22	G5C4P0	247	269	0.0	22
Q5DU09	PF00096	355	377	0.0	22	G5C4P0	358	380	0.0	22
Q5DU09	PF00096	383	405	0.0	22	G5C4P0	386	408	0.0	22
Q5DU09	PF00096	439	461	0.0	22	G5C4P0	442	464	0.0	22
Q5DU09	PF12874	327	346	0.09175	19	G5C4P0	330	349	0.092	19
P51863	PF01992	15	346	7.727159638554212	331	G5C662	16	348	7.406045045045045	332
P28184	PF00131	0	67	0.0	67	G5CAW2	1	68	0.029402985074626863	67
O09159	PF01074	63	380	2.2200534591194963	317	G5BYY1	65	396	4.90418373493976	331
O09159	PF07748	607	822	1.7738101851851864	215	G5BYY1	618	838	2.578556561085973	220
O09159	PF09261	386	482	2.6491340206185563	96	G5BYY1	402	498	2.1057835051546405	96
O09159	PF17677	900	1001	2.047686274509804	101	G5BYY1	875	976	1.5243627450980393	101
O08736	PF00656	175	413	4.6265690376569015	238	G5BVT9	36	277	12.49936776859504	241
Q14C37	PF03020	2	41	0.289875	39	G5BX42	3	52	0.07474	49
Q3V300	PF00225	43	362	2.7197281249999987	319	G5BYM5	33	352	3.360734375000001	319
Q3V300	PF12836	590	641	3.2370769230769234	51	G5BYM5	585	636	0.8133653846153847	51
Q8K396	PF03962	15	74	0.4826	59	G5BMK0	15	74	2.0859	59
Q8K396	PF18517	150	203	0.8242592592592594	53	G5BMK0	150	203	0.8216666666666668	53
Q3TL44	PF05729	160	319	9.455068749999997	159	G5BHP0	156	315	9.18730625	159
Q3TL44	PF13516	805	827	0.036652173913043484	22	G5BHP0	798	820	0.0	22
Q3UK78	PF13923	17	55	1.413948717948718	38	G5BV04	18	56	0.9624615384615384	38
Q3UK78	PF16207	162	215	3.7159814814814816	53	G5BV04	162	215	3.724888888888889	53
Q60710	PF01966	195	350	1.7881217948717951	155	G5B828	163	318	2.5495384615384604	155
Q60710	PF07647	75	138	0.396828125	63	G5B828	43	106	0.07656249999999998	63
P61219	PF01192	50	103	1.7866111111111114	53	G5AYS1	51	104	1.7866111111111114	53
O70283	PF00110	72	377	2.2387810457516335	305	G5BNW6	138	443	2.238261437908497	305
Q91ZK4	PF00046	71	127	0.3485087719298246	56	G5BYG9	73	129	0.35017543859649125	56
Q91ZK4	PF03826	355	371	0.0	16	G5BYG9	354	370	0.0	16
Q9D8N0	PF00043	107	197	16.0399010989011	90	G5AYH2	156	246	16.129582417582427	90
Q9D8N0	PF00647	274	380	8.962803738317756	106	G5AYH2	323	429	9.060644859813083	106
Q9D8N0	PF02798	4	79	5.133171052631579	75	G5AYH2	53	128	5.071934210526316	75
Q8C0Y1	PF05920	35	74	15.899874999999998	39	G5B835	36	75	15.883225	39
Q99J09	PF00400	122	152	13.241774193548386	30	G5BNX9	123	153	11.674	30
Q99J09	PF00400	159	195	0.7860540540540542	36	G5BNX9	160	196	0.8222972972972972	36
P51125	PF00748	214	303	0.010055555555555555	89	G5C346	105	192	0.00875	87
P51125	PF00748	312	437	0.0	125	G5C346	202	328	0.0	126
P51125	PF00748	450	576	0.0	126	G5C346	341	470	0.004807692307692308	129
P51125	PF00748	589	714	0.04344444444444444	125	G5C346	483	608	0.5514682539682539	125
O08762	PF00530	168	264	0.0	96	G5BC35	164	260	0.0	96
O08762	PF00530	276	370	0.11582105263157895	94	G5BC35	272	366	1.137178947368421	94
O08762	PF00530	389	484	0.3476041666666667	95	G5BC35	385	480	0.4376250000000001	95
O08762	PF00051	92	156	0.0	64	G5BC35	88	152	0.7904615384615381	64
O08762	PF00089	516	595	7.167250000000001	79	G5BC35	512	590	7.073935897435898	78
Q9WU20	PF02219	46	335	4.23865517241379	289	G5C506	40	329	1.908551724137929	289
Q78JE5	PF00646	26	61	2.040833333333333	35	G5AUJ8	14	49	1.3955277777777781	35
Q78JE5	PF10442	298	362	9.064492307692307	64	G5AUJ8	287	351	12.109107692307687	64
D3Z5L9	PF00007	278	347	6.212685714285715	69	G5AUB7	167	236	1.7227142857142859	69
D3Z5L9	PF19035	208	251	0.0	43	G5AUB7	97	140	0.0	43
Q9R0M6	PF00071	23	172	3.6962133333333336	149	G5AK63	1	150	3.697053333333333	149
Q8CDI2	PF01485	557	612	5.139714285714286	55	G5ANZ2	520	575	5.1271071428571435	55
Q91WG8	PF00480	409	713	6.22568524590164	304	G5B0H7	491	795	5.7506196721311476	304
Q91WG8	PF02350	37	374	3.0664822485207117	337	G5B0H7	119	456	3.0682573964497055	337
Q7TNH6	PF13176	1257	1288	2.709625	31	G5BKR4	1262	1293	2.71971875	31
Q7TNH6	PF13424	937	1010	1.4814999999999996	73	G5BKR4	942	1015	1.8781486486486487	73
Q7TNH6	PF13424	1113	1160	0.02177083333333333	47	G5BKR4	1118	1165	0.2460416666666667	47
Q7TNH6	PF13424	1176	1244	12.56128985507246	68	G5BKR4	1181	1249	15.263420289855073	68
Q64701	PF01857	785	937	9.392633986928107	152	G5B827	785	941	8.013509554140125	156
Q64701	PF01858	384	577	13.535139175257731	193	G5B827	385	578	11.91242268041237	193
Q64701	PF11934	78	211	11.961305970149255	133	G5B827	79	212	12.117305970149259	133
Q5F2E7	PF15293	93	684	0.92120777027027	591	G5BVJ6	36	629	0.8871464646464645	593
P42859	PF12372	1492	1532	0.19378048780487805	40	G5BZF2	1386	1426	0.19365853658536586	40
A1E960	PF15424	15	264	0.08062399999999999	249	G5AYC3	16	269	0.5709288537549408	253
P59384	PF00090	520	569	0.0	49	G5B4C0	406	455	0.0	49
P59384	PF01421	226	426	9.807333333333327	200	G5B4C0	112	312	9.817577114427863	200
P59384	PF01562	23	113	6.151483516483519	90	G5B4C0	24	113	5.338711111111111	89
P59384	PF05986	683	800	5.546830508474573	117	G5B4C0	569	686	5.416271186440675	117
P59384	PF17771	437	504	0.23439705882352935	67	G5B4C0	323	390	0.23582352941176474	67
P59384	PF19030	842	891	0.0	49	G5B4C0	728	777	0.22842	49
P59384	PF19030	896	949	0.0	53	G5B4C0	782	835	0.0	53
Q8K3W0	PF06113	43	332	8.495837931034487	289	G5C2Z0	1	290	8.493668965517239	289
P12813	PF00104	402	580	12.851262569832413	178	G5ATX6	427	578	16.099013157894742	151
P12813	PF00105	268	336	0.8250289855072466	68	G5ATX6	293	361	0.8248550724637681	68
Q03963	PF00035	8	73	11.995621212121206	65	G5BZ81	10	75	10.984636363636362	65
Q03963	PF00035	95	159	4.114153846153847	64	G5BZ81	101	165	0.5970615384615384	64
Q03963	PF00069	241	497	3.1762295719844365	256	G5BZ81	253	508	4.685999999999999	255
D3Z690	PF15005	25	165	1.8265390070921987	140	G5BBB9	16	156	0.6931914893617022	140
P14115	PF00828	27	144	2.4045423728813557	117	G5BUW4	28	145	2.58142372881356	117
Q91Z53	PF00389	8	115	3.0387222222222223	107	G5C1E1	9	116	6.148898148148147	107
Q91Z53	PF02826	116	245	7.646453846153847	129	G5C1E1	117	245	9.57115625	128
Q9D2Q3	PF14958	59	158	3.3421	99	G5AKG4	117	217	0.9868316831683164	100
Q8C4Q6	PF14186	155	298	4.7928472222222265	143	G5C186	157	300	3.5944375	143
Q8C4Q6	PF08910	9	111	0.12927184466019415	102	G5C186	10	112	0.16291262135922327	102
Q8VBT9	PF00789	382	453	8.989583333333334	71	G5BJ88	376	447	7.981569444444443	71
Q8VBT9	PF11470	31	77	2.5310000000000006	46	G5BJ88	22	68	7.369106382978723	46
Q8BW41	PF04577	164	390	6.516524229074887	226	G5ALY7	165	391	6.3655462555066125	226
Q9D2G2	PF00198	222	450	3.5556855895196495	228	G5C1L8	223	451	3.5592445414847167	228
Q9D2G2	PF00364	72	143	0.048125	71	G5C1L8	73	144	0.03136111111111111	71
Q05512	PF00069	52	303	7.433234126984127	251	G5B6G2	35	286	7.431051587301588	251
Q05512	PF00627	324	359	16.220138888888883	35	G5B6G2	307	342	18.494472222222225	35
Q05512	PF02149	733	775	0.0	42	G5B6G2	729	771	0.0	42
Q5RJH6	PF10373	170	427	12.318720930232566	257	G5B447	129	387	12.239471042471047	258
Q5RJH6	PF10374	54	166	0.7963716814159297	112	G5B447	13	125	0.805495575221239	112
Q05769	PF00008	21	52	0.0	31	G5C6B9	22	53	0.1428125	31
Q05769	PF03098	131	201	7.5187323943661974	70	G5C6B9	132	202	7.419802816901409	70
Q05769	PF03098	211	510	6.186610000000003	299	G5C6B9	212	511	6.0006099999999964	299
Q9Z2C4	PF02893	103	209	3.0921588785046743	106	G5C9P0	52	158	0.8694112149532713	106
Q9Z2C4	PF06602	216	552	7.253376854599407	336	G5C9P0	165	501	5.231510385756678	336
Q9WVK4	PF00350	60	220	6.434888198757767	160	G5B6N5	61	221	6.0010186335403715	160
Q9WVK4	PF12763	445	530	1.1407790697674416	85	G5B6N5	446	531	1.1407790697674416	85
Q9WVK4	PF16880	23	55	0.0	32	G5B6N5	24	56	0.0	32
Q9WVK4	PF18150	287	393	0.4955046728971963	106	G5B6N5	288	394	0.6116635514018692	106
Q8BXJ2	PF01448	786	840	0.13027272727272726	54	G5BNJ8	745	799	0.13018181818181818	54
Q8BXJ2	PF13912	513	533	0.07952380952380952	20	G5BNJ8	479	499	0.0	20
Q8BXJ2	PF13912	1025	1040	0.07906250000000001	15	G5BNJ8	983	998	0.06325	15
Q8BXJ2	PF13912	1091	1114	0.0	23	G5BNJ8	1049	1075	0.0	26
Q9CQL7	PF15155	0	85	0.3580581395348837	85	G5B2Z2	1	85	1.379435294117647	84
Q9JHH9	PF01217	39	176	15.736318840579713	137	G5BY18	29	166	19.71246376811593	137
P80317	PF00118	29	523	3.389551515151517	494	G5ASS3	30	524	3.394107070707073	494
Q3UPW2	PF00178	293	373	0.1490740740740741	80	G5B390	396	476	0.1490987654320988	80
Q3UPW2	PF02198	73	147	0.14709333333333333	74	G5B390	151	224	0.1481891891891892	73
Q8K4Q6	PF01149	27	122	4.844864583333334	95	G5AL75	54	149	9.0159375	95
Q8K4Q6	PF09292	251	289	0.38566666666666666	38	G5AL75	278	316	0.3872820512820513	38
Q9D2X8	PF17826	5	307	1.5211881188118828	302	G5AY85	6	298	3.273617747440274	292
Q9JIA1	PF03736	225	265	4.874853658536588	40	G5C705	226	266	4.839121951219514	40
Q9JIA1	PF03736	271	311	18.74741463414633	40	G5C705	272	312	18.74782926829268	40
Q9JIA1	PF03736	316	362	11.691021276595736	46	G5C705	317	363	12.036404255319152	46
Q9JIA1	PF03736	365	413	0.3047142857142857	48	G5C705	366	414	0.26918367346938776	48
Q9JIA1	PF03736	419	459	9.697560975609756	40	G5C705	420	460	9.693536585365852	40
Q9JIA1	PF03736	463	504	0.6449047619047621	41	G5C705	464	505	0.6438809523809524	41
Q9JIA1	PF03736	509	548	0.768825	39	G5C705	510	549	0.7678	39
Q9JIA1	PF13855	114	173	0.0	59	G5C705	115	174	0.0	59
E9Q4F7	PF00023	233	262	0.0	29	G5API6	428	457	0.0	29
E9Q4F7	PF12796	161	229	0.19531884057971016	68	G5API6	162	230	0.19660869565217384	68
Q70E20	PF00008	275	306	0.018593750000000003	31	G5C3R2	276	307	0.018593750000000003	31
Q70E20	PF00008	314	344	0.0	30	G5C3R2	315	345	0.0	30
Q70E20	PF00008	352	381	0.19863333333333336	29	G5C3R2	353	382	0.05366666666666667	29
Q70E20	PF00008	390	419	0.038	29	G5C3R2	391	420	0.0414	29
Q70E20	PF00008	432	460	0.0	28	G5C3R2	433	461	0.0	28
Q70E20	PF00008	544	574	0.0	30	G5C3R2	544	574	0.0	30
Q70E20	PF00008	583	613	0.0	30	G5C3R2	583	612	0.0	29
Q70E20	PF00008	622	652	0.05425806451612903	30	G5C3R2	622	652	0.054290322580645166	30
Q70E20	PF00008	660	690	0.0	30	G5C3R2	660	690	0.0	30
Q70E20	PF00008	756	785	0.0	29	G5C3R2	756	785	0.0	29
Q70E20	PF00008	794	824	0.06225806451612904	30	G5C3R2	794	824	0.34374193548387105	30
Q70E20	PF00008	832	860	0.8559310344827584	28	G5C3R2	841	869	0.8590689655172415	28
Q70E20	PF00008	1309	1339	0.0	30	G5C3R2	1436	1465	0.0	29
Q70E20	PF00041	907	986	0.98155	79	G5C3R2	1030	1109	4.6963125	79
Q70E20	PF00041	1006	1083	0.1850384615384616	77	G5C3R2	1129	1206	3.4295641025641017	77
Q70E20	PF00041	1105	1183	3.3172405063291133	78	G5C3R2	1228	1306	3.3461898734177216	78
Q70E20	PF06119	168	255	6.47615909090909	87	G5C3R2	169	256	4.279136363636365	87
Q70E20	PF12661	473	493	0.8686666666666667	20	G5C3R2	473	493	1.6647619047619049	20
Q922H7	PF00071	33	199	7.097023952095809	166	G5AU59	35	201	5.560604790419164	166
Q8K349	PF04548	104	294	9.363057591623036	190	G5AMK6	25	215	10.18694240837696	190
Q8C0L8	PF10392	35	157	0.05861788617886179	122	G5C2D2	36	158	0.08401626016260162	122
P53808	PF01852	11	193	8.13536612021858	182	G5BPA6	9	190	2.4588021978021968	181
Q9R1R0	PF00046	219	275	3.8185789473684206	56	G5AJL6	198	222	0.90996	24
Q9R1R0	PF00412	69	126	0.09094827586206894	57	G5AJL6	48	105	0.11855172413793096	57
Q9R1R0	PF00412	130	184	1.2893272727272729	54	G5AJL6	109	163	1.2879272727272728	54
Q8VEB3	PF15435	2	200	0.7290351758793969	198	G5B9C8	3	201	0.729030150753769	198
Q9D5J6	PF00370	6	260	7.007443137254902	254	G5B937	7	261	6.181501960784316	254
C3VPR6	PF05729	222	384	9.844963190184043	162	G5BR73	280	446	7.360335329341319	166
C3VPR6	PF13516	871	889	0.0	18	G5BR73	931	949	0.0	18
C3VPR6	PF13516	1007	1025	14.092789473684213	18	G5BR73	1064	1082	0.3027894736842105	18
C3VPR6	PF13516	1577	1596	0.16405	19	G5BR73	1610	1629	8.4523	19
C3VPR6	PF13516	1605	1624	0.14925	19	G5BR73	1610	1629	8.4523	19
C3VPR6	PF13516	1661	1680	0.14925	19	G5BR73	1610	1629	8.4523	19
C3VPR6	PF13516	1689	1707	0.0	18	G5BR73	1638	1656	0.0	18
C3VPR6	PF13516	1851	1870	0.06915	19	G5BR73	1800	1819	5.7787500000000005	19
C3VPR6	PF17776	516	631	7.372448275862068	115	G5BR73	575	689	7.315799999999998	114
C3VPR6	PF18461	0	93	6.791787234042555	93	G5BR73	63	157	2.1359157894736818	94
Q6NWW5	PF00225	223	539	5.4688611987381694	316	G5B053	229	545	4.252391167192433	316
Q6YND2	PF00096	498	521	0.0	23	G5AJT9	412	435	0.0	23
Q6YND2	PF00096	527	549	0.0	22	G5AJT9	441	463	0.0	22
Q6YND2	PF00096	556	577	0.0	21	G5AJT9	470	491	0.0	21
Q9CZX8	PF01090	4	138	0.2178148148148148	134	G5AZQ1	5	139	0.2178148148148148	134
A7MCT6	PF01633	106	301	1.5788775510204078	195	G5BML8	26	221	0.3559642857142856	195
Q3THJ3	PF01176	24	85	3.5569838709677417	61	G5BWW2	25	86	4.619306451612903	61
Q8VEI3	PF01630	25	353	4.873844984802432	328	G5BZZ0	26	353	3.7477134146341466	327
Q8VEI3	PF07974	356	406	0.0	50	G5BZZ0	357	407	0.031764705882352945	50
Q9QXF8	PF13847	59	176	1.051347457627119	117	G5BNK7	60	179	1.014475	119
Q8CG70	PF13640	579	667	1.553483146067416	88	G5CAR1	426	514	2.2766179775280904	88
P41164	PF00178	335	414	9.2302875	79	G5BCA0	354	433	9.020300000000002	79
P41164	PF04621	15	332	0.030918238993710694	317	G5BCA0	30	351	0.23617391304347826	321
Q8BM89	PF00884	73	385	4.833172523961662	312	G5AVC1	70	382	4.939699680511182	312
A2A4P0	PF00271	790	918	9.446767441860462	128	G5BN88	770	898	9.320558139534882	128
A2A4P0	PF00575	284	356	1.1726575342465757	72	G5BN88	264	336	1.164465753424658	72
A2A4P0	PF04408	980	1068	12.926764044943821	88	G5BN88	960	1048	13.799483146067415	88
A2A4P0	PF07717	1126	1202	1.3901688311688312	76	G5BN88	1106	1182	1.380857142857143	76
Q8BIZ1	PF00536	809	871	0.07941269841269842	62	G5BBH5	374	436	0.08019047619047619	62
Q8BIZ1	PF00536	882	941	2.6491	59	G5BBH5	447	506	4.448783333333332	59
Q8BIZ1	PF00640	1061	1189	9.827015503875971	128	G5BBH5	626	750	10.187039999999998	124
Q8BIZ1	PF12796	68	107	4.6351	39	G5BBH5	423	461	0.12953846153846152	38
Q6P5E4	PF06427	1115	1220	6.658452830188682	105	G5C327	1073	1178	6.705443396226412	105
Q6P5E4	PF18400	58	235	4.288904494382023	177	G5C327	35	213	3.900854748603351	178
Q6P5E4	PF18401	311	440	4.767000000000001	129	G5C327	289	367	6.151632911392406	78
Q6P5E4	PF18402	450	698	7.027879518072287	248	G5C327	377	625	7.370686746987952	248
Q6P5E4	PF18403	722	954	3.0288583690987143	232	G5C327	649	912	5.396568181818181	263
Q6P5E4	PF18404	1255	1522	8.611429104477615	267	G5C327	1214	1481	7.6098320895522376	267
Q08943	PF00505	546	614	5.667768115942027	68	G5BLI6	547	615	5.667695652173912	68
Q08943	PF03531	105	169	0.016046153846153845	64	G5BLI6	106	170	0.016046153846153845	64
Q08943	PF08512	339	426	3.06121590909091	87	G5BLI6	340	427	5.853624999999999	87
Q08943	PF17292	5	96	0.0	91	G5BLI6	6	97	0.0	91
Q8CC27	PF00625	275	456	5.603802197802197	181	G5BFD8	348	528	5.633734806629832	180
Q8CC27	PF12052	67	108	0.0	41	G5BFD8	140	181	0.004190476190476191	41
O08917	PF01145	4	183	3.165844444444444	179	G5C3C4	5	184	3.166505555555556	179
O08917	PF15975	309	388	0.3182625000000001	79	G5C3C4	310	389	0.2519250000000002	79
D3YXJ0	PF00130	172	222	0.014117647058823532	50	G5BA93	31	81	0.021215686274509805	50
D3YXJ0	PF00130	244	295	0.0	51	G5BA93	103	154	0.0	51
D3YXJ0	PF00169	142	153	4.701083333333332	11	G5BA93	1	12	0.12416666666666665	11
D3YXJ0	PF00609	761	917	5.24369426751592	156	G5BA93	569	725	4.821203821656054	156
D3YXJ0	PF00781	328	441	4.871833333333333	113	G5BA93	187	252	7.430848484848485	65
P62814	PF00006	172	398	6.78324669603525	226	G5ARE5	173	399	6.781577092511016	226
P62814	PF02874	49	115	6.122358208955224	66	G5ARE5	50	116	6.121626865671642	66
Q91YU8	PF04427	41	284	1.6313483606557384	243	G5B342	42	285	1.0781270491803274	243
Q9D668	PF00339	18	157	3.5304571428571427	139	G5B4D8	19	146	1.5896328125	127
Q9D668	PF02752	181	305	6.119143999999999	124	G5B4D8	170	294	0.8581199999999998	124
P56203	PF00112	125	353	3.7731572052401763	228	G5B6I7	127	356	7.301404347826085	229
P56203	PF08246	39	96	0.1238448275862069	57	G5B6I7	42	99	0.09465517241379308	57
Q14DQ1	PF15260	71	196	0.0	125	G5AL68	38	165	0.05379527559055117	127
Q80TH2	PF00595	1317	1395	1.0788860759493677	78	G5C011	1321	1399	5.240670886075948	78
Q80TH2	PF13855	46	103	0.3095172413793103	57	G5C011	47	104	0.3046379310344828	57
Q80TH2	PF13855	161	218	0.0	57	G5C011	162	219	0.0	57
Q80TH2	PF13855	229	287	0.05711864406779661	58	G5C011	230	288	0.0411864406779661	58
Q80TH2	PF13855	345	401	10.003000000000009	56	G5C011	346	402	11.286684210526312	56
Q3URR7	PF00096	377	399	0.0	22	G5B1I8	313	335	0.3647391304347827	22
Q3URR7	PF00096	405	427	0.0	22	G5B1I8	341	363	0.0	22
Q3URR7	PF00096	433	455	0.0	22	G5B1I8	369	391	0.02647826086956522	22
Q3URR7	PF00096	479	499	0.06271428571428571	20	G5B1I8	415	435	0.15476190476190474	20
Q3URR7	PF00096	523	546	0.0	23	G5B1I8	459	481	0.0	22
Q3URR7	PF00096	554	574	0.0	20	G5B1I8	526	546	0.0	20
Q3URR7	PF00096	580	602	0.0	22	G5B1I8	580	602	0.0	22
Q3URR7	PF00096	637	658	0.0	21	G5B1I8	525	546	0.0	21
Q3URR7	PF00096	664	686	0.0	22	G5B1I8	552	574	0.0	22
Q3URR7	PF00096	692	714	0.0	22	G5B1I8	580	602	0.0	22
Q3URR7	PF00096	726	747	0.0	21	G5B1I8	614	635	0.0	21
Q3URR7	PF00096	753	775	0.0	22	G5B1I8	641	663	0.0	22
Q3URR7	PF02023	54	122	0.3133623188405796	68	G5B1I8	1	69	4.192347826086956	68
Q61937	PF03066	17	116	0.1153	99	G5B475	18	117	0.11283	99
Q61937	PF16276	242	280	0.4174358974358975	38	G5B475	243	280	0.4395945945945946	37
Q3TZ65	PF07004	120	149	0.0	29	G5C5V6	89	117	0.2117586206896552	28
Q3TZ65	PF07004	201	228	0.2308571428571429	27	G5C5V6	170	197	0.1182142857142857	27
Q3TZ65	PF07004	236	265	0.0	29	G5C5V6	205	234	0.0	29
Q99PS0	PF00038	70	378	1.9814627831715204	308	G5AX64	71	379	1.635504854368932	308
Q921E6	PF00400	180	218	1.8988461538461536	38	G5B517	181	219	1.8995384615384612	38
Q921E6	PF00400	232	262	0.0	30	G5B517	233	263	0.0	30
Q9QZX7	PF00291	20	313	4.445591836734693	293	G5BCU2	21	314	3.694625850340136	293
Q9D6A1	PF00063	13	677	6.370830075187964	664	G5BDR8	14	678	6.184043609022552	664
Q9D6A1	PF06017	861	945	6.16645882352941	84	G5BDR8	926	1010	14.793470588235293	84
Q80UK7	PF16531	44	140	13.697288659793816	96	G5C723	45	141	10.503371134020613	96
Q80UK7	PF18594	145	170	0.0	25	G5C723	146	171	0.14153846153846153	25
Q8BQR4	PF13891	27	91	0.0	64	G5AU46	28	85	0.0	57
Q8BQR4	PF13891	306	363	0.03475862068965517	57	G5AU46	300	357	0.034655172413793116	57
Q6ZQA0	PF00400	2481	2516	8.346750000000002	35	G5ANQ7	2834	2869	8.42088888888889	35
Q6ZQA0	PF00400	2531	2566	17.651777777777774	35	G5ANQ7	2884	2919	2.7271944444444443	35
Q6ZQA0	PF02138	2053	2332	2.072357142857142	279	G5ANQ7	2422	2685	2.1782878787878777	263
Q6ZQA0	PF14844	1913	1991	8.633227848101255	78	G5ANQ7	2282	2359	8.735076923076916	77
Q6ZQA0	PF15787	874	1124	9.288346613545816	250	G5ANQ7	1239	1488	9.109267999999997	249
Q6ZQA0	PF16057	1582	1848	1.5393108614232205	266	G5ANQ7	1945	2217	1.1644139194139198	272
Q3USH5	PF01805	209	253	0.04155555555555557	44	G5AWP9	316	360	0.0412	44
Q3USH5	PF01805	457	499	0.0	42	G5AWP9	605	647	0.0	42
Q3USH5	PF09750	34	154	5.327809917355372	120	G5AWP9	141	261	4.381743801652893	120
Q7TSS2	PF00179	316	405	8.779855555555555	89	G5BDD2	375	517	5.8321258741258735	142
Q45VK7	PF03028	3728	3827	1.7469700000000006	99	G5BUD1	3747	3846	1.78717	99
Q45VK7	PF08385	198	650	3.726097130242827	452	G5BUD1	199	651	3.6808830022075063	452
Q45VK7	PF08393	1119	1517	3.514030075187967	398	G5BUD1	1120	1524	2.8911358024691363	404
Q45VK7	PF12774	1650	1985	4.6200863095238045	335	G5BUD1	1657	1992	5.351119047619046	335
Q45VK7	PF12775	2281	2430	8.139273333333335	149	G5BUD1	2288	2437	8.27724666666667	149
Q45VK7	PF12777	2895	3225	2.580776435045317	330	G5BUD1	2907	3237	2.5590302114803634	330
Q45VK7	PF12780	2624	2878	6.2696274509803915	254	G5BUD1	2631	2890	5.776092307692308	259
Q45VK7	PF12781	3251	3467	3.978723502304145	216	G5BUD1	3263	3486	5.99171875	223
Q45VK7	PF18198	3841	3999	3.7310314465408823	158	G5BUD1	3860	4018	4.221433962264154	158
Q45VK7	PF18199	4039	4302	3.5029242424242435	263	G5BUD1	4058	4321	2.9899621212121215	263
Q61592	PF00054	321	448	7.847468750000001	127	G5AVU8	669	796	4.482890624999997	127
Q61592	PF00594	49	82	0.21235294117647055	33	G5AVU8	372	404	0.0	32
Q61592	PF02210	510	646	10.176416058394166	136	G5AVU8	964	1100	20.352846715328493	136
Q61592	PF07645	234	259	0.0	25	G5AVU8	582	607	0.0	25
Q61592	PF12662	173	196	0.0	23	G5AVU8	520	544	0.0	24
Q6P1C1	PF06090	12	454	2.453090293453725	442	G5BQK6	13	455	2.46352144469526	442
P61809	PF03261	123	292	10.847405882352943	169	G5BVL6	124	293	10.847405882352943	169
P61021	PF00071	21	180	10.082437499999996	159	G5BB94	22	181	10.0802875	159
Q91WT4	PF00076	196	232	11.028054054054058	36	G5BLZ9	213	249	7.055432432432432	36
Q91WT4	PF00226	26	72	0.0	46	G5BLZ9	25	71	0.0	46
P23589	PF00194	45	287	6.8793497942386805	242	G5BJE8	100	342	5.603736625514403	242
P62876	PF01194	0	58	0.33393220338983043	58	G5C8G0	1	59	0.33393220338983043	58
Q91ZW3	PF00176	191	460	1.5882185185185174	269	G5C5K1	134	403	1.3799629629629613	269
Q91ZW3	PF00271	482	595	9.003324561403508	113	G5C5K1	425	538	9.012166666666666	113
Q91ZW3	PF09110	741	839	0.019414141414141425	98	G5C5K1	684	782	0.020969696969696968	98
Q91ZW3	PF09111	896	1009	7.460087719298247	113	G5C5K1	839	952	7.466438596491227	113
Q91ZW2	PF10250	38	373	2.0894523809523813	335	G5BR10	37	372	1.1550178571428564	335
F8VPZ5	PF00176	513	806	5.777272108843538	293	G5B0W8	516	816	3.9778538205980087	300
F8VPZ5	PF00271	843	947	7.901533333333332	104	G5B0W8	853	957	7.7617238095238115	104
A2APT9	PF01344	526	567	23.74080952380953	41	G5BZM6	505	546	21.43695238095237	41
A2APT9	PF01344	573	614	0.09452380952380952	41	G5BZM6	552	593	0.09404761904761903	41
Q61474	PF00076	33	89	9.718947368421055	56	G5B778	1	57	9.71561403508772	56
Q61474	PF00076	110	176	8.2395223880597	66	G5B778	78	144	8.081537313432834	66
P06683	PF00057	97	131	0.0	34	G5ANE0	78	112	0.0	34
P06683	PF00090	43	91	0.5856530612244897	48	G5ANE0	24	72	0.0	48
P06683	PF01823	277	503	3.7240484581497793	226	G5ANE0	257	483	5.239823788546253	226
Q8BNJ3	PF01467	27	273	4.479141700404859	246	G5B449	1	247	4.482927125506074	246
Q91W59	PF00076	63	123	0.05721311475409836	60	G5C006	40	100	0.05762295081967213	60
Q91W59	PF00076	142	206	0.019953846153846152	64	G5C006	119	183	0.017430769230769232	64
Q11136	PF00557	194	458	0.5159169811320757	264	G5BXM2	189	453	0.4647698113207546	264
Q11136	PF05195	22	138	4.757435897435901	116	G5BXM2	17	133	5.1595641025641035	116
Q8R105	PF07200	4	148	0.011517241379310348	144	G5AYE9	5	151	0.006496598639455783	146
Q9Z1B5	PF02301	15	176	8.532506172839504	161	G5ARQ8	16	178	10.838306748466255	162
Q91WQ3	PF00579	31	320	3.398968965517239	289	G5B5J9	32	290	2.6907876447876444	258
Q91WQ3	PF01588	369	464	6.312125000000001	95	G5B5J9	339	416	1.0474615384615389	77
P05202	PF00155	57	424	3.9248288043478263	367	G5AW57	58	425	3.7741277173913015	367
P70388	PF04423	659	711	2.1724716981132075	52	G5ASP8	689	741	2.1292264150943394	52
P70388	PF13476	5	232	3.0654210526315784	227	G5ASP8	6	262	3.4515369649805447	256
Q8VHT7	PF00096	67	91	0.02832	24	G5ATV3	139	163	0.0338	24
Q8VHT7	PF00096	97	122	0.0	25	G5ATV3	169	194	0.11107692307692307	25
Q8VHT7	PF00096	159	183	0.0	24	G5ATV3	231	255	0.0	24
Q8VHT7	PF00096	216	236	0.0	20	G5ATV3	261	281	0.0	20
Q8VHT7	PF00096	244	268	2.9725200000000007	24	G5ATV3	289	313	2.97772	24
E9Q394	PF00621	1960	2150	2.74920942408377	190	G5B088	1681	1871	2.7572774869109953	190
E9Q394	PF17838	2179	2295	11.404495726495723	116	G5B088	1900	2016	11.356743589743587	116
Q9D6T0	PF15906	3	77	0.29234666666666664	74	G5B8P6	4	82	0.27849367088607596	78
Q8QZT1	PF00108	38	294	4.050914396887157	256	G5BXR0	26	282	2.8956225680933847	256
Q8QZT1	PF02803	303	422	7.342041666666673	119	G5BXR0	291	410	6.956375	119
O54926	PF05458	0	174	1.4114914285714284	174	G5AWI6	1	175	0.21913218390804604	174
Q8R081	PF13893	365	476	10.201366071428568	111	G5AMA4	287	398	10.194366071428568	111
Q8R081	PF00076	102	151	10.38572	49	G5AMA4	44	93	10.37812	49
Q8R081	PF11835	187	265	11.492417721518994	78	G5AMA4	129	208	11.3110375	79
Q69ZS8	PF00536	447	511	2.5138615384615384	64	G5BRS1	369	433	2.536338461538461	64
Q69ZS8	PF00536	533	586	4.506611111111111	53	G5BRS1	455	508	4.607925925925926	53
Q69ZS8	PF07647	613	669	6.168894736842105	56	G5BRS1	535	591	6.142421052631577	56
P46660	PF00038	262	405	0.0028333333333333327	143	G5CAI8	88	231	0.046263888888888896	143
P09925	PF02104	75	288	8.571752336448599	213	G5B8H1	72	286	8.700855813953488	214
Q8BPA8	PF14913	5	192	1.5657234042553194	187	G5CAF8	6	193	2.730686170212766	187
Q9QZB0	PF00615	84	198	4.670200000000004	114	G5BQ66	85	199	4.647191304347826	114
Q4ZJM9	PF00386	110	234	7.629688000000002	124	G5AU21	111	235	7.5525839999999995	124
Q1W617	PF00595	37	86	8.48516	49	G5AY65	16	65	8.6108	49
Q1W617	PF08687	1239	1467	3.9757816593886455	228	G5AY65	1297	1525	2.6669563318777274	228
Q5UBV8	PF00229	117	251	13.749570370370366	134	G5AVI3	125	259	13.868104477611942	134
Q7TQI8	PF00956	253	392	6.195150000000001	139	G5BAY9	180	318	7.217618705035972	138
Q80XD8	PF15314	99	143	0.0	44	G5AVA8	93	137	5.781466666666668	44
P10077	PF00096	204	226	7.019652173913044	22	G5AMD2	210	232	5.1810869565217414	22
P10077	PF00096	232	254	0.7088695652173912	22	G5AMD2	238	260	0.7081304347826086	22
P10077	PF00096	260	282	0.0	22	G5AMD2	266	288	0.0	22
P10077	PF00096	290	310	0.0	20	G5AMD2	296	316	0.0	20
P10077	PF00096	316	338	1.5005217391304349	22	G5AMD2	322	344	0.16839130434782607	22
P10077	PF00096	344	366	0.0	22	G5AMD2	350	372	0.0	22
P10077	PF00096	402	422	0.0	20	G5AMD2	408	428	0.0	20
P10077	PF00096	428	450	0.0	22	G5AMD2	434	456	0.026521739130434784	22
P10077	PF00096	484	506	0.0	22	G5AMD2	490	512	0.0	22
P10077	PF00096	512	534	0.0	22	G5AMD2	518	540	0.0	22
P10077	PF00096	540	562	0.12904347826086954	22	G5AMD2	546	568	0.0	22
P10077	PF00096	570	590	0.0	20	G5AMD2	576	596	0.0	20
P10077	PF00096	598	618	5.778809523809524	20	G5AMD2	604	624	5.762142857142856	20
P10077	PF00096	624	646	0.0	22	G5AMD2	630	652	0.0	22
P10077	PF00096	654	671	0.0	17	G5AMD2	660	677	0.0	17
P10077	PF00096	680	702	0.0	22	G5AMD2	686	708	0.0	22
P10077	PF00096	708	730	0.0	22	G5AMD2	714	736	0.0	22
P10077	PF00096	736	758	0.0	22	G5AMD2	742	764	0.0	22
P10077	PF00096	764	786	0.0	22	G5AMD2	770	792	0.0	22
P10077	PF01352	26	36	0.014818181818181819	10	G5AMD2	1	11	0.5774545454545453	10
Q9CZG9	PF00595	47	111	1.9073538461538464	64	G5C277	48	111	1.92146875	63
Q5I043	PF00443	161	651	5.7753727087576365	490	G5B7G5	140	690	5.221700544464603	550
Q8C1W1	PF14822	67	311	3.603563265306122	244	G5B687	61	305	3.918061224489796	244
Q8BLR9	PF13621	52	297	3.637548780487805	245	G5CAE3	48	293	3.6340243902439036	245
E9PVB5	PF13181	296	325	8.843533333333333	29	G5AS38	297	326	7.8212	29
E9PVB5	PF13181	693	720	4.048	27	G5AS38	695	722	3.425535714285714	27
P70695	PF00316	12	197	11.245236559139784	185	G5B6G9	13	198	11.735543010752686	185
P70695	PF18913	208	331	4.36068548387097	123	G5B6G9	209	332	6.180725806451613	123
O55126	PF07978	181	278	0.5793163265306123	97	G5ASS1	157	254	0.7264897959183674	97
O88842	PF00169	367	462	12.324833333333332	95	G5BIP9	371	466	12.058062500000005	95
O88842	PF00621	156	334	0.26484916201117314	178	G5BIP9	160	338	0.6856145251396646	178
O88842	PF01363	525	579	0.0	54	G5BIP9	529	583	1.3680363636363635	54
Q61879	PF00063	86	770	3.4082131386861287	684	G5B5G2	87	761	3.4627081481481485	674
Q61879	PF00612	787	805	38.73252631578947	18	G5B5G2	778	796	38.34394736842105	18
Q61879	PF01576	847	1927	0.035294172062904736	1080	G5B5G2	838	1918	0.03274283071230342	1080
Q61879	PF02736	32	72	0.16121951219512193	40	G5B5G2	33	73	0.16121951219512193	40
Q8BP67	PF01246	0	65	2.330348484848485	65	G5C020	1	66	2.330348484848485	65
Q64213	PF00013	139	222	6.196095238095242	83	G5B6N9	103	186	6.202130952380951	83
Q64213	PF00098	277	292	0.0	15	G5B6N9	241	256	0.0	15
Q64213	PF16275	52	129	1.2004487179487178	77	G5B6N9	16	93	0.0	77
Q3U186	PF00750	123	448	4.4938619631901835	325	G5B6Y5	77	373	3.9049764309764314	296
Q3U186	PF05746	462	577	5.702422413793102	115	G5B6Y5	387	477	0.5025111111111112	90
Q9CZ49	PF01344	330	370	2.005853658536586	40	G5AS75	45	85	2.309121951219512	40
Q9CZ49	PF01344	377	418	1.483714285714285	41	G5AS75	92	132	1.3177560975609752	40
Q9CZ49	PF01344	423	461	3.2594871794871803	38	G5AS75	138	176	8.868205128205126	38
Q9CZ49	PF01344	514	555	0.5671666666666667	41	G5AS75	229	270	0.0	41
Q8CJF8	PF02170	232	354	0.22160975609756095	122	G5C6F0	222	344	0.22160975609756095	122
Q8CJF8	PF02171	508	818	5.6614823151125355	310	G5C6F0	498	808	5.331700964630222	310
Q8CJF8	PF08699	165	215	6.269823529411763	50	G5C6F0	155	205	6.269921568627446	50
Q8CJF8	PF16486	25	154	8.7463	129	G5C6F0	15	144	8.746330769230768	129
Q8CJF8	PF16487	420	500	11.823296296296293	80	G5C6F0	410	490	11.948481481481476	80
Q8CJF8	PF16488	363	411	7.701551020408164	48	G5C6F0	353	401	7.701551020408164	48
P58801	PF00619	435	469	0.0	34	G5BBN7	299	332	6.486970588235295	33
P58801	PF07714	57	286	4.804217391304348	229	G5BBN7	2	179	6.9031179775280895	177
Q8C735	PF06584	126	230	1.000809523809524	104	G5BAN7	116	220	0.7218000000000001	104
Q9QXX8	PF10453	206	258	0.011886792452830187	52	G5C911	211	263	0.02730188679245283	52
Q9QXX8	PF12171	164	185	0.672	21	G5C911	169	190	0.4396363636363637	21
Q8QZR7	PF00069	7	323	7.049785488958986	316	G5AUQ5	8	324	7.0506561514195525	316
Q8K4F6	PF01189	218	421	4.685769607843139	203	G5BG70	253	456	5.2960980392156864	203
Q9CX47	PF08423	40	210	12.500497076023386	170	G5AMV1	41	210	13.339141176470585	169
Q5DU56	PF13516	664	685	0.0	21	G5B1H1	366	387	0.0	21
Q5DU56	PF13516	691	713	0.915	22	G5B1H1	393	415	0.048695652173913036	22
Q5DU56	PF13516	719	741	0.12434782608695652	22	G5B1H1	589	611	0.14300000000000002	22
Q5DU56	PF13516	774	797	1.2624583333333332	23	G5B1H1	448	471	0.0	23
Q5DU56	PF13516	830	852	0.0	22	G5B1H1	504	526	0.5703913043478261	22
Q5DU56	PF13516	859	881	5.263434782608695	22	G5B1H1	533	555	4.341304347826087	22
Q5DU56	PF13516	887	908	0.08945454545454544	21	G5B1H1	561	582	0.21909090909090914	21
Q5DU56	PF13516	915	937	0.2437826086956521	22	G5B1H1	589	611	0.14300000000000002	22
Q5DU56	PF13516	971	993	0.009608695652173913	22	G5B1H1	645	667	0.0	22
Q5DU56	PF17776	453	578	8.429857142857145	125	G5B1H1	155	280	7.017396825396826	125
Q5DU56	PF17779	393	451	6.183101694915254	58	G5B1H1	95	153	14.789745762711865	58
Q9JL62	PF08718	93	165	9.734671232876714	72	G5BDR0	4	76	7.169260273972603	72
Q08624	PF00046	156	212	0.0	56	G5BIE0	157	213	0.0	56
Q8R3P6	PF13519	2	116	13.6572347826087	114	G5AN55	3	117	13.109800000000005	114
P14869	PF00428	230	315	2.052209302325582	85	G5B782	231	316	2.3958372093023264	85
P14869	PF00466	7	102	7.1697604166666675	95	G5B782	8	103	7.445489583333335	95
P14869	PF17777	110	179	0.703157142857143	69	G5B782	111	180	0.7030857142857146	69
Q9QZL0	PF00069	22	262	8.867161825726141	240	G5B274	17	254	7.0229285714285705	237
Q9JLB0	PF00595	133	204	0.6256388888888886	71	G5BCX9	173	244	0.6255694444444441	71
Q9JLB0	PF00625	349	538	4.091431578947367	189	G5BCX9	375	564	4.086705263157897	189
Q9JLB0	PF02828	0	52	0.2667169811320755	52	G5BCX9	1	91	10.24387912087912	90
Q9JLB0	PF02828	57	107	2.1383333333333336	50	G5BCX9	96	146	2.138823529411765	50
Q9JLB0	PF07653	231	293	3.0085238095238096	62	G5BCX9	257	319	3.009079365079365	62
Q9QVP9	PF00373	144	252	5.0799449541284405	108	G5BY94	145	253	5.120366972477064	108
Q9QVP9	PF03623	869	1000	4.649068181818183	131	G5BY94	870	1001	4.0076363636363626	131
Q9QVP9	PF07714	425	677	9.532533596837943	252	G5BY94	426	678	9.10562845849802	252
Q9QVP9	PF18038	38	136	5.127919191919191	98	G5BY94	39	137	5.127050505050503	98
Q06348	PF00046	102	154	0.8025660377358491	52	G5ASC0	89	124	10.714138888888892	35
Q06348	PF03826	220	236	0.0	16	G5ASC0	190	206	0.0	16
Q9JKN6	PF00013	52	110	0.2848305084745761	58	G5C1T4	376	434	3.846661016949152	58
Q9JKN6	PF00013	173	237	1.1083692307692312	64	G5C1T4	125	189	1.1247230769230772	64
Q9JKN6	PF00013	423	488	3.5534848484848487	65	G5C1T4	375	440	3.545621212121212	65
Q9CXG9	PF00628	96	146	1.1593921568627452	50	G5AXS7	99	149	1.845176470588236	50
Q9CXG9	PF14061	529	575	1.0442553191489363	46	G5AXS7	532	578	1.9358510638297872	46
Q9CXG9	PF18104	40	75	3.3790000000000004	35	G5AXS7	43	78	2.5418055555555554	35
Q9R0P4	PF15477	26	102	0.0	76	G5B0I1	27	103	0.0	76
P58069	PF00168	226	261	0.09355555555555556	35	G5B0D8	39	73	0.13448571428571432	34
P58069	PF00169	605	702	0.8497857142857143	97	G5B0D8	356	453	0.7513367346938775	97
P58069	PF00616	375	443	2.7066086956521733	68	G5B0D8	154	222	2.3049710144927538	68
P58069	PF00616	446	531	19.260093023255816	85	G5B0D8	225	309	12.187788235294118	84
P58069	PF00779	711	739	0.0	28	G5B0D8	462	490	3.879827586206897	28
Q7TSH4	PF16025	29	103	0.3709333333333335	74	G5AY22	30	103	0.34162162162162163	73
P54276	PF00488	1128	1320	5.091642487046633	192	G5ANB4	1134	1326	4.108139896373059	192
P54276	PF00855	89	182	0.025659574468085103	93	G5ANB4	95	188	0.025659574468085103	93
P54276	PF01624	405	522	7.483067796610169	117	G5ANB4	411	528	7.4967627118644025	117
P54276	PF05188	536	694	10.894283018867927	158	G5ANB4	542	702	6.5931614906832285	160
P54276	PF05190	928	1020	3.411354838709676	92	G5ANB4	935	1027	4.313430107526882	92
P54276	PF05192	735	927	0.07633678756476685	192	G5ANB4	742	934	0.26373575129533683	192
O88398	PF00626	24	104	4.039012345679014	80	G5BEB2	25	104	5.361037500000003	79
O88398	PF00626	143	214	3.982749999999998	71	G5BEB2	144	215	9.89443055555556	71
O88398	PF00626	264	338	0.01958666666666667	74	G5BEB2	265	339	0.06994666666666667	74
O88398	PF00626	406	485	14.204424999999995	79	G5BEB2	407	486	20.54915	79
O88398	PF00626	523	570	1.6983333333333337	47	G5BEB2	524	570	3.730617021276596	46
O88398	PF00626	630	703	8.048378378378379	73	G5BEB2	631	704	8.164472972972973	73
O88398	PF02209	783	818	17.81272222222222	35	G5BEB2	784	819	18.270285714285716	35
Q9CQK3	PF00076	33	85	22.64852830188679	52	G5AX77	34	85	6.510057692307693	51
P33175	PF00225	44	326	3.5389929328621936	282	G5BEC9	45	327	3.5372968197879846	282
Q640N2	PF00025	19	172	10.775201298701296	153	G5AV69	1	154	7.794779220779216	153
Q8BZA9	PF00300	26	139	1.5951666666666666	113	G5AS04	1	111	2.187288288288288	110
O35326	PF00076	5	66	0.08653225806451613	61	G5BQM4	6	67	0.08653225806451613	61
O35326	PF00076	109	174	0.0	65	G5BQM4	110	175	0.0	65
Q9JJ48	PF00642	206	229	0.0	23	G5BQY4	72	95	0.0	23
Q9JJ48	PF14608	261	282	0.0	21	G5BQY4	141	162	0.0	21
Q9JJ48	PF18345	239	257	0.0	18	G5BQY4	105	123	0.08178947368421052	18
Q91WL0	PF00018	463	507	0.17402222222222224	44	G5BQX6	459	503	0.13195555555555552	44
Q91WL0	PF08416	27	148	2.8849344262295085	121	G5BQX6	28	149	1.8384672131147544	121
Q91WL0	PF18016	530	588	1.4922542372881358	58	G5BQX6	526	584	1.4915932203389832	58
Q8BZM0	PF00651	22	128	2.1396261682242987	106	G5B377	23	129	2.1396261682242987	106
Q8BZM0	PF01344	280	313	15.114823529411767	33	G5B377	281	313	15.572848484848487	32
Q8BZM0	PF01344	318	365	7.600083333333334	47	G5B377	319	366	7.6027708333333335	47
Q8BZM0	PF01344	367	412	0.2975652173913044	45	G5B377	368	413	0.3055	45
Q8BZM0	PF01344	415	458	20.97852272727273	43	G5B377	416	459	21.05640909090909	43
Q8BZM0	PF01344	462	505	4.112795454545457	43	G5B377	463	506	4.086272727272728	43
Q8BZM0	PF01344	508	553	2.8169130434782623	45	G5B377	509	554	2.779869565217392	45
Q8BZM0	PF07707	134	235	3.3243725490196083	101	G5B377	135	236	3.3243725490196083	101
P84089	PF01133	1	98	8.008755102040821	97	G5BQN0	2	99	8.005255102040818	97
Q9DBT3	PF09747	155	318	0.0	163	G5AZS8	157	320	0.0	163
Q9D7X3	PF00782	41	174	5.646052238805969	133	G5BN85	27	160	6.097686567164178	133
P51667	PF00036	27	54	1.4516428571428572	27	G5AKU1	28	55	1.5595714285714286	27
Q9CWY8	PF01351	30	240	3.0467630331753566	210	G5BYW8	31	241	4.528914691943129	210
E9Q956	PF17855	539	619	8.260901234567902	80	G5AQN3	540	619	11.38165	79
Q9WV02	PF00076	9	79	9.855901408450707	70	G5CAU0	10	80	9.829084507042252	70
Q9WV02	PF08081	172	216	0.0	44	G5CAU0	173	217	0.0	44
Q7TN02	PF08711	33	83	0.08880392156862743	50	G5C2W2	10	60	0.0	50
Q7TN02	PF15693	406	585	0.0918388888888889	179	G5C2W2	332	511	0.09373446327683617	179
Q7TN02	PF15694	177	404	0.008969298245614035	227	G5C2W2	146	330	0.011081081081081079	184
Q6NXH9	PF00038	129	442	0.30902547770700656	313	G5ALS7	131	444	0.3086624203821657	313
Q6NXH9	PF16208	64	126	0.012	62	G5ALS7	66	128	0.04182539682539683	62
Q80U44	PF01363	731	792	5.663693548387097	61	G5BK77	757	818	5.6438225806451605	61
Q80U44	PF11979	1154	1502	4.091945558739255	348	G5BK77	1179	1527	6.395756446991398	348
O54863	PF00069	16	271	7.027632812500001	255	G5APX7	17	272	8.572039062499998	255
Q9R062	PF01501	6	221	2.9788148148148146	215	G5BSK5	12	227	5.0063518518518535	215
Q3UFY8	PF01746	206	374	7.641550295857987	168	G5C017	172	340	8.718005917159763	168
P26516	PF01398	4	117	10.269938596491231	113	G5AK36	5	118	10.385535087719301	113
P26516	PF13012	165	276	8.871928571428572	111	G5AK36	166	277	9.22914285714286	111
Q9CY94	PF05916	66	172	0.16289719626168225	106	G5AUG8	118	224	0.8819719626168225	106
Q3USS3	PF14772	99	199	0.4004059405940594	100	G5CBK4	48	148	0.2232970297029703	100
Q3USS3	PF14775	672	731	9.289316666666668	59	G5CBK4	601	660	1.835233333333334	59
Q64674	PF01564	75	258	0.6298097826086957	183	G5C520	25	208	1.2763315217391302	183
Q64674	PF17284	51	72	6.134227272727273	21	G5C520	1	22	6.155363636363638	21
Q8BGC9	PF13883	120	281	5.530012345679012	161	G5C8V6	1	162	6.309993827160495	161
P80205	PF00046	38	94	0.4920526315789474	56	G5AL61	39	95	0.4923684210526314	56
P80205	PF03529	177	278	0.005735294117647058	101	G5AL61	176	277	0.005735294117647058	101
Q9D5T0	PF00004	128	256	6.001658914728682	128	G5B5S4	129	257	5.9825426356589135	128
Q9D5T0	PF17862	281	321	4.319170731707317	40	G5B5S4	282	321	4.431124999999999	39
Q8VDL4	PF04587	78	489	4.888162621359224	411	G5BRE8	312	739	2.290378504672897	427
Q8R307	PF00637	638	768	2.318030534351145	130	G5BM05	640	770	2.314801526717557	130
Q8R307	PF05131	290	433	9.673354166666662	143	G5BM05	292	435	9.777833333333334	143
Q7TN83	PF00168	359	454	2.4358854166666686	95	G5BNE5	365	460	3.5252812499999986	95
Q7TN83	PF00168	513	619	17.83748598130841	106	G5BNE5	519	625	16.980532710280368	106
Q8C1A3	PF00175	539	658	7.201591666666666	119	G5AX04	576	695	7.251241666666667	119
Q8C1A3	PF00258	5	141	5.626094890510951	136	G5AX04	38	174	6.37635766423358	136
Q8C1A3	PF00667	271	489	6.394397260273973	218	G5AX04	307	526	7.019972727272728	219
Q9CQ86	PF10262	24	93	0.1333714285714286	69	G5BRX5	28	97	0.17554285714285706	69
Q6ZPF3	PF00169	505	616	5.413866071428571	111	G5BQ75	503	614	5.404812499999998	111
Q6ZPF3	PF18385	642	739	0.5156224489795919	97	G5BQ75	640	737	0.4940510204081633	97
Q6ZPF3	PF00595	921	984	4.94175	63	G5BQ75	898	961	1.2383281249999996	63
Q6ZPF3	PF00621	1123	1311	2.7042433862433857	188	G5BQ75	1100	1288	2.702941798941798	188
Q9D939	PF00685	38	287	3.3447120000000017	249	G5CB88	281	551	3.220605166051659	270
Q9DCJ1	PF00400	33	68	0.10841666666666666	35	G5BY42	34	69	0.10841666666666666	35
Q9DCJ1	PF00400	79	112	0.4850588235294117	33	G5BY42	80	113	0.4866470588235294	33
Q9DCJ1	PF00400	119	155	0.03648648648648649	36	G5BY42	120	156	0.03648648648648649	36
Q9DCJ1	PF00400	224	246	0.12543478260869567	22	G5BY42	225	247	0.12543478260869567	22
Q9DCJ1	PF00400	273	296	5.105333333333333	23	G5BY42	274	297	4.745625	23
Q64096	PF00169	843	944	0.587872549019608	101	G5AVW3	785	886	0.5758921568627452	101
Q64096	PF00621	635	809	0.9496399999999999	174	G5AVW3	577	751	0.9739314285714284	174
Q64096	PF00435	353	453	0.4758415841584159	100	G5AVW3	295	395	0.3311881188118812	100
Q64096	PF13716	90	223	9.12758208955224	133	G5AVW3	32	165	9.438604477611936	133
Q9D0D5	PF02002	15	122	1.4408333333333332	107	G5AU87	16	123	1.438814814814815	107
Q9D0D5	PF08271	126	174	0.0	48	G5AU87	127	175	0.0	48
Q9D0D5	PF11521	364	439	2.7556710526315777	75	G5AU87	365	440	1.4346533333333331	75
O55029	PF00400	91	126	0.4212222222222221	35	G5AQA3	91	126	0.44386111111111104	35
O55029	PF00400	131	169	12.682923076923075	38	G5AQA3	131	169	12.684615384615386	38
O55029	PF00400	176	214	0.814974358974359	38	G5AQA3	176	214	0.925948717948718	38
O55029	PF00400	219	255	0.3391891891891892	36	G5AQA3	219	255	0.33932432432432424	36
O55029	PF04053	318	761	10.02392342342342	443	G5AQA3	318	761	10.025423423423414	443
Q9QXE0	PF00205	208	334	7.2862204724409425	126	G5BUL5	209	335	6.900968503937008	126
Q9QXE0	PF02775	401	559	10.602037735849056	158	G5BUL5	402	560	10.807257861635213	158
Q9QXE0	PF02776	17	180	4.69075	163	G5BUL5	18	181	7.224298780487808	163
Q60973	PF00400	180	204	0.9026	24	G5B0F2	183	207	0.9046	24
Q60973	PF00400	220	254	0.08220000000000002	34	G5B0F2	223	257	0.05825714285714286	34
Q60973	PF00400	263	300	2.6846315789473683	37	G5B0F2	266	303	2.692894736842106	37
Q60973	PF00400	308	344	0.015540540540540543	36	G5B0F2	311	347	0.015540540540540543	36
Q60973	PF00400	365	400	2.908638888888889	35	G5B0F2	368	403	2.9030277777777784	35
Q60973	PF12265	17	86	3.994128571428572	69	G5B0F2	20	89	3.999514285714286	69
Q8K3E5	PF00018	907	953	6.757999999999999	46	G5C1A3	1155	1201	4.752787234042553	46
Q8K3E5	PF00400	494	531	1.0324736842105264	37	G5C1A3	743	780	0.9987894736842104	37
Q8K3E5	PF00400	701	720	24.82975	19	G5C1A3	950	969	7.615549999999998	19
Q99LS3	PF00702	14	190	2.8715819209039517	176	G5ASS2	15	191	3.8044463276836153	176
Q9Z0J0	PF02221	21	146	1.1323174603174602	125	G5C1M5	22	147	2.169404761904762	125
Q9Z0Z3	PF12937	96	141	5.667173913043479	45	G5C9G4	109	154	16.77408695652174	45
Q8C008	PF12773	229	289	0.4157377049180328	60	G5CBB0	200	260	0.4146721311475409	60
Q8C008	PF12773	360	406	0.06059574468085106	46	G5CBB0	330	376	0.03008510638297872	46
Q8C008	PF13287	31	99	1.5462318840579703	68	G5CBB0	32	100	1.5565942028985504	68
Q8C6E0	PF11527	9	120	0.7647500000000004	111	G5B8W9	10	148	3.205676258992803	138
Q80YV2	PF07967	72	198	1.7923779527559047	126	G5BH81	72	197	2.9638333333333335	125
Q80YV2	PF08600	247	331	1.6494235294117654	84	G5BH81	246	331	4.00982558139535	85
Q99LJ0	PF09727	2	187	3.3061397849462315	185	G5BNW8	3	188	3.2998655913978485	185
Q9WU28	PF02996	21	140	0.17300833333333332	119	G5BIG6	22	141	0.17300833333333332	119
P07214	PF00050	93	147	0.0	54	G5BN22	95	149	0.0	54
P07214	PF09289	70	91	0.0	21	G5BN22	72	93	0.0	21
P07214	PF10591	152	287	3.900132352941178	135	G5BN22	154	289	3.9014558823529417	135
P97504	PF00017	271	352	1.7554146341463412	81	G5C235	272	353	2.6405853658536587	81
P97504	PF00169	6	109	9.68275	103	G5C235	7	110	9.53610576923077	103
P97504	PF00779	118	146	0.5255862068965517	28	G5C235	119	147	0.5266206896551725	28
P97504	PF07714	393	574	4.116653846153846	181	G5C235	394	574	2.0146629834254157	180
Q9D7E3	PF03959	4	214	5.0827535545023705	210	G5BCU5	5	216	4.556061320754716	211
Q8BHZ0	PF07159	17	318	3.2419205298013254	301	G5BI58	18	319	3.2228211920529795	301
Q9CR63	PF14138	15	87	7.800739726027402	72	G5BQL9	16	88	7.736808219178082	72
P51944	PF00134	287	404	8.524516949152543	117	G5AQD3	352	469	8.489796610169497	117
P51944	PF00646	57	67	0.031363636363636364	10	G5AQD3	122	132	0.0	10
P51944	PF02984	423	526	0.7583557692307691	103	G5AQD3	488	591	0.8988557692307689	103
Q1HKZ5	PF07714	170	404	4.532617021276595	234	G5BTA1	91	325	4.542825531914893	234
O70251	PF00736	140	224	0.2924705882352941	84	G5C5M1	142	226	0.27335714285714274	84
O70251	PF10587	102	129	0.0	27	G5C5M1	104	131	0.0	27
Q9JHT5	PF01871	143	311	2.121491124260356	168	G5BPF9	49	217	2.0065384615384603	168
Q5U464	PF00169	303	391	1.7512808988764048	88	G5BHY8	304	392	2.1427415730337085	88
Q5U464	PF01412	427	540	2.5615175438596496	113	G5BHY8	429	542	2.9438421052631587	113
Q5U464	PF12796	588	674	0.046724137931034485	86	G5BHY8	590	676	0.05480459770114942	86
Q5U464	PF16746	41	259	3.6556438356164382	218	G5BHY8	42	260	3.655881278538813	218
Q8BFR2	PF13927	257	322	5.222424242424244	65	G5AZ92	16	81	2.8045909090909085	65
Q8BFR2	PF13927	339	416	0.04746153846153847	77	G5AZ92	98	175	0.04711538461538462	77
Q80VP5	PF00472	57	130	0.0761081081081081	73	G5AWS4	58	130	0.057616438356164375	72
Q8BVR0	PF02961	3	88	9.945674418604654	85	G5CBA2	4	89	9.50338372093023	85
Q3TKY6	PF00160	15	165	3.133516556291392	150	G5BNS9	3	153	3.1296622516556294	150
Q9CQP0	PF00471	16	59	0.026590909090909096	43	G5C2Z2	4	47	0.06018181818181818	43
Q8CGY8	PF00515	190	223	14.686676470588234	33	G5B2N1	191	224	10.541852941176467	33
Q8CGY8	PF00515	258	291	1.9062352941176477	33	G5B2N1	259	292	5.447294117647059	33
Q8CGY8	PF13181	162	188	0.05607407407407408	26	G5B2N1	163	189	1.2037777777777778	26
Q8CGY8	PF13181	225	257	2.1338181818181816	32	G5B2N1	226	258	2.2573636363636367	32
Q8CGY8	PF13414	95	135	8.974707317073172	40	G5B2N1	96	136	0.161	40
Q8CGY8	PF13414	372	407	0.0	35	G5B2N1	373	408	0.0	35
Q8CGY8	PF13414	437	470	0.08676470588235294	33	G5B2N1	438	471	0.10388235294117648	33
Q8CGY8	PF13424	294	357	0.011015625	63	G5B2N1	295	358	0.0109375	63
Q8CGY8	PF13844	475	1015	1.965621072088725	540	G5B2N1	476	1016	2.6288225508317944	540
Q8BGS0	PF01778	5	118	0.363982456140351	113	G5B9U4	6	119	0.3562105263157893	113
Q8BGS0	PF04874	151	234	0.4993809523809524	83	G5B9U4	152	234	0.425578313253012	82
Q8BFT2	PF14735	128	359	2.760431034482758	231	G5ASJ7	117	348	3.0468534482758645	231
Q9QXB9	PF01926	63	165	11.410893203883495	102	G5BMX2	64	166	11.344621359223302	102
Q9QXB9	PF02824	290	362	9.501917808219176	72	G5BMX2	291	363	8.666643835616437	72
Q9QXB9	PF16897	184	288	6.628685714285715	104	G5BMX2	185	289	7.2137523809523785	104
Q9CY21	PF08241	57	129	2.2691780821917806	72	G5BG80	58	130	1.316794520547945	72
Q9CY21	PF12589	203	277	1.4811466666666666	74	G5BG80	204	299	6.532197916666667	95
P32020	PF00108	23	239	3.037728110599078	216	G5BAL6	1	217	4.272331797235025	216
P32020	PF02036	436	537	2.5050784313725494	101	G5BAL6	411	512	2.4639901960784316	101
P32020	PF02803	283	380	0.07051020408163265	97	G5BAL6	261	358	0.07081632653061225	97
Q3V129	PF00069	5	278	6.466788321167885	273	G5ALX3	6	276	5.719885608856089	270
P97814	PF00611	20	92	0.24727397260273976	72	G5AL19	20	92	0.4317671232876712	72
P97814	PF14604	364	412	10.23969387755102	48	G5AL19	369	417	9.75761224489796	48
Q62160	PF02115	45	220	4.1046306818181835	175	G5BXX6	25	200	2.3121590909090908	175
Q8R107	PF04707	15	170	4.519506410256412	155	G5BQ03	16	171	4.518371794871795	155
Q80X50	PF12478	515	545	0.037354838709677415	30	G5BDC6	507	537	0.037354838709677415	30
Q8BGA8	PF00501	70	475	8.082689655172413	405	G5C2G3	72	477	6.631982758620686	405
Q8BGA8	PF13193	484	564	6.254604938271602	80	G5C2G3	486	566	6.308481481481483	80
Q9D3P9	PF07421	5	167	8.346435582822089	162	G5BJL3	50	212	7.2261840490797535	162
Q9QZE7	PF01997	50	263	0.6204953271028038	213	G5BQJ6	47	260	1.0940140186915883	213
O89079	PF04733	15	293	9.959845878136203	278	G5C5B4	16	293	11.303606498194947	277
Q9CPV2	PF17256	26	105	0.5881500000000003	79	G5C2I3	27	106	0.5881500000000003	79
Q8C0D4	PF00620	661	809	4.052261744966443	148	G5BE30	564	712	4.11806711409396	148
Q8C0D4	PF00169	467	565	0.7445151515151514	98	G5BE30	443	507	1.6669230769230767	64
Q8C0D4	PF00397	266	293	0.0	27	G5BE30	267	294	0.0	27
Q8C0D4	PF14604	16	67	0.0	51	G5BE30	19	70	0.0	51
Q8C0D4	PF16618	68	263	0.0063265306122448975	195	G5BE30	71	264	0.1844175257731958	193
Q8C0S1	PF00773	464	815	2.8148153409090897	351	G5AN84	382	733	1.8051534090909087	351
Q8C0S1	PF17215	875	959	6.9696588235294135	84	G5AN84	793	877	6.739847058823531	84
Q8C0S1	PF17216	235	309	0.05218666666666669	74	G5AN84	153	227	0.0	74
Q8C0S1	PF17849	364	431	3.6545441176470583	67	G5AN84	282	349	7.315514705882354	67
Q07231	PF00096	358	380	0.0	22	G5AN11	272	294	0.0	22
Q07231	PF00096	386	408	0.0	22	G5AN11	300	322	0.0	22
Q07231	PF00096	417	435	0.0	18	G5AN11	331	349	0.0	18
Q07231	PF00096	441	463	0.0	22	G5AN11	355	377	0.0	22
Q07231	PF00096	469	491	0.0	22	G5AN11	383	405	0.0	22
Q07231	PF00096	497	519	0.0	22	G5AN11	411	433	0.0	22
Q07231	PF00096	527	547	0.0	20	G5AN11	441	461	0.0	20
Q07231	PF02023	118	205	0.4179659090909091	87	G5AN11	35	122	0.09517045454545454	87
Q8BJH1	PF13913	15	38	0.0	23	G5AW52	11	34	0.0	23
Q8BJH1	PF13913	119	141	0.0	22	G5AW52	115	137	0.0	22
A2A791	PF06467	336	372	0.905783783783784	36	G5C6E0	317	353	0.9094864864864864	36
A2A791	PF06467	384	424	0.07668292682926829	40	G5C6E0	365	405	0.07682926829268293	40
A2A791	PF06467	481	520	0.0	39	G5C6E0	462	501	0.044350000000000014	39
A2A791	PF06467	682	718	0.0	36	G5C6E0	663	699	0.0	36
A2A791	PF06467	724	759	0.04180555555555556	35	G5C6E0	705	740	0.039444444444444435	35
A2A791	PF12012	1356	1526	5.9111578947368395	170	G5C6E0	1330	1500	5.921532163742688	170
Q8R0F3	PF03781	87	364	1.2257697841726618	277	G5BA10	90	367	1.621510791366907	277
Q3U1U7	PF00010	34	75	0.03885714285714286	41	G5BPH0	34	75	0.03871428571428572	41
Q3U1U7	PF00989	108	172	16.557215384615382	64	G5BPH0	187	251	16.544492307692312	64
Q9CRT8	PF03810	25	86	9.99437096774193	61	G5ARJ8	208	269	11.007000000000005	61
Q9CRT8	PF08389	98	213	16.765767241379308	115	G5ARJ8	281	392	14.69961607142857	111
P70181	PF01504	110	391	4.446453900709219	281	G5AVI0	151	432	4.725269503546098	281
Q8BYK6	PF04146	416	480	9.256615384615381	64	G5AW18	417	481	9.25596923076923	64
Q8BYK6	PF04146	492	549	8.196327586206895	57	G5AW18	493	550	8.688051724137928	57
Q91W63	PF13238	5	143	3.6023597122302164	138	G5BHT8	6	143	4.150260869565217	137
Q8R5M0	PF00595	98	166	0.12231884057971015	68	G5AKQ1	114	182	0.21479710144927533	68
Q91YP6	PF04727	159	311	12.192960784313724	152	G5BRQ9	118	270	13.378915032679734	152
Q9Z185	PF03068	280	658	1.4173139841688651	378	G5BZN4	284	662	1.3393350923482843	378
Q9Z185	PF08526	0	112	12.912734513274335	112	G5BZN4	1	113	7.655424778761064	112
Q9Z185	PF08527	114	271	5.099905063291138	157	G5BZN4	115	275	4.7739875776397485	160
P48722	PF00012	2	692	3.05196816208394	690	G5AKY4	3	694	3.247465317919076	691
Q6PHQ8	PF04112	45	136	15.193456521739133	91	G5ARM3	46	137	15.201097826086954	91
Q6PHQ8	PF04112	145	187	1.8112790697674424	42	G5ARM3	146	188	1.812372093023256	42
Q3ULW6	PF00168	280	362	5.7696626506024105	82	G5BRG3	231	313	1.263024096385542	82
P47811	PF00069	23	307	4.549196491228072	284	G5BEW2	24	308	4.546185964912281	284
Q921F2	PF00076	105	163	4.680101694915252	58	G5C522	106	164	4.466796610169494	58
Q921F2	PF00076	192	240	13.413612244897957	48	G5C522	193	241	13.434448979591837	48
Q921F2	PF18694	3	75	10.757917808219178	72	G5C522	4	76	10.769068493150687	72
O54983	PF02423	5	311	5.8065016286645	306	G5BV92	6	313	6.595363636363633	307
F6TQD1	PF14634	6	45	0.17219999999999994	39	G5BCJ8	7	46	0.030575	39
Q9CQ49	PF00076	41	110	1.7554142857142865	69	G5ALD0	42	111	1.6099285714285712	69
Q91YP1	PF06859	158	263	11.470415094339625	105	G5AU11	169	274	10.514716981132072	105
P22893	PF00642	95	115	0.0	20	G5BJD9	121	140	0.0	19
P22893	PF00642	133	159	0.0	26	G5BJD9	154	180	0.02537037037037037	26
P08505	PF00489	25	209	0.3388810810810812	184	G5BB49	26	209	8.24534239130435	183
Q3U564	PF06058	14	127	14.571780701754387	113	G5AQP5	15	128	14.015052631578946	113
Q3U564	PF16741	537	574	10.948973684210527	37	G5AQP5	552	589	14.864210526315789	37
Q0KK59	PF14776	297	644	5.7147614942528735	347	G5AXI6	15	362	6.441629310344824	347
D3YVL2	PF13181	984	1007	2.280375	23	G5C7G5	929	952	0.9924583333333332	23
D3YVL2	PF13181	1023	1052	1.1553333333333335	29	G5C7G5	968	997	27.522066666666674	29
Q99L48	PF04981	16	245	3.692056521739129	229	G5C1U3	17	246	3.847478260869565	229
Q8C0V0	PF00069	458	733	6.233905797101448	275	G5BLX2	411	686	6.203710144927535	275
Q8C050	PF00069	57	316	3.2932000000000023	259	G5AZZ5	119	378	3.259357692307692	259
Q8C050	PF00069	427	489	0.010555555555555556	62	G5AZZ5	489	551	0.012095238095238095	62
Q8C050	PF00069	554	749	5.813734693877555	195	G5AZZ5	551	746	5.796163265306122	195
Q8C050	PF00433	337	375	0.6771794871794872	38	G5AZZ5	399	437	0.7664871794871794	38
Q8VI94	PF00240	431	498	10.017882352941179	67	G5AWY0	436	503	2.508647058823529	67
Q8VI94	PF10421	164	345	5.838478021978018	181	G5AWY0	169	350	8.55029120879121	181
Q80X86	PF04826	109	258	4.3123666666666685	149	G5BEW7	185	332	5.139027027027028	147
Q7TMK6	PF05622	178	700	1.4383346080305928	522	G5BYX2	179	701	1.8503766730401527	522
Q7TMK6	PF19047	6	155	3.1521200000000014	149	G5BYX2	7	156	2.769593333333334	149
Q99N96	PF00687	123	304	1.5252362637362622	181	G5C323	98	279	4.261527472527469	181
Q99ML0	PF01753	393	429	2.0091621621621627	36	G5BZS8	394	430	0.053891891891891884	36
Q9QYE9	PF00169	22	125	6.797682692307693	103	G5ASA3	23	126	7.010240384615384	103
P61967	PF01217	1	139	8.280913669064745	138	G5AXC3	2	140	8.27507194244604	138
Q80Y61	PF08397	15	215	2.7620696517412937	200	G5AYS5	16	214	4.059748743718593	198
Q80Y61	PF14604	339	382	0.0	43	G5AYS5	374	417	0.0	43
Q4QY64	PF00004	1114	1160	2.6491276595744675	46	G5BVM6	1116	1162	2.0844042553191486	46
Q61457	PF00134	112	239	8.585062500000005	127	G5BL42	116	243	8.575859374999999	127
Q61457	PF02984	242	362	17.50367768595041	120	G5BL42	246	366	17.053198347107447	120
Q9CZP5	PF00004	226	353	6.021867187499999	127	G5AZI3	227	354	3.7541171875	127
Q9CZP5	PF08740	24	190	8.949437125748506	166	G5AZI3	25	191	11.035005988023954	166
O35099	PF00069	691	943	1.5898260869565213	252	G5C1A9	522	774	1.6000276679841896	252
O35099	PF13281	171	551	8.735186351706036	380	G5C1A9	10	382	8.91518766756032	372
O35099	PF19039	562	659	6.501581632653062	97	G5C1A9	393	490	6.511316326530617	97
Q8VI78	PF00151	19	335	3.5361419558359604	316	G5AUA1	20	336	3.3231388012618304	316
Q80YA3	PF02862	257	531	5.714385454545456	274	G5BF90	367	641	5.716287272727275	274
Q7TSE6	PF00069	89	382	2.6633027210884355	293	G5BPF3	90	350	3.0377739463601543	260
Q7TSE6	PF00433	401	442	13.484095238095238	41	G5BPF3	369	410	13.48030952380953	41
Q99P21	PF00633	167	196	2.5259	29	G5ARU1	155	184	3.824866666666667	29
Q99P21	PF00730	102	166	2.8111538461538457	64	G5ARU1	104	154	6.118294117647058	50
Q99P21	PF10576	260	276	0.0	16	G5ARU1	248	264	0.0	16
Q99P21	PF14815	355	462	5.2981944444444435	107	G5ARU1	296	408	5.94578761061947	112
Q8VDB8	PF12799	166	199	0.10617647058823527	33	G5ANP6	167	200	0.105	33
Q8VDB8	PF13855	238	294	9.737350877192982	56	G5ANP6	239	295	12.48057894736842	56
P57784	PF14580	27	174	2.6794121621621616	147	G5ARZ3	1	148	2.643405405405405	147
Q80Y55	PF03909	145	201	0.0	56	G5B5L9	146	202	0.0	56
P40226	PF00758	25	171	5.799333333333332	146	G5BTB8	20	166	8.774877551020408	146
P70261	PF14566	163	332	8.392558823529411	169	G5B199	161	330	9.714452941176473	169
P70261	PF14566	600	679	10.7895125	79	G5B199	598	677	12.0480625	79
Q9DCJ7	PF08213	127	158	0.0	31	G5ATQ0	127	158	0.0	31
Q6P1G6	PF11652	130	214	0.030882352941176475	84	G5AMF9	161	245	0.08352380952380949	84
Q9Z0X1	PF07992	146	458	1.9301086261980815	312	G5B2Q8	148	460	2.415373801916934	312
Q9Z0X1	PF14721	463	592	11.723484615384619	129	G5B2Q8	465	594	11.700523076923075	129
P46686	PF01167	314	555	2.7295330578512402	241	G5BAG9	218	459	4.405247933884298	241
P46686	PF16322	38	120	2.991349397590361	82	G5BAG9	27	100	0.013445945945945944	73
Q8C0C0	PF00046	446	494	0.5378979591836736	48	G5AY82	402	450	0.5322040816326531	48
Q8C0C0	PF00046	536	580	0.0	44	G5AY82	492	536	0.0	44
Q8C0C0	PF00046	635	680	0.058913043478260874	45	G5AY82	591	636	0.058347826086956524	45
Q8C0C0	PF18387	106	156	0.19852941176470587	50	G5AY82	107	157	0.19647058823529406	50
P48678	PF00038	49	385	0.007851632047477741	336	G5ARA1	84	420	0.0040207715133531155	336
P48678	PF00932	434	539	4.568632075471697	105	G5ARA1	470	575	4.555122641509433	105
Q9QXS1	PF00307	185	292	8.548879629629628	107	G5C5U7	321	423	8.996223300970872	102
Q9QXS1	PF00307	306	409	6.530307692307693	103	G5C5U7	437	540	6.520423076923076	103
Q9QXS1	PF00681	2833	2873	9.011073170731706	40	G5C5U7	3199	3239	8.911560975609754	40
Q9QXS1	PF00681	2872	2911	2.294549999999999	39	G5C5U7	3238	3277	1.1257249999999996	39
Q9QXS1	PF00681	2947	2987	0.03107317073170732	40	G5C5U7	4316	4356	0.03090243902439025	40
Q9QXS1	PF00681	3163	3201	12.782615384615385	38	G5C5U7	3529	3567	14.211769230769226	38
Q9QXS1	PF00681	3200	3239	1.625925	39	G5C5U7	3566	3605	0.737425	39
Q9QXS1	PF00681	3275	3314	0.0	39	G5C5U7	3641	3680	0.0	39
Q9QXS1	PF00681	3493	3532	1.1834249999999995	39	G5C5U7	4203	4242	1.1821749999999998	39
Q9QXS1	PF00681	3531	3570	0.769525	39	G5C5U7	4241	4280	0.6281000000000001	39
Q9QXS1	PF00681	3606	3645	0.0336	39	G5C5U7	4316	4355	0.031675	39
Q9QXS1	PF00681	3827	3867	1.4663170731707316	40	G5C5U7	4568	4608	1.0421219512195123	40
Q9QXS1	PF00681	3866	3905	0.21390000000000006	39	G5C5U7	4607	4646	0.20455	39
Q9QXS1	PF00681	3941	3981	0.0	40	G5C5U7	4682	4722	0.0	40
Q9QXS1	PF00681	4071	4110	6.61435	39	G5C5U7	4812	4851	6.6104499999999975	39
Q9QXS1	PF00681	4109	4148	0.30399999999999994	39	G5C5U7	4850	4889	0.3037250000000001	39
Q9QXS1	PF00681	4184	4223	0.031325000000000006	39	G5C5U7	4925	4964	0.031325000000000006	39
Q9QXS1	PF00681	4286	4315	0.0	29	G5C5U7	5027	5056	0.0	29
Q9QXS1	PF00681	4453	4490	0.2272105263157895	37	G5C5U7	5191	5228	0.2273947368421052	37
Q9QXS1	PF00681	4529	4568	0.06	39	G5C5U7	5267	5306	0.05992500000000001	39
Q9QXS1	PF03501	6	98	10.416956989247312	92	G5C5U7	101	193	7.2051827956989225	92
Q9QXS1	PF17902	937	1003	0.8163432835820896	66	G5C5U7	1068	1134	0.5683283582089551	66
Q9QXS1	PF18373	1038	1115	0.5376025641025639	77	G5C5U7	1169	1246	0.5328717948717947	77
P51827	PF05110	44	191	0.004256756756756757	147	G5BMS2	27	174	0.008486486486486484	147
P51827	PF05110	194	499	0.0	305	G5BMS2	177	480	0.0	303
P51827	PF18875	792	805	8.099357142857142	13	G5BMS2	675	688	7.4724999999999975	13
P51827	PF18876	989	1251	1.3590228136882132	262	G5BMS2	871	1133	1.3607528517110266	262
Q64511	PF00204	291	434	7.897069444444448	143	G5BF97	630	768	7.604561151079136	138
Q64511	PF00521	721	1176	2.83653289473684	455	G5BF97	1055	1510	2.8343574561403515	455
Q64511	PF01751	465	566	3.99628431372549	101	G5BF97	799	900	3.961098039215688	101
Q64511	PF02518	87	232	2.544705479452055	145	G5BF97	125	270	2.5339657534246576	145
Q64511	PF08070	1494	1596	0.0	102	G5BF97	1801	1903	0.0	102
Q64511	PF16898	581	719	4.412827338129496	138	G5BF97	915	1053	4.40751798561151	138
Q7TMQ7	PF00400	565	590	0.7563076923076921	25	G5BS16	525	550	0.7453461538461537	25
P63030	PF03650	20	102	8.088421686746987	82	G5BDY3	21	104	6.325698795180725	83
Q5SWT3	PF00153	1	85	6.989623529411764	84	G5B5F8	2	86	8.602835294117646	84
Q5SWT3	PF00153	99	194	0.5851979166666665	95	G5B5F8	100	195	0.3628229166666668	95
Q5SWT3	PF00153	207	250	27.801954545454546	43	G5B5F8	208	250	26.99983720930233	42
A2AIV2	PF15912	143	235	0.0	92	G5C4C4	18	109	0.0	91
Q8VHK1	PF00536	489	547	0.5348983050847459	58	G5BNB3	563	621	0.5347966101694915	58
Q8VHK1	PF00536	560	617	0.4064310344827586	57	G5BNB3	634	691	0.4246551724137931	57
Q8VHK1	PF07653	285	343	3.4340677966101696	58	G5BNB3	359	417	4.9494915254237295	58
Q8VHK1	PF12796	31	108	3.9544487179487167	77	G5BNB3	105	182	3.9540000000000006	77
Q8VHK1	PF12796	170	250	2.376567901234569	80	G5BNB3	244	324	2.350135802469136	80
Q8VHK1	PF13637	117	167	0.4604313725490196	50	G5BNB3	191	241	0.4928039215686275	50
Q8VHK1	PF16600	397	454	0.07344827586206898	57	G5BNB3	471	528	0.07344827586206898	57
Q8VHK1	PF16632	1143	1200	0.0	57	G5BNB3	1206	1263	0.04096491228070175	57
Q8VHK1	PF16907	796	876	0.0	80	G5BNB3	870	949	0.0	79
Q9DCA5	PF04427	66	241	9.471295454545457	175	G5BQ92	67	242	9.079022727272726	175
P09103	PF00085	27	132	3.7478113207547166	105	G5BJ77	28	133	2.3312452830188684	105
P09103	PF00085	370	472	0.662864077669903	102	G5BJ77	371	473	0.09327184466019417	102
P09103	PF13848	162	345	5.43513043478261	183	G5BJ77	163	346	5.464331521739129	183
Q3TYD4	PF00884	35	377	5.951653061224487	342	G5BLS1	36	378	6.300903790087463	342
Q3TYD4	PF14707	401	521	0.4735289256198349	120	G5BLS1	402	522	1.3012066115702474	120
Q9D2X0	PF12796	89	151	0.1295873015873016	62	G5BMU7	90	152	0.2799841269841269	62
Q9D2X0	PF13637	35	83	2.2999591836734696	48	G5BMU7	36	84	2.502836734693877	48
Q569Z6	PF15440	190	755	0.7787809187279152	565	G5C6F8	191	761	1.88478458844133	570
P14733	PF00038	116	387	0.17212867647058827	271	G5B0R9	1	272	0.09768382352941173	271
P14733	PF00932	436	543	2.6593518518518504	107	G5B0R9	321	428	2.5943703703703704	107
Q9D417	PF00415	385	431	2.036234042553192	46	G5BC01	386	432	2.0784042553191497	46
Q9D417	PF12937	29	71	0.7814651162790699	42	G5BC01	53	95	0.07988372093023256	42
Q60779	PF13851	220	419	0.8867149999999998	199	G5APG8	196	408	1.8045023474178403	212
Q8CIM8	PF12765	184	217	0.0	33	G5AW69	172	205	0.006088235294117647	33
A2ADY9	PF00240	11	76	0.34277272727272723	65	G5BRT1	12	77	0.2808030303030303	65
A2ADY9	PF09668	211	334	3.709443548387098	123	G5BRT1	212	335	4.920008064516129	123
Q9Z204	PF00076	17	79	10.69252380952381	62	G5BFV5	18	80	10.619507936507944	62
Q8C2E7	PF10266	54	1102	9.080401334604387	1048	G5AY99	83	1131	7.531225929456627	1048
Q9WVE8	PF00611	23	97	4.82608	74	G5BPS6	24	98	1.8443733333333332	74
Q9WVE8	PF00018	431	478	0.0	47	G5BPS6	432	479	0.0	47
Q3UE31	PF09741	29	261	10.942248927038612	232	G5BKI0	135	368	11.789226495726496	233
Q9D5Z5	PF01753	103	147	0.039	44	G5C7G7	104	148	0.0	44
Q99LC3	PF01712	59	259	1.8668258706467649	200	G5BHI4	60	308	3.356883534136545	248
Q3UNW5	PF04516	44	237	0.7816288659793815	193	G5B4R1	45	238	0.7765670103092783	193
Q3UNW5	PF18016	306	361	11.45357142857142	55	G5B4R1	307	362	0.35360714285714273	55
Q9CSB4	PF00595	383	465	11.577481927710846	82	G5BNT5	342	424	8.176578313253012	82
Q9CSB4	PF00595	502	574	4.172438356164385	72	G5BNT5	461	533	4.190260273972603	72
Q9CSB4	PF12053	41	82	8.391666666666666	41	G5BNT5	1	42	8.408452380952383	41
Q7TSI0	PF00096	262	284	0.0	22	G5BF49	220	242	0.0	22
Q7TSI0	PF00096	290	312	0.0	22	G5BF49	248	270	0.0	22
Q7TSI0	PF00096	318	340	0.0	22	G5BF49	276	298	0.0	22
Q7TSI0	PF00096	346	368	0.0	22	G5BF49	304	326	0.0	22
Q7TSI0	PF00096	374	396	0.0	22	G5BF49	332	354	0.0	22
Q7TSI0	PF00096	402	424	0.0	22	G5BF49	248	270	0.0	22
Q7TSI0	PF00096	430	452	1.054434782608696	22	G5BF49	388	410	1.0448260869565218	22
Q7TSI0	PF00096	458	480	0.0	22	G5BF49	416	438	0.30399999999999994	22
Q7TSI0	PF00096	486	508	2.8612608695652173	22	G5BF49	444	466	2.696434782608696	22
Q7TSI0	PF00096	514	536	0.0	22	G5BF49	472	494	0.0	22
Q7TSI0	PF00096	542	564	0.9163913043478259	22	G5BF49	500	522	0.9077826086956522	22
Q7TSI0	PF00096	570	592	0.0	22	G5BF49	528	550	0.0	22
Q7TSI0	PF00096	598	620	0.6835217391304349	22	G5BF49	556	578	0.6772608695652174	22
Q7TSI0	PF00096	626	648	0.2977826086956522	22	G5BF49	584	606	0.364217391304348	22
Q7TSI0	PF00096	654	676	0.0	22	G5BF49	612	634	0.0	22
Q7TSI0	PF01352	36	47	0.7070000000000001	11	G5BF49	1	12	0.6654166666666667	11
Q922D8	PF00763	42	124	2.8936626506024106	82	G5BD00	1	83	2.6389879518072297	82
Q922D8	PF01268	317	934	4.817032362459546	617	G5BD00	276	893	4.441453808752024	617
Q922D8	PF02882	128	292	3.8457030303030297	164	G5BD00	87	251	5.68252121212121	164
Q3UEN2	PF15793	693	865	4.1678381502890165	172	G5B978	710	905	5.901653061224492	195
Q8BVG4	PF00326	661	861	7.231373134328363	200	G5C0R6	847	1047	7.4354749999999985	200
Q8BVG4	PF00930	144	568	4.980611764705882	424	G5C0R6	293	723	3.7592389791183294	430
Q9EPK2	PF07986	55	173	3.9800504201680664	118	G5ATH0	59	177	3.8596554621848775	118
O55013	PF04051	18	164	6.178000000000001	146	G5C6F6	19	165	5.378619047619049	146
Q9ERP3	PF00643	122	155	1.2086470588235294	33	G5BZ02	123	156	1.7667647058823528	33
Q9ERP3	PF13445	25	78	0.18814814814814812	53	G5BZ02	26	79	0.1877777777777778	53
Q69ZT1	PF08774	898	1009	4.9146964285714265	111	G5B6I0	901	1012	2.6419553571428565	111
P34914	PF00561	256	529	4.972149635036496	273	G5BY92	259	549	7.779817869415804	290
P34914	PF13419	110	202	8.12137634408602	92	G5BY92	111	202	5.9716195652173925	91
Q91XU3	PF01504	136	418	4.8059399293286225	282	G5BEC8	136	426	6.2805360824742245	290
Q9JI70	PF00118	29	568	3.114407407407405	539	G5B2B2	30	573	4.975981617647052	543
Q9D2Z8	PF00225	30	359	3.702118181818181	329	G5B1Y5	31	365	5.3998179104477595	334
Q9CRB3	PF00576	7	116	4.644327272727273	109	G5APG7	8	117	1.1887727272727282	109
O88428	PF01583	41	196	5.053397435897437	155	G5B5S5	55	210	5.181685897435901	155
O88428	PF01747	389	611	3.8674932735425984	222	G5B5S5	398	620	3.7653856502242147	222
O88428	PF14306	217	380	1.1502439024390247	163	G5B5S5	231	389	0.4504213836477988	158
Q3TLD5	PF02996	37	120	2.25754761904762	83	G5BL41	33	115	3.916301204819277	82
P05017	PF00049	51	76	0.2831538461538461	25	G5AME0	52	77	0.2435769230769231	25
P05017	PF00049	80	108	0.0	28	G5AME0	81	109	0.0	28
P25318	PF00386	571	695	11.37544	124	G5C6F5	573	697	11.192552000000004	124
P25318	PF01391	118	163	0.0	45	G5C6F5	120	165	0.0	45
Q99MY8	PF00439	2449	2524	3.393513157894739	75	G5ARB5	2422	2497	4.164421052631581	75
Q99MY8	PF00856	2145	2250	0.5195	105	G5ARB5	2117	2222	0.5185471698113208	105
Q99MY8	PF01426	2651	2784	0.5257835820895523	133	G5ARB5	2624	2757	0.5258805970149252	133
Q99MY8	PF17907	2092	2130	0.0	38	G5ARB5	2064	2102	0.0	38
Q9Z222	PF01762	155	347	2.8740466321243523	192	G5ATZ9	153	345	2.840264248704667	192
Q8BRG6	PF00651	55	161	8.153130841121492	106	G5BTF0	56	162	7.620757009345795	106
Q8BRG6	PF01344	313	348	13.996388888888893	35	G5BTF0	314	349	11.274722222222225	35
Q8BRG6	PF01344	355	393	8.011564102564101	38	G5BTF0	356	394	2.1046410256410253	38
Q8BRG6	PF01344	399	439	6.225390243902439	40	G5BTF0	400	440	6.2299024390243884	40
Q8BRG6	PF01344	445	481	3.0432972972972974	36	G5BTF0	446	482	3.047	36
Q8BRG6	PF01344	535	568	0.5706470588235294	33	G5BTF0	536	569	0.6711470588235294	33
Q8BRG6	PF07707	167	268	6.154578431372548	101	G5BTF0	168	269	6.157901960784315	101
Q6IQX8	PF00096	60	82	0.7865217391304349	22	G5BFV9	56	78	0.7828695652173913	22
Q6IQX8	PF00096	88	110	0.0	22	G5BFV9	84	106	0.0	22
Q6IQX8	PF00096	276	298	0.10926086956521737	22	G5BFV9	269	291	0.1086521739130435	22
Q6IQX8	PF00096	304	326	0.0	22	G5BFV9	297	319	0.0	22
Q6IQX8	PF00096	502	522	0.0	20	G5BFV9	497	517	0.0	20
Q6IQX8	PF00096	528	550	0.0	22	G5BFV9	523	545	0.0	22
Q99MK8	PF00069	191	452	6.231606870229008	261	G5BSB5	149	410	6.236740458015268	261
Q99MK8	PF00169	560	649	0.2240888888888889	89	G5BSB5	518	607	0.22432222222222226	89
Q99MK8	PF00615	54	173	2.1107083333333336	119	G5BSB5	18	131	0.06642982456140348	113
Q9DAV9	PF05197	36	225	20.5087	189	G5B9T4	37	226	20.551742105263155	189
Q9D516	PF04502	8	383	0.8087845744680854	375	G5BYV1	66	448	0.7608250652741512	382
Q8VDR9	PF06920	1616	2047	1.8451203703703696	431	G5BUI8	1837	2270	1.6769723502304144	433
Q8VDR9	PF11878	48	156	0.07255045871559634	108	G5BUI8	39	146	0.3325462962962963	107
Q8VDR9	PF14429	543	718	3.7576761363636377	175	G5BUI8	537	711	3.3210171428571447	174
Q5XFR0	PF00076	147	213	1.3765820895522387	66	G5C2T5	185	251	0.7354477611940299	66
Q8VE11	PF06602	106	442	7.345362017804155	336	G5AMY2	99	434	4.978991071428574	335
Q8CAQ8	PF09731	42	744	2.3402759601706964	702	G5BG31	43	746	2.1300127840909093	703
Q91ZP9	PF03992	290	360	6.886169014084508	70	G5BFX8	229	299	4.43087323943662	70
Q91ZP9	PF13833	70	87	0.6012222222222222	17	G5BFX8	8	25	0.7578333333333334	17
Q91ZP9	PF13833	96	126	0.0	30	G5BFX8	34	64	0.0	30
Q8BP27	PF10376	104	309	0.01820388349514563	205	G5CAK2	37	245	0.05385167464114832	208
Q5SSG4	PF00307	32	156	6.457559999999997	124	G5B748	33	157	4.919208	124
Q5SSG4	PF02187	205	273	5.032130434782609	68	G5B748	206	274	4.984144927536232	68
O09044	PF00835	85	145	0.0	60	G5BM31	86	147	0.0	61
P26041	PF00373	90	205	9.108163793103447	115	G5AW49	129	244	9.135000000000009	115
P26041	PF00769	337	576	0.0	239	G5AW49	376	615	0.0	239
P26041	PF09379	8	69	9.10935483870968	61	G5AW49	47	108	9.079306451612904	61
P26041	PF09380	209	297	1.2134269662921349	88	G5AW49	248	336	1.2064494382022473	88
Q61827	PF03131	23	114	0.05630434782608695	91	G5BUG3	24	119	0.056343749999999984	95
Q9CPY7	PF00883	196	507	1.6241858974358985	311	G5APR2	197	508	1.5476153846153833	311
Q9CPY7	PF02789	36	168	6.609022556390978	132	G5APR2	37	169	4.673533834586465	132
P97820	PF00069	41	287	3.925595141700406	246	G5C8V8	136	383	3.7452500000000013	247
P97820	PF00780	924	1201	10.013928057553967	277	G5C8V8	1169	1445	9.733981949458489	276
Q9DCI9	PF01783	77	132	0.4602500000000001	55	G5BJZ7	79	134	0.4674285714285714	55
Q6XBJ3	PF00046	427	480	9.008722222222222	53	G5BCD4	230	283	9.020574074074077	53
Q6XBJ3	PF02376	331	405	0.016133333333333333	74	G5BCD4	134	208	0.016266666666666662	74
Q61598	PF00996	15	434	6.617014285714286	419	G5B3J1	1	420	5.567542857142855	419
Q8BSU7	PF03637	35	207	7.3980462427745675	172	G5BBB8	36	208	6.986184971098268	172
Q4VA61	PF00041	888	973	0.18765116279069768	85	G5BHK4	967	1052	0.18776744186046512	85
Q4VA61	PF00041	988	1077	3.0533888888888883	89	G5BHK4	1067	1156	3.054088888888889	89
Q4VA61	PF00041	1092	1178	12.255206896551723	86	G5BHK4	1171	1257	12.37209195402299	86
Q4VA61	PF00041	1192	1276	12.22770588235294	84	G5BHK4	1271	1355	12.228411764705882	84
Q4VA61	PF00041	1387	1466	3.3091125000000003	79	G5BHK4	1466	1545	3.814887500000001	79
Q4VA61	PF00041	1487	1561	4.78256	74	G5BHK4	1566	1640	4.783333333333333	74
Q4VA61	PF07679	242	301	0.20636666666666667	59	G5BHK4	1385	1448	0.021640625	63
Q4VA61	PF07679	407	501	0.4706421052631581	94	G5BHK4	486	580	0.4709157894736842	94
Q4VA61	PF07679	790	883	1.6653723404255318	93	G5BHK4	869	962	1.672382978723404	93
Q4VA61	PF13927	316	388	3.5318904109589035	72	G5BHK4	395	467	4.758917808219178	72
Q4VA61	PF13927	504	576	1.5346575342465754	72	G5BHK4	583	655	1.844808219178082	72
Q4VA61	PF13927	607	672	0.3965909090909092	65	G5BHK4	686	751	0.3988181818181818	65
Q4VA61	PF13927	688	770	0.0913132530120482	82	G5BHK4	767	849	0.0913734939759036	82
Q4VA61	PF13927	1300	1366	0.02067164179104477	66	G5BHK4	1379	1445	0.02067164179104477	66
P97436	PF00046	125	181	0.0	56	G5B9S1	126	182	0.0	56
Q61103	PF00628	329	373	0.0	44	G5B6K9	540	584	0.0	44
Q61103	PF14051	13	83	2.672802816901408	70	G5B6K9	84	154	2.6526197183098588	70
Q6PD10	PF03770	206	425	4.0274363636363635	219	G5BZX2	207	426	3.966245454545455	219
Q8VBX6	PF00595	142	220	5.925354430379747	78	G5AP53	142	220	7.304075949367089	78
Q8VBX6	PF00595	263	333	1.0130422535211263	70	G5AP53	263	333	1.0720563380281691	70
Q8VBX6	PF00595	378	459	2.303439024390243	81	G5AP53	377	458	2.6816585365853665	81
Q8VBX6	PF00595	553	619	1.6955223880597017	66	G5AP53	558	624	1.847850746268656	66
Q8VBX6	PF00595	693	775	6.0565662650602405	82	G5AP53	698	780	6.82197590361446	82
Q8VBX6	PF00595	996	1063	4.373632352941178	67	G5AP53	1006	1073	3.1169999999999987	67
Q8VBX6	PF00595	1145	1222	1.5643205128205129	77	G5AP53	1155	1232	2.7944871794871795	77
Q8VBX6	PF00595	1338	1414	8.284532467532468	76	G5AP53	1348	1424	8.15922077922078	76
Q8VBX6	PF00595	1471	1548	1.9858076923076924	77	G5AP53	1480	1557	1.880076923076924	77
Q8VBX6	PF00595	1614	1692	5.105974683544303	78	G5AP53	1627	1705	6.4512658227848085	78
Q8VBX6	PF00595	1710	1787	3.7701794871794867	77	G5AP53	1723	1800	3.892294871794873	77
Q8VBX6	PF00595	1847	1928	7.178219512195122	81	G5AP53	1860	1941	7.283975609756098	81
Q8VBX6	PF00595	1972	2052	11.426703703703707	80	G5AP53	1984	2064	8.984962962962962	80
Q8VBX6	PF09045	5	62	0.30151724137931035	57	G5AP53	6	63	0.26932758620689656	57
Q8VBX6	PF16667	1549	1610	0.12422580645161295	61	G5AP53	1558	1623	0.027954545454545454	65
Q91VR5	PF00270	25	130	3.0554245283018875	105	G5BET5	20	125	3.0549905660377377	105
Q91VR5	PF00271	499	608	4.4603636363636365	109	G5BET5	494	603	4.45961818181818	109
Q91VR5	PF00622	131	243	0.21778761061946905	112	G5BET5	126	238	0.2177433628318584	112
Q9D219	PF11502	349	387	0.0	38	G5BBL4	350	388	0.0	38
Q65Z93	PF03226	28	120	1.8214408602150547	92	G5BLJ6	29	121	1.8214408602150547	92
Q9WUZ5	PF00992	14	145	0.017772727272727273	131	G5B3A1	31	162	0.0175	131
Q6PAM1	PF09728	169	476	1.7534025974025975	307	G5BU95	169	476	1.7489415584415584	307
Q3UV70	PF00481	202	440	4.12380753138075	238	G5C4C9	254	492	4.336682008368198	238
Q8BWU3	PF15010	79	354	0.1609855072463769	275	G5BTC2	80	350	0.18425092250922515	270
Q69ZJ7	PF07064	733	985	8.52994861660079	252	G5B6S4	730	982	8.525450592885377	252
Q8CIW5	PF13481	386	563	7.3887752808988765	177	G5CAE9	661	838	7.316471910112359	177
Q8BZ52	PF00041	344	424	7.115592592592592	80	G5B1R1	12	92	10.362333333333336	80
Q8BZ52	PF00622	587	703	1.548282051282052	116	G5B1R1	255	371	1.6961025641025642	116
Q8BZ52	PF13765	534	580	0.880085106382979	46	G5B1R1	202	248	1.348212765957447	46
Q61645	PF02373	1045	1132	3.0150113636363636	87	G5B9P7	1043	1130	3.052806818181818	87
P38585	PF03133	87	363	2.3658808664259934	276	G5B001	55	331	3.2468483754512607	276
Q8VE01	PF00782	33	141	4.281064220183487	108	G5BKZ3	34	141	5.792429906542057	107
Q6PB75	PF01909	14	121	3.0108240740740735	107	G5BJC0	15	122	0.6868703703703704	107
Q6PB75	PF03828	177	235	0.4168813559322033	58	G5BJC0	178	236	0.4180508474576271	58
Q8BG18	PF03992	252	324	0.13667123287671232	72	G5BBP4	165	237	0.4712054794520548	72
Q8BG18	PF13833	32	55	0.067	23	G5BBP4	32	55	0.050375	23
P70269	PF00026	77	393	7.908586750788647	316	G5BX53	73	388	10.318693037974679	315
P70269	PF07966	21	49	0.0	28	G5BX53	21	49	0.0	28
Q6PIU9	PF15282	169	347	0.03393854748603352	178	G5BNZ3	118	297	0.07559444444444444	179
Q69Z89	PF00595	1001	1080	0.2367625	79	G5BI71	975	1054	0.3669874999999999	79
Q69Z89	PF00788	90	192	0.005922330097087379	102	G5BI71	62	164	0.02577669902912622	102
Q69Z89	PF01843	662	768	10.650654205607477	106	G5BI71	634	740	10.283429906542057	106
Q922G7	PF03148	16	396	1.0602939632545934	380	G5C6F3	17	408	0.6501122448979593	391
Q8BSS9	PF00536	896	959	7.74015625	63	G5ALZ1	760	823	7.731390624999999	63
Q8BSS9	PF00536	1019	1081	0.0	62	G5ALZ1	873	935	0.0	62
Q8BSS9	PF07647	1104	1163	6.137616666666667	59	G5ALZ1	958	1016	5.766084745762713	58
A3KMN5	PF15252	52	303	0.9303253968253968	251	G5BBZ2	43	294	0.9200239043824702	251
O35717	PF00017	47	128	6.924475609756098	81	G5B013	48	129	7.1428536585365885	81
O35717	PF07525	160	191	0.0	31	G5B013	161	192	0.0	31
P30561	PF00989	111	177	12.442134328358215	66	G5BZI5	132	197	15.38710606060606	65
P30561	PF00010	35	76	0.038571428571428576	41	G5BZI5	57	98	0.038571428571428576	41
P30561	PF08447	291	375	2.2777647058823525	84	G5BZI5	315	399	6.990035294117647	84
Q9CWF6	PF14781	19	125	1.0529906542056076	106	G5BMR9	20	126	2.022345794392524	106
Q9CWF6	PF14782	275	714	3.110643181818181	439	G5BMR9	276	715	4.913974999999995	439
Q9CWF6	PF14783	164	271	0.3562592592592593	107	G5BMR9	165	272	0.3527407407407408	107
P35710	PF00505	555	623	5.52404347826087	68	G5BEH3	278	346	5.514826086956521	68
Q62311	PF02969	10	75	0.015727272727272732	65	G5AN17	11	76	0.01834848484848485	65
Q62311	PF07571	307	396	1.5255666666666667	89	G5AN17	307	396	1.2833666666666668	89
Q8K2H1	PF11488	293	366	3.255608108108108	73	G5C3M9	301	374	3.2500000000000013	73
Q8C167	PF00326	487	701	3.8309255813953467	214	G5BI65	490	704	3.3222139534883715	214
Q8C167	PF02897	109	423	10.62325079365079	314	G5BI65	112	426	10.345453968253961	314
Q61288	PF07714	202	486	5.639266666666669	284	G5ATX9	206	496	5.7443676975945035	290
Q61288	PF08515	172	198	0.0	26	G5ATX9	176	202	0.11503703703703705	26
P51448	PF00104	325	491	17.114059880239516	166	G5AWB8	374	540	16.923790419161673	166
P51448	PF00105	71	139	0.15030434782608695	68	G5AWB8	121	189	0.14918840579710144	68
Q9QWK5	PF00653	62	127	7.062712121212122	65	G5C0I0	63	127	10.775076923076927	64
Q9QWK5	PF00653	161	227	5.005582089552238	66	G5C0I0	162	228	3.4969402985074627	66
Q9QWK5	PF00653	280	345	1.334560606060606	65	G5C0I0	281	346	0.0	65
Q9QWK5	PF05729	464	616	12.287006535947716	152	G5C0I0	465	599	7.5222592592592585	134
Q9QWK5	PF17779	687	741	1.4461454545454542	54	G5C0I0	670	724	0.0848	54
Q9QWK5	PF17889	765	871	2.879570093457944	106	G5C0I0	748	854	5.524532710280376	106
Q9DBD0	PF00405	58	345	1.879493055555557	287	G5BQB0	1	288	2.433135416666668	287
Q9DBD0	PF00405	354	683	2.6767969696969702	329	G5BQB0	297	626	2.3974121212121227	329
D3YZU1	PF00536	2102	2162	0.6046557377049179	60	G5B8T5	1175	1235	0.7266557377049182	60
D3YZU1	PF07653	560	610	0.14058823529411765	50	G5B8T5	561	611	0.13698039215686272	50
D3YZU1	PF12796	189	276	2.892806818181818	87	G5B8T5	190	277	2.907738636363636	87
D3YZU1	PF12796	317	398	5.3387560975609745	81	G5B8T5	318	399	5.354829268292682	81
D3YZU1	PF17820	702	746	0.1068888888888889	44	G5B8T5	694	738	0.10766666666666667	44
P97334	PF00046	145	197	0.6630754716981132	52	G5C4U6	146	197	0.6993076923076923	51
P97813	PF00614	437	463	23.97018518518519	26	G5BWA3	420	446	6.3279259259259275	26
P97813	PF00787	91	191	0.27326732673267323	100	G5BWA3	71	174	0.9583942307692304	103
P97813	PF13091	626	794	3.0301656804733725	168	G5BWA3	609	777	1.6123668639053257	168
Q9D529	PF02893	15	131	3.1666581196581185	116	G5BPR1	16	131	0.7329051724137929	115
Q08EC4	PF08824	432	588	4.700656050955411	156	G5AW10	306	462	7.937070063694267	156
Q08EC4	PF12026	606	802	3.0150812182741107	196	G5AW10	487	682	2.6175918367346944	195
Q3TY60	PF15010	32	324	0.34319795221843	292	G5C2M1	33	325	0.3439385665529011	292
Q9JLY7	PF00782	33	162	3.3540307692307687	129	G5ARC5	34	162	3.353069767441861	128
Q8BWL5	PF00076	57	116	0.05858333333333333	59	G5B987	39	98	0.05858333333333333	59
Q8BWL5	PF00076	136	200	0.007569230769230769	64	G5B987	118	182	0.005046153846153845	64
O70172	PF01504	126	402	4.828346570397112	276	G5AVX4	125	403	4.785480286738354	278
Q9JJL8	PF00587	290	467	5.310752808988767	177	G5AM99	329	506	3.3431292134831465	177
Q9JJL8	PF02403	58	171	0.15201754385964916	113	G5AM99	59	210	2.668052631578948	151
Q8BHD1	PF00400	13	45	15.874060606060608	32	G5BSI7	24	55	4.506874999999998	31
Q8BHD1	PF00400	55	86	2.436593750000001	31	G5BSI7	24	55	4.506874999999998	31
Q8BHD1	PF00400	95	129	0.882657142857143	34	G5BSI7	64	98	1.664657142857143	34
Q8BHD1	PF00400	137	171	1.8080571428571424	34	G5BSI7	106	140	0.8516571428571429	34
Q8BHD1	PF00400	188	213	0.6541923076923077	25	G5BSI7	157	182	0.2377692307692308	25
Q8BHD1	PF00400	218	253	0.0661388888888889	35	G5BSI7	187	222	0.6605000000000001	35
Q8BHD1	PF00400	260	296	15.818054054054052	36	G5BSI7	229	265	10.644891891891888	36
Q9DAN9	PF13879	34	128	0.0	94	G5BN84	35	129	0.0971578947368421	94
Q9WUH2	PF00046	267	323	2.498421052631579	56	G5BP35	268	324	2.5027543859649124	56
Q9WUH2	PF00412	70	127	9.812724137931037	57	G5BP35	71	128	9.813931034482763	57
Q9WUH2	PF00412	132	187	0.0822142857142857	55	G5BP35	133	188	0.08239285714285716	55
O35495	PF00069	134	418	7.808014035087713	284	G5BD63	95	379	7.762670175438593	284
Q8K4Z5	PF00240	719	785	1.1330298507462693	66	G5APV2	722	788	6.965388059701491	66
Q8K4Z5	PF01805	49	100	0.1572307692307692	51	G5APV2	50	101	0.15734615384615386	51
Q8K4Z5	PF01805	163	214	1.9521538461538464	51	G5APV2	164	215	1.870057692307692	51
Q8K4Z5	PF12230	232	469	0.04960084033613446	237	G5APV2	233	472	0.04924166666666666	239
Q8BRM6	PF13971	1	257	5.184466926070037	256	G5C8T4	2	251	6.056808000000004	249
Q9JKS4	PF00412	546	599	2.077314814814815	53	G5APG1	547	600	2.087	53
Q9JKS4	PF00412	605	659	2.1168181818181817	54	G5APG1	606	660	2.5401636363636366	54
Q9JKS4	PF00412	664	696	7.471818181818183	32	G5APG1	665	696	5.10558064516129	31
Q9JKS4	PF00595	8	80	3.311643835616439	72	G5APG1	9	81	3.3245205479452045	72
Q9JKS4	PF15936	190	292	0.3825631067961165	102	G5APG1	266	362	0.4045463917525773	96
P47993	PF00048	31	82	15.738538461538464	51	G5CB53	22	73	7.675057692307693	51
Q9CQ25	PF12926	13	97	8.082882352941175	84	G5C041	6	73	1.0745882352941176	67
Q571B6	PF02205	726	744	12.363789473684205	18	G5BF09	497	515	21.945000000000004	18
Q571B6	PF15871	206	434	5.221960698689956	228	G5BF09	1	230	6.206113043478262	229
Q8CB27	PF02338	150	238	11.697146067415714	88	G5BP13	111	199	11.619629213483146	88
P04444	PF00042	7	111	4.225171428571429	104	G5BS34	8	112	4.593304761904762	104
P97459	PF00010	50	95	0.24619565217391304	45	G5AV03	47	91	0.060555555555555564	44
P97459	PF00989	140	197	13.010775862068968	57	G5AV03	139	196	12.971603448275859	57
P97459	PF08447	316	397	9.584292682926828	81	G5AV03	315	396	9.25980487804878	81
Q8BWJ3	PF00723	7	918	8.053578947368418	911	G5BDT3	8	915	9.198982378854623	907
Q9ESN6	PF00630	323	417	4.685063157894737	94	G5BMJ9	324	418	4.6667578947368415	94
Q9ESN6	PF00643	115	153	0.0	38	G5BMJ9	116	154	0.0	38
Q9ESN6	PF01436	485	512	0.3045	27	G5BMJ9	539	566	0.3128214285714285	27
Q9ESN6	PF01436	532	559	5.869142857142856	27	G5BMJ9	586	613	6.4223928571428575	27
Q9ESN6	PF01436	575	601	21.86592592592592	26	G5BMJ9	629	655	21.86644444444445	26
Q9ESN6	PF01436	621	648	0.042321428571428565	27	G5BMJ9	675	702	0.042321428571428565	27
Q9ESN6	PF01436	668	695	0.32146428571428576	27	G5BMJ9	722	749	0.32128571428571423	27
Q9ESN6	PF01436	712	739	0.0	27	G5BMJ9	766	793	0.0	27
Q9ESN6	PF13445	22	60	5.8731282051282045	38	G5BMJ9	23	61	4.5431282051282045	38
Q99LI7	PF05843	374	648	6.793301818181821	274	G5AN90	367	641	6.629836363636366	274
Q9CXG3	PF00076	241	311	6.168746478873242	70	G5BMC8	242	312	4.9322394366197155	70
Q9CXG3	PF00160	2	158	0.5720445859872612	156	G5BMC8	3	159	0.5704968152866243	156
P56960	PF00570	505	571	10.915880597014928	66	G5C519	506	572	8.028835820895523	66
P56960	PF01612	288	454	7.168479041916169	166	G5C519	289	455	7.198143712574852	166
P56960	PF08066	43	132	1.7470555555555554	89	G5C519	44	133	1.883511111111112	89
Q9D8I3	PF00903	30	141	6.598919642857143	111	G5BJH9	1	112	3.406946428571428	111
O70137	PF00046	153	209	0.7990175438596492	56	G5BD72	151	207	0.793421052631579	56
Q80X56	PF00622	377	480	4.8193653846153826	103	G5BF73	346	450	2.3002761904761897	104
Q80X56	PF13765	325	373	0.6573469387755102	48	G5BF73	294	342	0.6817346938775509	48
Q80X56	PF15227	41	81	0.2057560975609756	40	G5BF73	10	50	0.0	40
Q9CPV5	PF03980	70	167	0.38184693877551	97	G5AR98	176	273	0.3797346938775511	97
Q9CRB8	PF10558	18	61	20.97611363636364	43	G5APU8	19	62	29.44568181818182	43
Q9CRB8	PF10558	75	145	10.519929577464788	70	G5APU8	76	146	12.237591549295768	70
Q562D6	PF01980	44	163	5.930225000000003	119	G5AZ27	20	139	5.950466666666669	119
B2RQC6	PF00117	180	354	2.6701828571428567	174	G5BYZ9	181	355	3.5378914285714287	174
B2RQC6	PF00185	2071	2219	2.9324026845637583	148	G5BYZ9	2072	2220	3.6325234899328858	148
B2RQC6	PF00988	1	136	5.027867647058821	135	G5BYZ9	2	137	4.961963235294117	135
B2RQC6	PF01979	1463	1526	0.617984375	63	G5BYZ9	1464	1527	0.6168281249999998	63
B2RQC6	PF02142	1326	1426	0.9113960396039604	100	G5BYZ9	1327	1427	0.9285247524752476	100
B2RQC6	PF02729	1923	2064	1.0968521126760555	141	G5BYZ9	1924	2065	1.5799999999999996	141
B2RQC6	PF02786	513	716	0.3982205882352942	203	G5BYZ9	514	717	0.3986176470588235	203
B2RQC6	PF02786	1049	1247	3.1315577889447237	198	G5BYZ9	1050	1248	4.622286432160804	198
B2RQC6	PF02787	800	876	17.040168831168835	76	G5BYZ9	801	877	17.73405194805195	76
Q9QZZ4	PF00063	1207	1870	5.845051204819278	663	G5BMX3	1180	1841	5.5256374622356565	661
Q9QZZ4	PF00612	1888	1906	0.040263157894736834	18	G5BMX3	1859	1877	5.393684210526316	18
Q9QZZ4	PF00612	1909	1929	0.21023809523809525	20	G5BMX3	1880	1900	0.4631428571428572	20
Q9QZZ4	PF00784	2092	2191	6.813760000000001	99	G5BMX3	2063	2167	7.454695238095236	104
Q9QZZ4	PF00784	3075	3182	9.898388888888894	107	G5BMX3	3051	3158	5.229750000000001	107
Q9QZZ4	PF07653	2851	2931	5.545666666666668	80	G5BMX3	2827	2907	4.846716049382716	80
Q6NZB0	PF00226	56	116	1.1245901639344256	60	G5AP85	57	117	1.1245901639344256	60
Q8CGU1	PF07888	121	588	1.1907286324786324	467	G5BIE9	122	589	1.118215811965812	467
Q8CGU1	PF17751	14	117	3.501884615384616	103	G5BIE9	15	118	3.620519230769231	103
Q8CGU1	PF18112	653	679	0.24937037037037035	26	G5BIE9	654	680	0.039703703703703706	26
Q9Z1X4	PF07528	218	337	1.977191666666667	119	G5BBY8	20	135	0.025586206896551725	115
Q9Z1X4	PF00035	410	463	0.5619444444444445	53	G5BBY8	207	260	3.7944629629629625	53
Q9Z1X4	PF00035	528	560	0.06581818181818183	32	G5BBY8	325	356	0.0676875	31
P61971	PF02136	9	120	4.6411339285714295	111	G5C676	10	121	4.621616071428571	111
Q8K4P1	PF15180	20	93	0.674	73	G5BJ81	24	106	0.08638554216867468	82
Q9Z1B8	PF00628	89	139	1.4355294117647055	50	G5BK19	90	140	2.1722352941176473	50
Q9Z1B8	PF18104	33	68	6.571527777777777	35	G5BK19	34	69	6.864527777777777	35
Q9Z1B8	PF14061	527	555	0.6155862068965517	28	G5BK19	535	563	0.6213448275862068	28
Q99LE1	PF11461	122	172	3.0398235294117653	50	G5AWS7	133	182	0.22676	49
Q6PAR0	PF01344	256	301	0.908108695652174	45	G5BH80	181	226	0.918717391304348	45
Q6PAR0	PF13418	311	357	0.5730425531914896	46	G5BH80	236	282	0.3606170212765956	46
Q6PAR0	PF13964	88	140	3.275566037735849	52	G5BH80	13	65	3.3051132075471688	52
Q6PAR0	PF13964	205	244	10.851375000000004	39	G5BH80	130	169	12.804525000000002	39
Q69ZF8	PF16682	455	507	0.0	52	G5C834	456	508	0.0	52
Q69ZF8	PF16685	41	110	1.2033	69	G5C834	42	111	1.2099857142857144	69
Q61845	PF15163	10	85	4.908381578947369	75	G5C5E0	11	86	2.8820657894736845	75
Q8BLY7	PF15702	134	762	4.2270333863275065	628	G5CAG5	1	626	2.2731501597444104	625
P15919	PF12940	383	1018	2.7795188679245286	635	G5B131	388	1022	2.6993055118110214	634
P15919	PF00097	289	327	0.0	38	G5B131	294	332	0.0	38
P15919	PF10426	350	379	0.21320000000000006	29	G5B131	355	384	0.2782333333333334	29
P15919	PF12560	11	287	0.09634296028880866	276	G5B131	12	292	2.6953309608540925	280
Q6NVG7	PF01755	340	523	5.876934782608695	183	G5BGP5	224	407	5.614277173913044	183
Q6NVG7	PF13704	119	177	7.3954915254237275	58	G5BGP5	1	59	7.061016949152541	58
Q9QX60	PF01712	40	270	1.046554112554113	230	G5AXG9	41	270	1.8201004366812232	229
Q8BGX0	PF00025	398	563	8.872524096385538	165	G5B0E7	399	564	9.092024096385538	165
Q8BGX0	PF00643	125	167	4.548860465116278	42	G5B0E7	126	168	4.558953488372095	42
Q8BGX0	PF14634	29	75	0.18206382978723396	46	G5B0E7	30	76	0.10648936170212768	46
P36536	PF00025	11	196	9.075456989247307	185	G5B193	12	197	9.713118279569896	185
Q8CAV0	PF02130	32	147	1.701353448275862	115	G5C7V4	33	148	1.4380603448275862	115
A2RTL5	PF15477	295	364	0.0	69	G5AWR1	276	345	0.0	69
Q921L7	PF05175	163	248	1.6234069767441859	85	G5BZT4	164	249	0.6306976744186046	85
Q921L7	PF17827	46	115	1.5708285714285717	69	G5BZT4	47	116	1.9106714285714288	69
Q61179	PF10401	211	375	4.821909090909092	164	G5B292	212	376	4.703133333333331	164
Q61179	PF00605	10	113	0.7581730769230769	103	G5B292	11	115	4.059780952380951	104
Q3UIA2	PF00620	267	412	5.084815068493149	145	G5B945	260	405	4.756773972602738	145
Q3UIA2	PF03114	18	237	2.8935681818181807	219	G5B945	11	230	3.1849681818181805	219
Q8QZZ8	PF00071	10	163	9.64841558441558	153	G5B529	11	163	9.655620915032683	152
Q3V3I5	PF15076	17	89	0.009835616438356164	72	G5BPB1	19	91	0.0	72
Q9Z223	PF02391	49	159	6.3183423423423415	110	G5BVD5	50	160	8.456234234234232	110
Q61488	PF01079	187	393	3.952898550724637	206	G5AU29	188	394	3.952898550724637	206
Q61488	PF01085	22	184	3.0603558282208594	162	G5AU29	23	185	3.0603558282208594	162
O88448	PF13176	368	398	0.20970967741935484	30	G5BWX0	370	400	1.6169677419354835	30
O88448	PF13424	196	270	12.639093333333333	74	G5BWX0	198	272	12.63665333333333	74
O88448	PF13424	279	352	2.965972972972973	73	G5BWX0	281	354	2.868932432432432	73
Q7TSH2	PF00723	249	869	7.595212560386473	620	G5BGD1	413	983	7.803665499124342	570
Q3U2V3	PF00293	45	153	8.079449541284403	108	G5B9P6	46	154	6.928504587155963	108
Q6ZQL4	PF00400	122	152	0.0	30	G5C2Y1	123	153	0.44896774193548383	30
Q6ZQL4	PF00400	163	192	0.4604333333333333	29	G5C2Y1	164	193	0.7560333333333334	29
Q6ZQL4	PF04003	470	572	4.527135922330097	102	G5C2Y1	473	575	8.309058252427185	102
P59764	PF06920	1093	1593	2.548081836327343	500	G5BCA6	1126	1626	2.7146586826347283	500
P59764	PF07653	12	61	5.495360000000002	49	G5BCA6	1	50	0.1263	49
P59764	PF14429	396	580	8.875162162162159	184	G5BCA6	385	569	8.308513513513518	184
P59764	PF16172	69	391	3.729978328173372	322	G5BCA6	58	380	3.670743034055728	322
Q5SQF8	PF13866	66	93	0.09107142857142857	27	G5AY10	11	38	0.09125	27
Q5SQF8	PF13867	112	164	14.964245283018869	52	G5AY10	57	109	14.959169811320754	52
Q9ESN5	PF11802	13	270	4.6267984496124015	257	G5B0E5	12	269	2.9770389105058364	257
Q9Z207	PF02181	615	891	3.501949458483756	276	G5BCM7	671	946	3.388300724637681	275
Q9Z207	PF06345	1038	1052	0.0	14	G5BCM7	1015	1029	0.0	14
Q9Z207	PF06367	283	468	3.9343010752688174	185	G5BCM7	340	524	12.158497297297302	184
Q9Z207	PF06371	97	275	4.965541899441344	178	G5BCM7	119	332	4.247434579439252	213
Q99MQ3	PF00069	265	501	2.0964219409282703	236	G5C4W7	150	383	2.6553162393162393	233
Q02819	PF13499	245	318	6.205081081081081	73	G5BAG8	246	319	4.97731081081081	73
P33242	PF00104	257	438	11.758675824175828	181	G5B6W6	257	438	12.623285714285707	181
P33242	PF00105	11	78	0.020367647058823525	67	G5B6W6	12	79	0.020367647058823525	67
Q8CEG5	PF13270	85	176	0.0678804347826087	91	G5BU94	86	175	0.07095505617977528	89
Q8K224	PF05127	281	441	12.44726708074534	160	G5AXV3	282	441	11.71836875	159
Q8K224	PF08351	106	200	10.287694736842102	94	G5AXV3	107	201	10.130978947368424	94
Q8K224	PF13718	527	751	3.984675555555555	224	G5AXV3	462	684	4.091856502242154	222
Q8K224	PF13725	762	974	4.592333333333336	212	G5AXV3	695	906	2.8740518867924543	211
Q61316	PF00012	2	583	2.797307560137458	581	G5BN06	3	582	2.684832758620688	579
Q61316	PF00012	599	689	0.06621978021978021	90	G5BN06	599	689	0.14789010989010992	90
Q9ER75	PF05920	160	199	15.250500000000002	39	G5BSD8	175	214	15.260099999999998	39
P70347	PF12845	165	218	0.08222222222222222	53	G5BT31	133	186	0.020648148148148148	53
Q78XR0	PF04051	6	151	3.6709178082191785	145	G5CBL6	7	181	10.007137931034489	174
Q9DBG5	PF03036	21	427	0.5996117936117938	406	G5C0R4	69	473	0.7663283950617286	404
P70284	PF05920	52	91	6.035975	39	G5CAY2	85	124	6.00615	39
Q6QNU9	PF13676	762	772	4.7297272727272714	10	G5B5L1	764	773	1.3170999999999995	9
Q6QNU9	PF13855	269	327	0.16461016949152538	58	G5B5L1	274	332	3.4414576271186434	58
Q6QNU9	PF13855	340	377	0.0	37	G5B5L1	345	382	2.5304473684210524	37
Q9WUR2	PF00378	144	386	8.413604938271606	242	G5C8W8	111	354	7.697704918032793	243
Q9WUR2	PF00887	37	115	0.17683544303797472	78	G5C8W8	5	82	0.25026923076923074	77
Q9CR95	PF07933	6	163	1.843417721518988	157	G5BPN4	7	164	1.8438354430379744	157
Q8CBY1	PF00536	324	380	2.071491228070175	56	G5BF81	326	382	2.0711403508771924	56
E9PW74	PF04548	9	209	4.989736318407965	200	G5AQM9	8	208	3.5933233830845768	200
Q5SUV5	PF00069	108	360	6.138300395256919	252	G5BKF4	109	366	12.296860465116286	257
Q8CI61	PF02179	384	453	1.678914285714286	69	G5B0A6	384	453	1.6537428571428563	69
P83887	PF00091	3	212	1.9302666666666664	209	G5B0J1	4	213	1.8049285714285717	209
O70373	PF08043	88	103	0.0	15	G5C5N3	89	104	0.0	15
O70373	PF08043	150	165	0.0	15	G5C5N3	186	201	0.0	15
O70373	PF08043	185	200	0.0	15	G5C5N3	186	201	0.0	15
O70373	PF08043	265	278	0.0	13	G5C5N3	266	279	0.0	13
O70373	PF08043	302	316	0.0	14	G5C5N3	303	317	0.0	14
O70373	PF08043	340	354	0.0	14	G5C5N3	341	355	0.0	14
O70373	PF08043	375	390	21.2361875	15	G5C5N3	376	391	21.2278125	15
O70373	PF08043	510	525	0.0	15	G5C5N3	506	521	0.0	15
O70373	PF08043	548	563	0.0	15	G5C5N3	544	559	0.0	15
O70373	PF08043	592	606	0.0488	14	G5C5N3	588	602	0.0476	14
Q80TT8	PF01485	1479	1541	0.11277777777777775	62	G5BNL7	2162	2224	0.11261904761904765	62
Q80TT8	PF01485	1571	1617	0.0	46	G5BNL7	2254	2300	0.0	46
Q80TT8	PF03256	519	635	6.95252136752137	116	G5BNL7	1228	1344	7.092760683760687	116
P70700	PF00562	669	1029	6.920119113573407	360	G5B002	664	1024	6.71142105263158	360
P70700	PF04560	1032	1132	8.45732673267327	100	G5B002	1027	1127	8.452396039603961	100
P70700	PF04561	185	373	5.597687830687832	188	G5B002	180	368	2.9688783068783065	188
P70700	PF04563	37	184	3.69968918918919	147	G5B002	38	179	4.5987605633802815	141
P70700	PF04565	455	519	7.442384615384616	64	G5B002	450	514	0.7965846153846154	64
P70700	PF06883	562	620	9.11091525423729	58	G5B002	557	615	8.419779661016946	58
Q99L85	PF10483	14	179	1.4115722891566265	165	G5B5A7	15	180	1.0815361445783132	165
Q99L85	PF10483	226	281	0.0494642857142857	55	G5B5A7	195	250	0.020625	55
Q9CQA9	PF03266	14	180	3.3520359281437138	166	G5BUQ2	54	220	1.1264011976047907	166
O08605	PF00069	51	332	5.183836879432627	281	G5BYH1	67	348	5.19694326241135	281
P34821	PF00019	297	397	2.8075049504950518	100	G5C4Z0	171	272	1.680401960784314	101
P34821	PF00688	130	247	3.672415254237287	117	G5C4Z0	2	121	4.661508333333334	119
Q9D8T7	PF00076	21	81	0.030573770491803282	60	G5AW37	22	82	8.296377049180329	60
Q03059	PF00755	23	611	5.1652275042444815	588	G5B0X0	101	689	6.101020373514434	588
P02468	PF00053	283	326	0.0	43	G5B451	250	293	0.0	43
P02468	PF00053	339	392	0.0	53	G5B451	306	359	0.0	53
P02468	PF00053	395	439	0.0	44	G5B451	362	406	0.0	44
P02468	PF00053	442	489	0.05666666666666668	47	G5B451	409	456	0.0565625	47
P02468	PF00053	686	708	0.0	22	G5B451	653	675	0.0	22
P02468	PF00053	721	767	0.03017021276595745	46	G5B451	688	734	0.018063829787234045	46
P02468	PF00053	770	814	0.017555555555555557	44	G5B451	737	781	0.2942222222222222	44
P02468	PF00053	825	878	0.14922222222222226	53	G5B451	792	845	0.15057407407407405	53
P02468	PF00053	881	929	0.0	48	G5B451	848	896	0.0	48
P02468	PF00053	932	977	0.0	45	G5B451	899	944	0.0	45
P02468	PF00053	980	1025	0.0	45	G5B451	947	992	0.0	45
P02468	PF00052	555	685	0.030648854961832082	130	G5B451	522	652	0.05148091603053435	130
P02468	PF00055	47	281	4.549217021276591	234	G5B451	14	248	4.527987234042556	234
O70279	PF09751	37	403	0.25240871934604897	366	G5C050	35	401	0.24044686648501365	366
Q60759	PF00441	288	427	1.217464285714285	139	G5BYW3	290	429	1.3272785714285722	139
Q60759	PF02770	175	268	5.872542553191487	93	G5BYW3	177	270	5.822510638297875	93
Q60759	PF02771	61	171	1.2138558558558563	110	G5BYW3	63	173	1.6424864864864863	110
Q7JJ13	PF00439	84	164	2.0548395061728395	80	G5BB04	85	165	2.553209876543209	80
Q7JJ13	PF00439	351	438	0.3483522727272728	87	G5BB04	352	439	0.34874999999999995	87
Q7JJ13	PF17035	638	700	0.2117936507936508	62	G5BB04	639	701	0.24538095238095234	62
Q9CYQ7	PF02256	401	448	0.0	47	G5BJA7	446	493	0.0	47
Q9CYQ7	PF02906	99	386	2.8402534722222232	287	G5BJA7	99	431	2.288339339339339	332
Q9DAK3	PF00071	15	206	5.721302083333334	191	G5C361	16	207	5.7007656250000025	191
Q9DAK3	PF00651	474	579	7.262301886792453	105	G5C361	476	581	1.7121226415094335	105
Q3U1Z5	PF02188	63	82	0.0	19	G5C3I7	64	83	0.0	19
Q3U1Z5	PF02188	132	152	0.23404761904761906	20	G5C3I7	133	153	0.2348095238095238	20
Q4VBD9	PF00096	345	368	0.0	23	G5CBD0	370	393	0.0	23
Q4VBD9	PF00096	434	454	0.0	20	G5CBD0	459	479	0.0	20
Q4VBD9	PF00096	488	510	0.0	22	G5CBD0	513	535	0.0	22
Q4VBD9	PF00096	516	538	0.0	22	G5CBD0	541	563	0.0	22
Q4VBD9	PF00096	544	566	0.0	22	G5CBD0	569	591	0.0	22
Q4VBD9	PF00096	572	594	0.0	22	G5CBD0	597	619	0.0	22
Q4VBD9	PF00651	21	129	8.352623853211012	108	G5CBD0	22	130	4.55916513761468	108
Q4VBD9	PF13912	403	426	0.0	23	G5CBD0	428	451	0.0	23
Q4VBD9	PF13912	460	482	0.0	22	G5CBD0	485	507	0.0	22
P45376	PF00248	15	288	3.276919708029198	273	G5BFL9	16	289	3.480558394160583	273
O35206	PF01391	611	664	0.0	53	G5AZ16	497	550	0.0	53
O35206	PF01391	661	710	0.0	49	G5AZ16	547	595	0.0	48
O35206	PF01391	807	849	0.0	42	G5AZ16	694	736	0.0	42
O35206	PF01391	862	911	0.0	49	G5AZ16	749	798	0.0	49
O35206	PF06482	1113	1160	8.923250000000003	47	G5AZ16	1003	1049	7.986127659574469	46
O35206	PF06482	1180	1361	3.395324175824176	181	G5AZ16	1070	1251	3.5048021978021984	181
O35206	PF13385	96	233	13.68752898550724	137	G5AZ16	2	139	15.087108695652162	137
Q8BTY1	PF00155	28	408	6.032556430446193	380	G5ASD5	30	411	6.281500000000002	381
Q9CZH3	PF10178	33	117	17.245458823529404	84	G5BUG5	34	118	16.122035294117644	84
Q8VE80	PF00400	46	80	6.558857142857143	34	G5BPY3	47	81	8.663314285714286	34
Q8VE80	PF00400	93	127	1.694142857142857	34	G5BPY3	94	128	1.694142857142857	34
Q8VE80	PF08662	134	242	3.4457339449541293	108	G5BPY3	135	243	3.4397798165137625	108
Q8VE80	PF12894	265	314	3.03982	49	G5BPY3	266	315	3.03982	49
O35309	PF07292	105	192	2.3588636363636355	87	G5B7R9	106	193	3.2890568181818183	87
O35309	PF07292	203	291	8.372820224719101	88	G5B7R9	204	292	6.9698202247191015	88
O35309	PF07334	29	104	0.009434210526315791	75	G5B7R9	30	105	0.5956973684210526	75
Q8BGP6	PF00153	13	134	7.664786885245904	121	G5C4X5	13	134	8.114418032786883	121
Q8BGP6	PF00153	145	227	11.442240963855426	82	G5C4X5	145	227	7.665819277108437	82
Q8BGP6	PF00153	234	331	1.9700000000000009	97	G5C4X5	234	331	2.940071428571428	97
Q6U7H8	PF01504	131	389	9.324776061776065	258	G5BLF8	132	455	5.862617283950617	323
Q8R1F0	PF09495	0	79	0.0	79	G5BYU8	1	82	0.0	81
P30412	PF00160	43	195	7.300156862745098	152	G5C8I7	6	158	6.928267973856213	152
A6H6A9	PF00566	541	743	17.802108374384233	202	G5ARS3	546	748	16.10128078817734	202
A6H6A9	PF12473	289	420	12.228378787878786	131	G5ARS3	290	425	18.141860294117645	135
Q91VU8	PF11232	89	237	4.132892617449663	148	G5B8R0	33	181	4.148577181208055	148
Q91VU8	PF11232	254	398	4.9856965517241365	144	G5B8R0	198	342	5.041068965517241	144
Q02596	PF05242	38	150	0.0197787610619469	112	G5BIC9	22	141	5.8333333333333326e-05	119
Q3V0M2	PF14580	125	147	1.6737391304347826	22	G5C658	19	41	0.0	22
Q8BGR9	PF00240	4	76	0.033205479452054786	72	G5BEN2	5	77	0.033205479452054786	72
Q8BGR9	PF03031	137	299	3.8329754601227037	162	G5BEN2	138	300	3.7960552147239297	162
Q7TMY7	PF03810	21	100	0.4494	79	G5BLL5	22	101	0.4522000000000001	79
Q7TMY7	PF08506	193	440	7.076487903225808	247	G5BLL5	194	441	7.090620967741931	247
Q80YT5	PF03190	66	226	8.110105590062117	160	G5C4K3	85	245	4.953366459627329	160
O08755	PF00046	385	438	0.5999444444444443	53	G5C9C8	180	233	0.6069074074074076	53
O08755	PF02376	289	363	0.016133333333333333	74	G5C9C8	84	158	0.016346666666666666	74
P50652	PF02106	0	512	8.796635477582848	512	G5B6H3	1	513	9.57675243664718	512
Q8BJS8	PF14918	0	268	6.627059479553906	268	G5C9Q7	1	261	6.396114942528738	260
Q8BJS8	PF14919	286	625	2.3035823529411767	339	G5C9Q7	287	625	2.2998407079646004	338
Q8BJS8	PF14920	629	883	0.481807843137255	254	G5C9Q7	629	900	0.13863970588235291	271
Q99LM3	PF00307	360	445	7.5284767441860465	85	G5BLJ3	314	399	7.486941860465117	85
Q9CQL0	PF10294	26	188	15.527196319018405	162	G5C182	27	205	15.368988826815652	178
Q8BVD7	PF00386	148	272	7.8195200000000025	124	G5BGB9	149	273	8.52396	124
Q8BVD7	PF01391	36	91	0.0	55	G5BGB9	37	92	0.0	55
Q8BVD7	PF01391	82	136	0.0	54	G5BGB9	83	137	0.0	54
Q9R269	PF17902	387	450	2.3028437500000005	63	G5B2M2	444	507	0.32906250000000004	63
Q9WV96	PF02953	2	63	8.059467741935482	61	G5BBQ7	3	64	8.319387096774191	61
Q8BYM8	PF01406	60	348	2.392411764705884	288	G5AZ44	16	303	4.5679756944444465	287
Q8VCG3	PF00400	263	294	0.0	31	G5AYJ5	264	295	0.0	31
P08553	PF00038	97	408	0.2508461538461536	311	G5BYB1	109	393	0.29840701754385945	284
P08553	PF04732	52	96	0.0	44	G5BYB1	68	108	0.0	40
O35382	PF04048	44	142	0.5963636363636364	98	G5C4D7	45	143	0.6011616161616161	98
P70217	PF00046	272	328	5.632929824561403	56	G5BU14	138	194	5.669578947368421	56
P70217	PF12284	135	168	0.0	33	G5BU14	1	34	0.0	33
Q9D2P4	PF09138	6	100	12.598957894736841	94	G5ASE8	7	101	12.499319148936172	94
Q8BYW9	PF04577	244	469	3.756778761061946	225	G5AVQ8	245	470	4.398579646017701	225
A2AU72	PF00514	56	86	0.3829677419354839	30	G5AVX6	57	87	0.8154193548387096	30
A2AU72	PF00514	142	176	0.2311142857142857	34	G5AVX6	143	177	0.2842857142857143	34
A2AU72	PF00514	355	383	2.599931034482758	28	G5AVX6	356	384	1.8949310344827588	28
A2AU72	PF00514	470	502	6.129636363636363	32	G5AVX6	471	503	3.7704242424242422	32
A2AU72	PF14381	747	866	0.37613333333333343	119	G5AVX6	749	868	0.4312166666666665	119
Q8R3B1	PF00168	629	731	1.3648932038834962	102	G5ATL5	643	745	0.9141262135922329	102
Q8R3B1	PF00387	491	606	2.4080086206896545	115	G5ATL5	505	620	2.30431896551724	115
Q8R3B1	PF00388	297	429	2.741323308270677	132	G5ATL5	321	452	4.000636363636363	131
Q8R3B1	PF09279	203	287	14.434188235294116	84	G5ATL5	227	311	15.252141176470586	84
Q8R3B1	PF16457	18	125	4.47800925925926	107	G5ATL5	42	149	4.453666666666667	107
E9Q8T2	PF00096	401	423	0.0	22	G5BK29	394	416	0.0	22
E9Q8T2	PF00096	433	456	0.0	23	G5BK29	421	444	0.0	23
E9Q8T2	PF00096	494	516	0.0	22	G5BK29	482	504	0.0	22
E9Q8T2	PF00096	724	746	0.05195652173913043	22	G5BK29	721	743	0.05195652173913043	22
E9Q8T2	PF00096	752	774	0.0	22	G5BK29	749	771	0.0	22
E9Q8T2	PF00096	865	887	0.18617391304347827	22	G5BK29	862	884	0.14104347826086955	22
Q9CQY1	PF04110	54	140	5.996011494252867	86	G5BL88	55	143	10.46864772727273	88
P23804	PF00641	297	324	0.0	27	G5BBG7	304	331	0.0	27
P23804	PF02201	39	94	10.86992857142857	55	G5BBG7	42	97	10.82228571428571	55
Q8BZ21	PF00628	264	311	0.26491666666666663	47	G5BMJ0	265	312	0.2645	47
Q8BZ21	PF01853	563	739	8.197169491525425	176	G5BMJ0	564	740	8.192305084745758	176
Q8BZ21	PF17772	504	558	0.0	54	G5BMJ0	505	559	0.0	54
Q8BP00	PF00612	294	314	1.7676190476190474	20	G5B950	295	315	2.3202857142857143	20
Q8BP00	PF00612	387	407	0.06500000000000003	20	G5B950	388	407	1.38285	19
Q9QXM0	PF00561	127	381	4.599321568627451	254	G5CA88	128	382	4.672768627450981	254
P16043	PF00123	30	57	0.5496785714285715	27	G5B825	32	59	0.0	27
O88783	PF00754	1880	2016	3.881145985401461	136	G5CB46	1797	1933	3.0377445255474447	136
O88783	PF00754	2039	2176	0.6034637681159419	137	G5CB46	1956	2093	0.54981884057971	137
O88783	PF07732	79	192	0.2259736842105263	113	G5CB46	81	194	0.2322982456140351	113
O88783	PF07732	415	485	0.0	70	G5CB46	417	487	0.0	70
O88783	PF07732	1602	1676	4.205146666666667	74	G5CB46	1618	1692	2.7554	74
A2AWP8	PF00621	320	498	7.737614525139666	178	G5BZM9	317	495	7.659810055865919	178
A2AWP8	PF19056	787	1278	7.417101626016262	491	G5BZM9	779	1269	6.62932790224033	490
A2AWP8	PF19057	523	678	2.918974358974358	155	G5BZM9	520	670	3.0722251655629136	150
Q6A0A2	PF05383	162	216	0.4890909090909092	54	G5BUS9	161	215	0.4883272727272727	54
Q9WUA5	PF00782	176	302	8.210685039370077	126	G5BL67	40	166	9.076566929133863	126
Q69ZM6	PF13646	1163	1258	1.9640625	95	G5AKL9	514	609	1.968520833333333	95
Q3V1G4	PF02191	493	743	12.160063745019924	250	G5BU43	494	744	12.923286852589646	250
P70352	PF01129	28	254	6.693938325991188	226	G5AVS7	29	255	6.721356828193834	226
P70441	PF00595	17	89	0.0	72	G5BNE3	91	163	1.5950547945205478	72
P70441	PF00595	151	224	1.6035405405405403	73	G5BNE3	90	163	1.5735	73
P70441	PF09007	229	354	0.7882380952380953	125	G5BNE3	168	291	1.0272926829268292	123
Q80U35	PF00621	1066	1244	5.013525139664805	178	G5ASA6	1066	1244	4.518631284916203	178
Q80U35	PF19056	1732	1970	11.497096234309625	238	G5ASA6	1731	1969	9.778000000000002	238
Q80U35	PF19057	1272	1363	6.632793478260868	91	G5ASA6	1272	1363	6.42186956521739	91
Q91Z67	PF00018	733	778	0.7850869565217392	45	G5BX57	753	798	0.8025434782608695	45
Q91Z67	PF00611	30	113	0.5641904761904761	83	G5BX57	50	133	0.5627380952380951	83
Q91Z67	PF00620	504	653	4.93334	149	G5BX57	524	673	4.5504733333333345	149
P48757	PF00918	60	98	0.0	38	G5B0M1	61	101	0.0	40
Q91XC0	PF00412	346	400	0.32745454545454544	54	G5ASJ8	348	402	0.3149454545454546	54
Q91XC0	PF00412	411	466	0.8456964285714283	55	G5ASJ8	413	468	0.8358928571428572	55
Q91XC0	PF00412	471	535	0.01550769230769231	64	G5ASJ8	473	537	0.01550769230769231	64
Q8BKR5	PF13516	280	302	0.4554347826086957	22	G5CBL7	276	298	0.4543478260869565	22
Q8BKR5	PF13516	338	358	0.0	20	G5CBL7	334	354	0.0	20
Q8BKR5	PF13516	393	415	1.4804782608695652	22	G5CBL7	389	411	1.777217391304348	22
P70268	PF00069	619	877	9.606401544401542	258	G5BYS7	620	878	9.73445173745174	258
P70268	PF00433	900	940	0.0	40	G5BYS7	901	941	0.0	40
P70268	PF02185	45	97	0.0	52	G5BYS7	50	102	0.0	52
P70268	PF02185	127	188	0.0878225806451613	61	G5BYS7	132	193	0.08967741935483872	61
P70268	PF02185	216	278	0.0	62	G5BYS7	218	280	0.0	62
O70475	PF00984	213	307	6.1829368421052635	94	G5C3U6	214	308	6.178663157894736	94
O70475	PF03720	331	445	2.933347826086956	114	G5C3U6	332	446	4.681434782608693	114
O70475	PF03721	5	189	2.9041297297297315	184	G5C3U6	6	190	3.022610810810812	184
O08692	PF00666	22	118	0.03160824742268042	96	G5BTA7	24	122	0.046959595959595965	98
Q61473	PF00505	68	108	9.129073170731706	40	G5B610	69	108	9.3385	39
Q9QVP4	PF13202	37	58	0.07681818181818181	21	G5BIK3	30	51	0.07636363636363637	21
Q9QVP4	PF13833	108	130	2.1143478260869566	22	G5BIK3	101	123	1.5368260869565218	22
Q80VK6	PF00621	225	282	0.5754827586206898	57	G5AT21	21	78	0.6592068965517243	57
Q80VK6	PF03114	316	506	4.462984293193718	190	G5AT21	112	304	0.4663937823834196	192
Q80VK6	PF14604	712	763	3.0188076923076923	51	G5AT21	516	567	1.7429423076923074	51
O70348	PF08652	234	299	0.4258181818181818	65	G5C3H4	235	300	0.2378787878787879	65
O55240	PF00106	30	213	4.500836956521738	183	G5BBA6	31	214	3.080934782608692	183
P70343	PF00656	131	368	6.5291890756302555	237	G5BVT8	65	302	8.495336134453789	237
Q8VIM5	PF02037	380	412	0.0	32	G5BRA7	143	175	0.0	32
Q9WVQ1	PF00397	302	331	0.026166666666666668	29	G5B546	204	233	0.026166666666666668	29
Q9WVQ1	PF00595	21	88	6.738455882352942	67	G5B546	696	761	11.398984848484846	65
Q9WVQ1	PF00595	426	493	11.68136764705882	67	G5B546	334	401	11.684279411764713	67
Q9WVQ1	PF00595	607	667	1.750557377049181	60	G5B546	515	575	0.5286557377049181	60
Q9WVQ1	PF00595	778	856	9.538784810126582	78	G5B546	694	772	9.537759493670883	78
Q9WVQ1	PF00595	919	1004	7.825430232558133	85	G5B546	835	920	7.823953488372101	85
Q9WVQ1	PF00595	1139	1216	0.2212692307692308	77	G5B546	1063	1140	0.2208717948717949	77
Q9WVQ1	PF00625	136	185	8.805819999999999	49	G5B546	37	86	8.818979999999998	49
Q9WVQ1	PF16663	196	257	0.056467741935483866	61	G5B546	98	159	0.14374193548387101	61
Q69ZB0	PF14580	61	142	0.2896219512195122	81	G5ATX4	59	140	0.1391829268292683	81
Q99N87	PF00333	219	284	5.713060606060603	65	G5APT1	219	284	7.843196969696969	65
Q99N87	PF03719	298	366	0.8967826086956521	68	G5APT1	298	366	0.903536231884058	68
Q8BGZ4	PF04049	32	148	6.27988034188034	116	G5BA40	33	149	6.323999999999999	116
Q8BGZ4	PF13181	331	362	2.123625	31	G5BA40	332	363	2.26965625	31
Q8BGZ4	PF13414	371	408	0.07857894736842105	37	G5BA40	372	409	0.0556578947368421	37
Q8R3Q6	PF09774	9	134	0.015960317460317463	125	G5AV83	10	135	0.016571428571428574	125
Q9WUH5	PF00622	363	461	11.60769696969697	98	G5C3A9	266	363	8.1689793814433	97
Q9WUH5	PF00643	100	132	8.466818181818182	32	G5C3A9	1	33	5.042121212121214	32
Q9WUH5	PF13765	312	359	3.7672083333333344	47	G5C3A9	215	262	0.2781041666666667	47
A6H8H2	PF02141	308	490	12.665530054644806	182	G5B2J8	309	491	11.956633879781425	182
A6H8H2	PF03455	597	646	2.1472800000000003	49	G5B2J8	598	647	2.3784799999999997	49
A6H8H2	PF03456	210	273	11.847312499999996	63	G5B2J8	211	274	11.92221875	63
Q9Z1S3	PF00130	541	592	9.693	51	G5C7D1	662	713	9.678903846153846	51
Q9Z1S3	PF00617	207	381	4.714651428571429	174	G5C7D1	328	502	4.74141142857143	174
Q9Z1S3	PF00618	109	152	34.732000000000006	43	G5C7D1	230	273	34.72072727272728	43
Q9Z1S3	PF13202	474	497	0.0	23	G5C7D1	595	618	0.0	23
Q8C3X4	PF00009	48	225	8.936252808988765	177	G5APB3	67	244	7.819280898876411	177
Q8C3X4	PF00679	450	537	5.550613636363639	87	G5APB3	469	556	5.009670454545457	87
Q8C3X4	PF03144	249	319	14.881971830985913	70	G5APB3	268	338	12.38414084507042	70
Q8C3X4	PF06421	539	645	3.9274953271028035	106	G5APB3	558	664	3.8600934579439263	106
Q08890	PF00884	81	416	2.562577380952382	335	G5BQ59	26	361	2.5305297619047598	335
Q80UM3	PF12569	186	697	4.255208984374999	511	G5BXF6	169	680	4.272593749999999	511
Q80UM3	PF13181	82	112	4.095935483870968	30	G5BXF6	65	95	3.4600000000000004	30
Q80XI4	PF01504	129	413	4.1486175438596495	284	G5BK64	77	345	3.9140786516853963	268
Q9CXC3	PF12705	189	290	6.561715686274508	101	G5CBA5	189	291	6.808203883495147	102
Q08288	PF08790	30	57	0.0	27	G5B2Z1	31	58	0.0	27
Q9EPK7	PF03810	29	94	1.6223030303030304	65	G5B9P1	31	96	1.649772727272727	65
Q924C6	PF00530	40	132	0.06268817204301076	92	G5ANF9	40	132	0.07693548387096777	92
Q924C6	PF00530	174	286	0.5645575221238938	112	G5ANF9	174	286	0.06306194690265486	112
Q924C6	PF00530	315	411	0.5777216494845362	96	G5ANF9	315	411	0.5139175257731959	96
Q924C6	PF00530	425	524	0.7818399999999995	99	G5ANF9	425	523	1.4302929292929285	98
Q924C6	PF01186	533	732	3.2521849999999994	199	G5ANF9	526	725	3.430355	199
Q9Z108	PF00035	97	160	0.414390625	63	G5B9N5	186	249	3.6125625	63
Q9Z108	PF00035	196	261	0.8974242424242426	65	G5B9N5	287	352	3.218863636363635	65
Q9Z108	PF16482	356	466	1.7739549549549554	110	G5B9N5	447	557	2.4517387387387384	110
Q8CBE3	PF00400	146	184	2.8413846153846154	38	G5BUS4	147	185	3.1906923076923066	38
Q8CBE3	PF00400	188	225	0.06486842105263158	37	G5BUS4	189	226	0.062105263157894726	37
Q8CBE3	PF00400	315	352	0.2398157894736842	37	G5BUS4	315	352	0.2500789473684211	37
Q8CBE3	PF00400	361	395	7.330999999999999	34	G5BUS4	361	395	7.3166	34
Q8BWF0	PF00171	67	517	2.692170731707316	450	G5BJY3	1	468	2.0063525641025635	467
Q8VD63	PF00956	239	352	3.8655964912280716	113	G5C157	244	357	3.837947368421053	113
Q8K2Z8	PF00179	271	361	5.879923076923076	90	G5AUJ9	267	357	5.227879120879121	90
Q8VDV8	PF04212	14	76	4.707412698412699	62	G5BMT0	15	77	1.2893333333333332	62
Q8VDV8	PF16565	99	241	0.1737972027972028	142	G5BMT0	100	241	0.1625422535211267	141
O89053	PF08954	409	460	0.026346153846153846	51	G5BRC3	410	461	0.0	51
O89053	PF00400	78	108	1.4024193548387094	30	G5BRC3	79	109	1.4029677419354838	30
O89053	PF00400	121	159	12.50292307692308	38	G5BRC3	122	160	12.823384615384615	38
O89053	PF00400	173	201	0.2457931034482759	28	G5BRC3	174	202	0.08086206896551723	28
O89053	PF08953	4	68	6.124615384615384	64	G5BRC3	5	69	8.522215384615382	64
O89053	PF16300	344	386	0.008674418604651162	42	G5BRC3	345	387	0.7141395348837208	42
Q03958	PF01920	9	113	0.07953333333333333	104	G5BAZ2	10	114	0.07991428571428573	104
Q9Z2M7	PF03332	23	240	3.011004587155965	217	G5BSC8	28	245	3.3664678899082547	217
P10605	PF00112	79	327	0.9929558232931724	248	G5AMF3	80	329	2.3002640000000008	249
P10605	PF08127	25	62	0.9756842105263164	37	G5AMF3	26	63	1.0340263157894736	37
A4FUP9	PF00534	204	317	1.4733421052631577	113	G5AWP2	436	548	0.8810000000000001	112
P47945	PF00131	0	60	0.0	60	G5CAW1	1	61	0.0	60
P21275	PF00019	306	406	2.0468613861386142	100	G5BF86	308	408	2.0394554455445544	100
P21275	PF00688	47	275	1.5000567685589519	228	G5BF86	48	276	1.5872401746724891	228
P50752	PF00992	105	243	0.004316546762589928	138	G5B3A3	85	220	0.005551470588235296	135
P50752	PF00992	238	292	0.021	54	G5B3A3	215	269	0.026509090909090902	54
P39749	PF00752	0	104	7.3460095238095215	104	G5AYF5	1	106	7.193132075471701	105
P39749	PF00867	144	230	1.342022988505747	86	G5AYF5	147	233	1.4543448275862068	86
P60487	PF13242	206	284	3.969962025316456	78	G5AYX6	207	285	3.3066455696202515	78
P60487	PF13344	21	126	4.3761226415094345	105	G5AYX6	22	127	4.445160377358492	105
Q9CQ39	PF11221	0	125	4.351333333333332	125	G5AVM7	1	126	4.349460317460316	125
P61213	PF00025	8	185	7.477398876404492	177	G5BCA1	9	186	7.412893258426966	177
Q9EPC1	PF00307	96	201	10.071037735849057	105	G5C7T4	44	149	10.109047169811321	105
Q9EPC1	PF00307	262	368	14.531757009345789	106	G5C7T4	210	316	16.704112149532722	106
Q8CEC0	PF10168	13	750	3.927540650406504	737	G5BW82	14	741	3.869515109890109	727
Q8K3J1	PF12838	111	165	0.1945090909090909	54	G5BTV7	111	165	0.1946	54
Q60715	PF08336	23	154	0.8003712121212119	131	G5C7F9	29	160	0.7434469696969697	131
P70160	PF00214	0	120	9.776446280991737	120	G5BUD9	1	120	13.77032499999999	119
Q9ESP5	PF00096	271	290	0.0	19	G5BBX2	177	196	0.0	19
Q9ESP5	PF00096	299	321	0.0	22	G5BBX2	205	227	0.0	22
Q9ESP5	PF00096	327	349	0.0	22	G5BBX2	233	255	0.0	22
Q9ESP5	PF00096	355	377	0.0	22	G5BBX2	261	283	0.0	22
Q9ESP5	PF00096	411	434	0.0	23	G5BBX2	317	340	0.0	23
Q9ESP5	PF13912	383	407	1.1884800000000002	24	G5BBX2	289	313	1.1991199999999995	24
Q6R891	PF00595	497	578	3.643939024390243	81	G5C4I8	124	205	3.6264512195121936	81
Q6R891	PF17817	425	488	0.4688124999999999	63	G5C4I8	52	115	0.4662968750000001	63
Q9WV93	PF00010	49	104	0.03053571428571428	55	G5BAJ7	50	109	0.028499999999999994	59
Q9WV93	PF07527	123	162	4.42525	39	G5BAJ7	128	167	0.6775	39
Q99K67	PF03435	482	597	1.7210517241379302	115	G5AZE2	483	598	1.3907844827586218	115
Q99K67	PF05222	27	156	1.8168615384615383	129	G5AZE2	28	157	1.892530769230768	129
Q99K67	PF16653	601	915	0.5984476190476193	314	G5AZE2	602	916	1.0308063492063495	314
Q8CCP0	PF05670	526	636	13.522144144144141	110	G5B964	215	325	13.002225225225224	110
Q8CCP0	PF05833	314	513	1.7050150000000002	199	G5B964	1	202	1.6650841584158411	201
Q8CCP0	PF11923	962	1053	0.7411304347826083	91	G5B964	661	752	3.156086956521739	91
Q9QYE0	PF00096	61	85	0.0	24	G5B333	62	86	0.0	24
Q9QYE0	PF00096	120	142	0.0	22	G5B333	121	143	0.0	22
Q9QYE0	PF00096	213	235	0.1431304347826087	22	G5B333	214	236	0.10947826086956523	22
P43027	PF00019	392	493	4.994862745098039	101	G5B852	350	451	4.993941176470588	101
P43027	PF00688	146	337	5.719208333333333	191	G5B852	147	295	5.242543624161074	148
P51879	PF13499	41	106	2.8271666666666664	65	G5BF31	4	69	0.2375151515151515	65
Q8BFS6	PF00149	39	248	8.416571428571428	209	G5B4F7	44	253	8.955542857142857	209
Q8R0V5	PF01231	16	398	6.1245378590078445	382	G5AYK9	283	683	8.452982543640902	400
P63056	PF02191	221	466	6.377422764227642	245	G5AYR0	222	467	6.70810975609756	245
P63056	PF12308	46	144	1.047313131313131	98	G5AYR0	47	145	1.047313131313131	98
Q6NS59	PF05057	1235	1429	8.388241025641026	194	G5ALU8	1247	1441	8.581338461538465	194
Q6NS59	PF12394	111	171	10.124295081967214	60	G5ALU8	112	172	8.808049180327867	60
Q7TQJ8	PF00412	192	246	0.9414363636363638	54	G5BXL4	24	78	0.3255090909090909	54
Q7TQJ8	PF00412	257	311	0.5235636363636363	54	G5BXL4	89	143	0.5296181818181815	54
Q7TQJ8	PF00412	317	381	0.0	64	G5BXL4	149	213	0.0	64
Q5SXJ3	PF06733	333	417	1.444964705882353	84	G5BAX6	1	85	0.7218235294117648	84
Q5SXJ3	PF13307	682	868	8.22295721925134	186	G5BAX6	350	536	8.041572192513371	186
Q8K387	PF00443	191	808	4.694969255663429	617	G5BJP1	191	804	3.550967426710097	613
Q8K387	PF02148	61	136	21.94790789473684	75	G5BJP1	61	136	21.709013157894734	75
Q9CQW2	PF00025	10	178	7.5277928994082774	168	G5BZE9	11	179	7.515248520710053	168
Q91X17	PF00100	335	583	9.8799718875502	248	G5C2G5	365	613	4.642405622489961	248
Q91X17	PF07645	64	97	0.0	33	G5C2G5	103	136	0.0	33
Q91X17	PF12947	115	146	0.1945625	31	G5C2G5	145	176	0.019218750000000003	31
P14152	PF00056	5	151	11.066795918367353	146	G5C8M3	12	158	11.162755102040816	146
P14152	PF02866	155	329	1.362182857142857	174	G5C8M3	162	336	1.3568057142857135	174
Q91WL6	PF00787	48	127	6.838150000000003	79	G5BY15	43	122	7.844025	79
Q9D9I1	PF14983	2	140	0.21351079136690648	138	G5BHU5	3	134	0.005381679389312977	131
Q8CGT6	PF02170	269	398	6.5657230769230726	129	G5BQ55	277	406	8.119746153846151	129
Q8CGT6	PF02171	540	832	7.1473549488054635	292	G5BQ55	548	846	7.513521739130434	298
Q8K0E1	PF02214	57	145	3.6027752808988764	88	G5BXM0	58	146	3.9864382022471903	88
P29037	PF00352	140	219	3.00455	79	G5C7S0	125	204	3.0113874999999988	79
P29037	PF00352	228	309	8.425707317073174	81	G5C7S0	213	294	8.42206097560976	81
Q6VY05	PF14709	253	332	11.4846875	79	G5AR54	100	179	13.825699999999996	79
Q9D2Q8	PF01023	18	57	0.0	39	G5BER0	19	58	0.0	39
Q8CAS9	PF01661	137	254	0.8960338983050852	117	G5AV79	211	327	0.6508547008547008	116
Q8CAS9	PF01661	351	450	1.5004300000000008	99	G5AV79	424	525	6.917598039215688	101
E9Q9W4	PF00501	62	485	10.166287735849057	423	G5BNU7	29	452	8.385577830188677	423
E9Q9W4	PF13193	494	570	0.3355064935064936	76	G5BNU7	461	532	2.760875	71
Q9CPP6	PF04716	21	78	5.410155172413795	57	G5BZQ5	1	58	2.718724137931034	57
Q8K2H3	PF00620	38	186	1.2986644295302014	148	G5BA35	39	187	1.2966711409395968	148
Q8CI33	PF04676	442	533	3.1196195652173917	91	G5B0S8	444	535	3.119858695652174	91
Q8CI33	PF04677	318	423	2.3884056603773587	105	G5B0S8	320	425	2.388745283018868	105
Q80UK8	PF14750	217	1130	8.197145514223198	913	G5C8A2	329	1261	9.25848445873526	932
Q9CQC5	PF00786	29	83	0.010909090909090908	54	G5BZ87	30	84	0.011000000000000001	54
Q9CQC5	PF14957	101	252	0.049190789473684216	151	G5BZ87	102	253	0.04925	151
Q7TN99	PF16366	639	701	0.8121587301587303	62	G5BV06	564	626	0.8136349206349208	62
Q7TN99	PF16367	457	546	7.502899999999999	89	G5BV06	382	471	7.503533333333333	89
A2AU37	PF04824	497	548	12.181730769230775	51	G5AJR2	499	550	4.451865384615384	51
A2AU37	PF04825	0	99	2.8585900000000004	99	G5AJR2	1	100	3.0242799999999983	99
Q9JKB3	PF00313	101	150	0.07936	49	G5BE05	16	65	0.07872000000000001	49
Q7TN31	PF00498	431	504	0.8502297297297298	73	G5ATK2	422	495	0.8542702702702701	73
Q7TN31	PF01585	616	658	0.0	42	G5ATK2	607	649	0.0	42
Q7TN31	PF17780	203	253	0.958627450980392	50	G5ATK2	208	258	0.9599411764705884	50
P59113	PF00169	389	470	7.486951219512192	81	G5BY82	390	471	7.6569024390243925	81
P59113	PF00373	278	386	6.475339449541282	108	G5BY82	279	387	6.405926605504585	108
P59113	PF18124	8	94	0.5464597701149425	86	G5BY82	9	95	0.7663448275862068	86
Q9ERV7	PF00531	800	876	0.7850779220779223	76	G5C8G5	780	856	0.8285324675324671	76
Q9ERV7	PF00791	329	417	6.9176966292134825	88	G5C8G5	329	420	6.012108695652173	91
Q9ERV7	PF00791	468	541	0.05966216216216216	73	G5C8G5	487	560	0.19074324324324324	73
Q9ERV7	PF10461	425	457	20.581606060606056	32	G5C8G5	444	476	20.581363636363637	32
Q9ERV7	PF13855	131	186	9.637589285714283	55	G5C8G5	131	185	7.893181818181818	54
Q9ERV7	PF13855	222	279	0.01517241379310345	57	G5C8G5	222	279	4.544017241379311	57
Q04736	PF00017	155	237	2.515493975903614	82	G5BTT0	156	238	3.863831325301205	82
Q04736	PF00018	94	141	7.2239583333333375	47	G5BTT0	95	142	5.156104166666666	47
Q04736	PF07714	275	523	2.2337269076305235	248	G5BTT0	276	528	2.212466403162056	252
Q4FZC9	PF00435	220	323	1.1516538461538466	103	G5B484	221	324	0.2087980769230769	103
Q4FZC9	PF00435	650	742	2.4446236559139782	92	G5B484	654	746	0.5910645161290321	92
Q4FZC9	PF10541	944	974	1.0483225806451613	30	G5B484	949	979	14.454433333333332	30
Q9R190	PF00320	366	402	7.272513513513513	36	G5AYH4	359	395	7.280648648648648	36
Q9R190	PF01426	8	142	5.532874074074073	134	G5AYH4	1	135	5.553103703703704	134
Q9R190	PF01448	146	197	9.111	51	G5AYH4	139	190	9.112692307692308	51
Q9R190	PF17226	449	523	2.933853333333333	74	G5AYH4	434	508	2.91428	74
Q62348	PF01997	18	215	9.370949494949492	197	G5AWW7	19	216	9.364323232323233	197
F6VAN0	PF00170	293	352	0.05716666666666665	59	G5BWG3	306	365	0.056833333333333326	59
Q03142	PF07679	157	235	1.3837341772151897	78	G5BQ00	7	85	1.4149493670886075	78
Q03142	PF07714	464	739	2.4044673913043457	275	G5BQ00	325	576	5.4211626984127	251
Q03142	PF13927	252	333	0.4631463414634144	81	G5BQ00	102	194	0.25110752688172044	92
Q9D3J8	PF15757	16	209	3.3545979381443303	193	G5BFI4	17	201	3.4388702702702703	184
Q8CE64	PF00096	495	517	0.0	22	G5APH6	419	441	0.0	22
Q8CE64	PF00096	553	576	0.0	23	G5APH6	477	500	0.0	23
Q8CE64	PF07776	78	155	0.9411025641025638	77	G5APH6	3	80	1.6020769230769234	77
Q4VC17	PF00090	592	642	0.0	50	G5BE14	597	647	0.0	50
Q4VC17	PF01421	294	497	10.976200980392164	203	G5BE14	299	502	11.603573529411756	203
Q4VC17	PF01562	64	202	0.2329640287769784	138	G5BE14	68	207	3.1205428571428584	139
Q4VC17	PF05986	749	860	0.2842232142857143	111	G5BE14	754	865	0.5490535714285713	111
Q4VC17	PF08686	1185	1215	0.7012903225806452	30	G5BE14	1190	1220	0.697709677419355	30
Q4VC17	PF17771	510	577	0.03469117647058823	67	G5BE14	515	582	0.11460294117647055	67
Q4VC17	PF19030	934	990	0.0	56	G5BE14	939	996	0.4085344827586207	57
Q4VC17	PF19030	994	1047	0.0	53	G5BE14	1000	1053	0.0	53
Q4VC17	PF19030	1055	1114	0.19545000000000007	59	G5BE14	1061	1120	0.031166666666666662	59
Q4VC17	PF19030	1124	1174	1.4039607843137254	50	G5BE14	1129	1179	0.0	50
P14234	PF00017	131	213	0.7706144578313253	82	G5AUU0	142	224	0.5549879518072288	82
P14234	PF00018	71	117	5.235531914893617	46	G5AUU0	82	128	2.5395106382978723	46
P14234	PF07714	258	499	6.2421239669421515	241	G5AUU0	271	514	6.206479508196722	243
P97379	PF00076	332	388	12.51784210526316	56	G5B1B5	333	389	12.509807017543856	56
P97379	PF02136	10	132	5.1753170731707305	122	G5B1B5	11	133	5.174414634146341	122
Q9QUR6	PF00326	482	705	7.467830357142861	223	G5AWD3	465	688	5.934812499999999	223
Q9QUR6	PF02897	15	421	6.703931203931207	406	G5AWD3	1	404	6.240321782178218	403
Q9R0P3	PF00756	22	205	2.8511249999999984	183	G5C1F0	23	204	3.9377142857142853	181
Q9WTX6	PF00888	20	657	5.0966927899686505	637	G5BET4	21	658	5.09553448275862	637
Q9WTX6	PF10557	705	766	1.242354838709677	61	G5BET4	706	767	1.242354838709677	61
Q8BW86	PF00621	277	442	20.873638554216868	165	G5CA66	318	483	21.09125903614457	165
Q61686	PF00385	19	68	0.5103800000000003	49	G5BID8	20	69	0.4735599999999998	49
Q61686	PF01393	121	173	14.826056603773587	52	G5BID8	122	174	14.826056603773587	52
Q6NS46	PF00575	185	256	1.7729444444444442	71	G5CAJ3	186	257	0.6417222222222223	71
Q6NS46	PF00575	450	521	1.1744722222222226	71	G5CAJ3	451	522	0.19576388888888893	71
Q6NS46	PF00575	545	609	6.053246153846153	64	G5CAJ3	546	610	1.058292307692308	64
Q6NS46	PF00575	728	797	11.296471428571431	69	G5CAJ3	719	788	11.210985714285718	69
Q6NS46	PF05843	1748	1856	4.5758256880733965	108	G5CAJ3	1696	1804	2.9454403669724765	108
P24699	PF00010	83	134	0.0	51	G5BH15	84	135	0.0	51
P24699	PF01586	13	82	0.1747142857142857	69	G5BH15	14	83	0.3046428571428572	69
P24699	PF12232	142	213	0.07829166666666668	71	G5BH15	143	214	0.08784722222222223	71
Q6PCZ4	PF01454	466	632	8.871946107784431	166	G5B9Y2	464	630	6.01116167664671	166
Q32LZ8	PF01734	11	177	5.658646706586827	166	G5ALW2	12	178	3.4119760479041914	166
Q8CI15	PF00781	15	127	4.554522123893807	112	G5AQU9	76	188	4.856982300884958	112
Q9CWI3	PF13862	59	257	7.587733668341711	198	G5C970	59	257	6.622120603015072	198
Q9CQW1	PF00957	135	191	0.0	56	G5BIK5	136	192	0.0	56
Q9CQW1	PF13774	44	107	13.567984374999998	63	G5BIK5	45	108	9.6383125	63
Q9Z0P4	PF03285	70	382	1.513837060702875	312	G5C5W8	150	474	1.9365679012345671	324
Q01339	PF00084	22	71	0.42026	49	G5BGY7	23	72	7.9982799999999985	49
Q01339	PF00084	88	136	0.14383673469387756	48	G5BGY7	89	137	0.1538571428571429	48
Q01339	PF00084	141	199	0.04805084745762712	58	G5BGY7	142	200	0.0	58
Q01339	PF00084	204	259	0.10982142857142857	55	G5BGY7	326	381	0.35178571428571426	55
Q01339	PF09014	260	344	0.2180941176470588	84	G5BGY7	382	466	0.5710238095238096	84
O08788	PF01302	28	92	18.118107692307696	64	G5AXG2	29	93	18.103107692307688	64
O08788	PF12455	526	804	5.966340501792116	278	G5AXG2	514	792	5.632716845878138	278
Q50H33	PF02214	45	141	7.491721649484536	96	G5APB6	46	142	7.596247422680416	96
Q63829	PF07258	121	191	3.688788732394366	70	G5BTK3	81	151	5.732943661971833	70
Q03404	PF00088	30	71	0.0	41	G5B2T7	31	72	0.0	41
Q03404	PF00088	80	120	0.4988048780487807	40	G5B2T7	90	130	0.018780487804878048	40
P27090	PF00019	315	412	6.577326530612246	97	G5ATT1	342	439	7.464091836734698	97
P27090	PF00688	21	252	0.5940646551724136	231	G5ATT1	22	279	0.5416589147286819	257
Q80VM3	PF13424	314	380	3.7726716417910446	66	G5C7D5	317	383	0.0	66
Q8R0J7	PF07200	46	154	0.7553761467889909	108	G5AWR8	1	109	0.7503944954128441	108
Q04211	PF07742	8	121	5.117657894736842	113	G5B365	9	123	5.2397043478260885	114
P56716	PF03607	52	109	0.062068965517241385	57	G5B618	54	111	1.6155	57
P56716	PF03607	177	229	8.332735849056602	52	G5B618	127	179	7.231584905660378	52
P48036	PF00191	25	81	6.024263157894738	56	G5BBS9	1	57	16.228754385964912	56
P48036	PF00191	88	153	6.634348484848485	65	G5BBS9	64	129	8.09068181818182	65
P48036	PF00191	172	237	14.919666666666668	65	G5BBS9	148	213	16.287	65
P48036	PF00191	248	312	3.6297538461538466	64	G5BBS9	224	288	3.8740461538461535	64
O70582	PF00305	254	680	6.214402810304447	426	G5B5F0	255	681	4.450552693208434	426
O70582	PF01477	3	108	1.90022641509434	105	G5B5F0	4	109	3.1322075471698123	105
Q8BZT9	PF02578	194	425	4.595698275862069	231	G5AV56	193	424	4.121487068965515	231
P97454	PF03165	31	131	0.00920792079207921	100	G5BX13	32	132	0.00920792079207921	100
P97454	PF03166	268	440	3.5824046242774545	172	G5BX13	269	441	3.5824046242774545	172
P47809	PF00069	101	364	7.3772348484848544	263	G5B2C1	32	295	7.918397727272729	263
Q5RJ54	PF00096	269	291	0.0	22	G5BSH0	232	254	0.0	22
Q5RJ54	PF00096	297	319	0.0	22	G5BSH0	260	282	0.0	22
Q5RJ54	PF00096	327	347	0.015428571428571429	20	G5BSH0	290	310	0.055476190476190484	20
Q5RJ54	PF00096	354	375	0.6118181818181818	21	G5BSH0	317	338	1.787727272727273	21
Q5RJ54	PF00096	381	403	0.16173913043478266	22	G5BSH0	344	366	0.16391304347826088	22
Q5RJ54	PF00096	409	431	0.0	22	G5BSH0	372	394	0.0	22
Q5RJ54	PF00096	437	459	0.0	22	G5BSH0	400	422	0.0	22
Q5RJ54	PF02023	38	124	0.3943333333333334	86	G5BSH0	14	100	3.2545517241379307	86
Q9Z2Z9	PF01380	362	489	9.2294609375	127	G5C7A5	749	872	9.598209677419351	123
Q9Z2Z9	PF01380	533	663	4.796259541984734	130	G5C7A5	916	1053	4.9811594202898535	137
Q9Z2Z9	PF13522	81	186	6.867245283018868	105	G5C7A5	445	550	6.8490283018867935	105
P25085	PF00340	60	173	3.762359649122805	113	G5B414	45	158	7.209991228070173	113
P52196	PF00581	15	135	1.3411404958677684	120	G5BAV6	1	121	1.3422892561983473	120
P52196	PF00581	165	278	2.981157894736842	113	G5BAV6	151	264	2.8882192982456143	113
Q9JJD0	PF05485	5	79	0.06026666666666669	74	G5C675	6	80	0.0604	74
Q9D902	PF02186	74	144	0.08669014084507046	70	G5B4I1	75	145	0.08690140845070428	70
Q9D902	PF18121	146	204	7.373728813559325	58	G5B4I1	147	205	7.381627118644068	58
P08030	PF00156	31	157	0.9085039370078748	126	G5C2T8	32	165	2.7216343283582094	133
Q6TDU8	PF15927	97	228	8.673901515151517	131	G5BEH7	6	134	9.564806201550391	128
P62196	PF00004	185	317	3.224526315789473	132	G5BDI9	325	457	3.196744360902255	132
P62196	PF16450	72	127	0.1826964285714286	55	G5BDI9	86	141	0.18291071428571432	55
P62196	PF17862	341	383	0.04218604651162791	42	G5BDI9	481	523	0.04727906976744186	42
Q9CQL5	PF00861	78	168	2.3519340659340657	90	G5BC64	78	168	1.8989890109890109	90
Q9Z1T5	PF01342	200	272	0.05465753424657534	72	G5C8H3	137	209	0.054726027397260284	72
Q9Z1T5	PF01753	504	540	0.0	36	G5C8H3	440	476	0.0	36
Q811S7	PF04516	52	254	0.3769950738916256	202	G5BIU4	53	255	0.5076059113300495	202
Q811S7	PF18016	362	421	0.02125	59	G5BIU4	363	422	0.02116666666666667	59
Q80WJ1	PF15685	1	305	0.008314754098360657	304	G5AMB6	2	306	0.012996721311475407	304
Q80WJ1	PF15685	305	671	0.1559673024523161	366	G5AMB6	296	628	0.12032432432432436	332
Q8BGW0	PF12736	16	264	1.6826265060240966	248	G5C4R8	17	264	0.7380927419354832	247
Q8BGW0	PF12736	287	499	0.1622018779342723	212	G5C4R8	287	500	1.199803738317757	213
Q8K157	PF01263	20	336	3.6719369085173454	316	G5CA71	21	337	3.192041009463721	316
Q60866	PF02126	14	346	0.9707267267267274	332	G5BFE9	15	347	1.03012012012012	332
Q8CH62	PF09811	21	59	0.19348717948717947	38	G5BSS0	22	60	5.498666666666668	38
P48381	PF02257	182	256	0.1726266666666667	74	G5C4T3	183	257	0.17242666666666664	74
P48381	PF04589	24	133	1.6683181818181816	109	G5C4T3	25	134	1.6820000000000006	109
Q99ME7	PF00907	42	215	3.255551724137931	173	G5AQ59	43	210	0.32754761904761903	167
Q61301	PF01044	99	331	1.7136609442060091	232	G5BWU7	1	233	1.7118884120171678	232
Q61301	PF01044	335	913	3.438367875647668	578	G5BWU7	237	815	3.4350155440414483	578
Q8R1B0	PF00130	112	138	0.030925925925925926	26	G5BRW4	192	220	0.005068965517241379	28
Q8R1B0	PF14604	295	343	2.1798571428571427	48	G5BRW4	150	198	1.4068163265306128	48
Q8R1B0	PF16664	166	291	0.28863492063492063	125	G5BRW4	21	146	0.9610793650793652	125
P47857	PF00365	17	322	5.538147058823529	305	G5BWB9	74	379	6.036509803921566	305
P47857	PF00365	402	685	2.4758098591549285	283	G5BWB9	459	742	3.1469859154929574	283
Q62210	PF00619	452	533	0.6558170731707317	81	G5BUB7	459	540	0.2915731707317074	81
Q62210	PF00653	48	113	1.5487121212121209	65	G5BUB7	49	114	1.918166666666666	65
Q62210	PF00653	179	242	1.189765625	63	G5BUB7	187	250	1.2982968749999997	63
Q62210	PF00653	264	328	3.873430769230769	64	G5BUB7	272	336	6.5076307692307696	64
Q62210	PF13920	560	603	9.89	43	G5BUB7	567	610	9.881863636363637	43
Q62203	PF12874	53	77	0.2116	24	G5BBC3	54	78	0.2142	24
Q62203	PF16835	111	195	2.9553882352941176	84	G5BBC3	112	196	1.4252117647058826	84
Q9CZS3	PF09398	48	112	10.404615384615386	64	G5AK11	49	113	11.03103076923077	64
P24610	PF00046	219	275	0.7722807017543861	56	G5AVN4	299	355	0.7833333333333333	56
P24610	PF00292	35	150	0.32440517241379313	115	G5AVN4	27	151	0.0	124
P24610	PF12360	346	390	0.0025555555555555557	44	G5AVN4	426	470	0.10535555555555556	44
Q3B7Z2	PF00169	118	176	1.4332881355932203	58	G5AP21	23	81	1.4582881355932205	58
Q3B7Z2	PF01237	415	790	3.0989281914893607	375	G5AP21	303	678	3.1053829787234024	375
Q921T2	PF05609	159	594	7.5207064220183515	435	G5AYL9	159	584	7.467750588235296	425
Q91WD5	PF00346	192	462	3.6235977859778603	270	G5BWI0	193	463	3.652351851851853	270
Q8C5L7	PF00076	190	221	1.62009375	31	G5AKC2	185	216	0.60796875	31
Q8C5L7	PF00076	292	361	8.675157142857143	69	G5AKC2	287	356	8.579357142857138	69
Q14B48	PF14723	826	909	0.01975	83	G5B2S1	445	528	0.0	83
O55176	PF13639	529	570	2.5454761904761902	41	G5AX00	599	640	2.5411428571428574	41
Q80W88	PF11569	452	500	0.29359183673469386	48	G5ASL2	517	565	0.5931836734693877	48
Q9CWX4	PF00849	104	275	4.91167441860465	171	G5AXW4	105	276	4.5408372093023255	171
P31230	PF01588	154	246	4.839430107526881	92	G5AQM8	190	282	4.740365591397849	92
O08759	PF00632	571	868	5.548567114093963	297	G5B0I7	575	872	5.312939597315436	297
O08759	PF16558	27	80	0.0	53	G5B0I7	27	80	0.0	53
Q9R000	PF04968	3	63	0.008163934426229508	60	G5BW25	4	64	0.0	60
Q9R000	PF04968	148	208	0.3186229508196721	60	G5BW25	148	208	3.128967213114755	60
Q9R000	PF04969	218	294	11.297545454545453	76	G5BW25	218	294	10.709701298701304	76
Q00547	PF15905	15	338	0.034675925925925936	323	G5B243	1	325	0.3942123076923076	324
Q00547	PF15908	650	788	0.004640287769784173	138	G5B243	553	693	0.012357142857142858	140
Q8CB87	PF00071	787	945	6.650371069182388	158	G5B540	486	644	7.799094339622643	158
P28738	PF00225	68	326	4.204513513513515	258	G5B7T4	194	452	4.140918918918913	258
Q80W00	PF00642	856	879	0.0	23	G5C3B6	828	851	0.0	23
Q80W00	PF08711	92	142	10.877196078431373	50	G5C3B6	93	143	8.43578431372549	50
A2A690	PF00023	1099	1129	0.7586774193548388	30	G5BDK2	1100	1130	0.7578709677419355	30
A2A690	PF12796	889	972	17.41396428571429	83	G5BDK2	890	973	17.41808333333334	83
A2A690	PF12796	995	1096	1.854676470588236	101	G5BDK2	996	1097	1.7825294117647064	101
A2A690	PF12796	1136	1224	9.445247191011237	88	G5BDK2	1137	1225	9.298651685393258	88
A2A690	PF13181	1292	1322	1.0085806451612902	30	G5BDK2	1303	1333	0.7166451612903226	30
A2A690	PF13181	1324	1357	0.4102941176470589	33	G5BDK2	1335	1368	0.4334117647058823	33
Q6ZWY8	PF01290	2	39	0.0	37	G5BRQ3	3	40	0.0	37
P97470	PF00149	47	238	4.8640989583333365	191	G5BXS1	48	239	4.6970156250000015	191
Q9DBG9	PF00595	19	108	2.727933333333333	89	G5B935	20	109	2.755411111111111	89
Q9CRD0	PF07051	24	108	11.311988235294118	84	G5B8D0	25	109	10.275129411764707	84
P51450	PF00104	319	483	12.644030303030302	164	G5B8K8	300	464	13.146278787878794	164
P51450	PF00105	29	97	0.1489420289855072	68	G5B8K8	7	75	0.14830434782608698	68
Q8CFJ9	PF00400	197	235	0.06548717948717947	38	G5BXV7	198	236	0.06912820512820514	38
Q5SX19	PF02585	45	165	4.790347107438016	120	G5BEV2	1	121	8.500404958677688	120
Q9QZK2	PF00017	147	227	1.0855308641975308	80	G5B697	28	108	1.0803950617283955	80
Q9QZK2	PF00617	589	688	9.18538	99	G5B697	469	568	5.3718699999999995	99
P62908	PF00189	105	187	0.3138915662650603	82	G5AS76	106	188	0.3138915662650603	82
P62908	PF07650	19	92	8.389716216216215	73	G5AS76	20	93	8.389716216216215	73
Q9D695	PF00079	6	379	9.537243315508015	373	G5BH06	7	415	9.273414215686273	408
Q9EQG9	PF01852	413	617	5.6793512195121965	204	G5AVZ8	298	502	5.693068292682929	204
P24452	PF00626	30	106	4.074831168831169	76	G5BRR0	31	107	4.062545454545454	76
P24452	PF00626	148	221	5.907851351351352	73	G5BRR0	148	221	5.551094594594592	73
P24452	PF00626	272	343	3.2132083333333337	71	G5BRR0	270	341	0.2236111111111112	71
Q8R4I4	PF03153	121	444	0.18898765432098769	323	G5APM3	1	328	0.44256574923547415	327
P23578	PF00089	42	264	6.383174887892374	222	G5B2F4	35	231	6.239817258883248	196
O08672	PF00225	434	731	5.294409395973153	297	G5C5S1	334	657	4.133172839506172	323
Q9WVQ5	PF00596	26	219	2.6429742268041245	193	G5AXU8	28	221	2.6453350515463923	193
Q8CDR2	PF04712	191	681	2.408989816700612	490	G5AUY1	206	698	1.8095983772819475	492
Q9QXT0	PF11938	26	170	0.0	144	G5BB77	27	171	0.0	144
Q8BXC6	PF07258	120	189	0.046542857142857136	69	G5BH54	121	190	0.046471428571428566	69
P27792	PF00010	149	200	3.0623846153846155	51	G5BYV6	150	201	3.627192307692309	51
Q8K3V1	PF06294	53	148	2.8982916666666667	95	G5BY00	54	149	4.288583333333333	95
Q70UZ7	PF00008	297	322	0.0	25	G5BKA7	282	307	0.0	25
Q70UZ7	PF00008	714	744	0.029516129032258063	30	G5BKA7	699	729	0.19903225806451613	30
Q70UZ7	PF00092	50	210	10.336409937888195	160	G5BKA7	34	195	10.882771604938274	161
Q70UZ7	PF00092	341	504	8.447798780487808	163	G5BKA7	326	489	11.696317073170734	163
Q70UZ7	PF00092	529	681	13.830941176470592	152	G5BKA7	514	665	13.944717105263159	151
Q9WVM8	PF00155	70	416	3.032247838616713	346	G5BC26	71	417	3.0406023054755056	346
Q8R3Y8	PF00097	502	546	0.0	44	G5AUY4	346	390	0.0	44
Q80YR3	PF02437	11	94	2.8803928571428576	83	G5BTK0	12	95	2.878845238095237	83
Q80YR3	PF15223	383	819	0.12264530892448505	436	G5BTK0	216	645	0.1500697674418604	429
Q6ZQB6	PF00328	384	899	3.4858507751937995	515	G5B9C6	379	894	2.9741647286821697	515
Q6ZQB6	PF18086	49	138	10.914777777777774	89	G5B9C6	44	133	10.396822222222227	89
Q9D8X1	PF03932	25	224	5.142755000000002	199	G5AYP0	27	226	4.027894999999998	199
O88895	PF00850	21	311	2.7494501718213065	290	G5AQQ9	22	312	2.7024020618556723	290
Q8CGV2	PF00351	149	479	3.8340966767371616	330	G5BSX5	183	513	3.8036918429003	330
Q3USZ2	PF00505	100	168	0.05043478260869565	68	G5BHD6	100	168	0.10340579710144926	68
Q5ND29	PF09744	26	168	1.0520069930069929	142	G5BCV4	28	193	1.0982228915662653	165
Q5ND29	PF11461	223	280	2.0177413793103454	57	G5BCV4	250	328	0.3888354430379748	78
Q61199	PF06312	63	258	6.4389540816326525	195	G5C8L8	91	289	6.355698492462312	198
Q8CDN9	PF13855	1239	1295	1.0844210526315792	56	G5C5H2	1130	1186	0.95740350877193	56
Q8CDN9	PF14580	136	238	0.01679611650485437	102	G5C5H2	17	119	0.015970873786407762	102
Q8CDN9	PF14580	961	1072	10.52875	111	G5C5H2	852	963	9.424125000000004	111
P41241	PF00017	81	155	2.628893333333334	74	G5AL62	82	156	2.627226666666667	74
P41241	PF00018	14	61	14.5936875	47	G5AL62	15	62	14.5936875	47
P41241	PF07714	194	439	6.1874227642276445	245	G5AL62	195	440	6.1758699186991874	245
Q80WT2	PF03474	254	289	0.8628333333333331	35	G5BXE8	128	163	0.8789722222222225	35
Q80UN1	PF00805	287	325	0.0	38	G5BYA7	323	361	0.0	38
Q80UN1	PF02214	90	180	0.9725824175824178	90	G5BYA7	76	166	0.946087912087912	90
Q80UN1	PF11834	15	63	13.413653061224489	48	G5BYA7	1	49	13.69483673469388	48
Q8R4A3	PF15268	108	204	0.017164948453608244	96	G5ALN9	109	205	0.0	96
Q8R4A3	PF15268	204	777	1.775827526132404	573	G5ALN9	205	785	1.6074965517241384	580
Q9EP82	PF00400	187	217	0.403	30	G5B2V3	187	217	0.3939354838709677	30
P51943	PF00134	170	295	7.853325396825394	125	G5BBT1	182	307	8.043928571428571	125
P51943	PF02984	298	415	6.7857542372881365	117	G5BBT1	310	427	10.224076271186444	117
P51943	PF16500	21	156	0.08745588235294117	135	G5BBT1	28	167	0.4232499999999999	139
Q6DFV3	PF00169	926	1030	2.1208285714285715	104	G5AVY4	999	1103	2.7494380952380943	104
Q6DFV3	PF00620	1154	1304	2.738298013245033	150	G5AVY4	1112	1232	3.3938925619834706	120
Q6DFV3	PF17820	107	158	8.399519230769231	51	G5AVY4	144	195	8.41375	51
P38647	PF00012	69	651	2.163857632933103	582	G5BA48	1	547	2.1840548446069454	546
Q8BX13	PF09814	12	316	6.016816393442624	304	G5BZN8	10	313	7.0684276315789445	303
Q8K3B1	PF00622	153	277	12.532895999999996	124	G5ALC3	122	246	13.331240000000005	124
Q8K3B1	PF12937	40	83	4.240068181818182	43	G5ALC3	9	52	4.707909090909092	43
Q9CR11	PF03366	43	121	15.270012658227847	78	G5ASK7	44	122	15.270012658227847	78
Q3US16	PF07500	180	289	1.2421363636363634	109	G5B7H6	174	283	3.721372727272727	109
Q3US16	PF08711	29	75	0.5953191489361701	46	G5B7H6	30	76	2.25527659574468	46
O35902	PF00028	63	147	17.63474117647059	84	G5C309	64	156	17.479258064516124	92
O35902	PF00028	162	256	5.447884210526315	94	G5C309	171	265	4.725715789473685	94
O35902	PF00028	271	373	7.843805825242712	102	G5C309	280	382	11.40350485436893	102
O35902	PF00028	400	484	4.824505882352941	84	G5C309	409	493	10.303552941176466	84
Q9JIC3	PF07522	900	1004	0.2786666666666666	104	G5BKD9	914	1018	0.34585714285714275	104
Q9CYP7	PF04636	39	489	3.4226031042128615	450	G5BTZ7	16	466	3.852889135254988	450
Q8BPM0	PF02181	600	981	7.271157068062823	381	G5B7E9	600	982	7.118015665796344	382
Q8BPM0	PF06367	234	437	6.84302450980392	203	G5B7E9	235	438	6.8774901960784325	203
Q8BPM0	PF06371	46	231	1.788672043010753	185	G5B7E9	47	232	1.7942634408602154	185
P60324	PF05741	56	108	0.0	52	G5BYU6	61	113	0.0	52
Q6P8K8	PF00246	128	405	1.3006115107913674	277	G5BH76	130	407	1.0719784172661873	277
Q6P8K8	PF02244	26	100	0.011200000000000002	74	G5BH76	27	101	0.013133333333333332	74
Q9CWY4	PF11095	55	126	2.283708333333334	71	G5CBL8	58	129	2.4864305555555553	71
Q9CWY4	PF12901	9	26	0.0	17	G5CBL8	8	25	0.0	17
Q62421	PF00018	292	334	0.8833255813953488	42	G5BF00	258	300	0.8850697674418605	42
Q62421	PF03114	35	240	2.0272330097087377	205	G5BF00	1	206	2.02728640776699	205
Q3TXU5	PF01916	44	353	3.485132258064518	309	G5BYX8	45	354	3.544390322580648	309
Q9D5D8	PF00378	266	494	6.091882096069868	228	G5B1Y0	281	509	6.10376419213974	228
Q9D5D8	PF00385	7	55	0.0	48	G5B1Y0	15	63	0.0	48
P09024	PF00046	137	193	0.04324561403508772	56	G5C4M5	131	187	0.07833333333333332	56
Q6Y4S4	PF15152	46	73	0.022607142857142857	27	G5BMM0	46	71	0.0	25
Q8VCR2	PF00106	36	227	7.5827812499999965	191	G5BSV1	37	229	5.071041450777202	192
Q8BTU7	PF00415	179	227	3.1327142857142856	48	G5CAB2	175	223	0.0726530612244898	48
Q8BTU7	PF00415	231	315	1.7184470588235286	84	G5CAB2	227	309	1.8086987951807236	82
Q8BTU7	PF00415	319	366	2.1257916666666667	47	G5CAB2	313	360	3.5154791666666667	47
Q8QZV6	PF10595	124	282	0.04530188679245283	158	G5C1Y6	233	391	1.289188679245283	158
Q91WA6	PF16764	17	125	7.5640917431192625	108	G5C5T8	2	110	1.0539541284403668	108
Q8BHC1	PF00071	9	171	7.037779141104298	162	G5BD25	10	172	6.601846625766876	162
Q9DBZ5	PF10075	61	199	3.936705035971224	138	G5AMB1	62	195	3.800970149253732	133
O70589	PF02828	346	394	0.09510204081632652	48	G5B9J6	70	118	0.07624489795918367	48
O70589	PF02828	405	455	2.051196078431373	50	G5B9J6	129	179	2.0535686274509803	50
O70589	PF00018	637	673	7.415864864864866	36	G5B9J6	361	397	7.419675675675673	36
O70589	PF00595	490	566	0.05349350649350649	76	G5B9J6	214	290	0.05355844155844157	76
O70589	PF00625	737	910	6.3264770114942515	173	G5B9J6	461	634	6.328827586206895	173
F8VPZ9	PF15249	1101	1200	0.21093000000000006	99	G5AV17	879	978	0.21216	99
Q61371	PF12895	464	542	0.27831645569620256	78	G5BKV6	526	604	0.3332784810126581	78
Q61371	PF13174	656	685	0.3672666666666667	29	G5BKV6	718	747	0.3339333333333333	29
Q61371	PF13181	551	580	2.3927666666666667	29	G5BKV6	613	642	5.061833333333333	29
Q61371	PF13424	234	301	2.3673970588235296	67	G5BKV6	296	363	2.4549411764705886	67
Q05D44	PF00009	628	838	9.99331279620853	210	G5BMS4	652	862	9.182023696682466	210
Q05D44	PF03144	865	941	2.665883116883115	76	G5BMS4	889	965	3.5519220779220766	76
Q05D44	PF11987	963	1064	7.70720588235294	101	G5BMS4	987	1088	7.7273823529411745	101
Q8BXX2	PF00096	385	407	0.0	22	G5B309	391	413	0.0	22
Q8BXX2	PF00096	413	435	0.0	22	G5B309	419	441	0.0	22
Q8BXX2	PF00096	441	463	0.0	22	G5B309	447	469	0.0	22
Q8BXX2	PF00096	525	547	0.0	22	G5B309	531	553	0.0	22
Q8BXX2	PF00096	553	575	0.0	22	G5B309	559	581	0.0	22
Q8BXX2	PF00651	16	118	2.8252621359223284	102	G5B309	17	119	2.8246699029126234	102
Q8BXX2	PF13912	469	491	0.0	22	G5B309	475	497	0.0	22
Q8BXX2	PF13912	496	519	0.0	23	G5B309	502	525	0.0	23
P11679	PF00038	95	406	0.3046378205128205	311	G5BJ39	92	403	0.3026410256410257	311
P11679	PF16208	2	92	2.3437912087912083	90	G5BJ39	3	89	0.2768620689655173	86
Q9Z1K6	PF01485	206	268	0.04114285714285714	62	G5BZU6	207	269	0.04114285714285714	62
Q9Z1K6	PF01485	290	331	0.7206666666666666	41	G5BZU6	291	332	0.7203571428571428	41
O08528	PF00349	21	218	3.4097979797979803	197	G5AXE1	22	219	5.199363636363636	197
O08528	PF00349	470	666	3.233852791878173	196	G5AXE1	471	667	3.165274111675126	196
O08528	PF03727	224	458	4.423693617021278	234	G5AXE1	225	459	3.630855319148936	234
O08528	PF03727	672	906	6.102034042553187	234	G5AXE1	673	907	6.204144680851061	234
Q5S006	PF00069	1884	2128	5.968934693877549	244	G5BHG2	1879	2119	7.136970954356851	240
Q5S006	PF08477	1335	1454	9.401499999999997	119	G5BHG2	1330	1449	9.325083333333332	119
Q5S006	PF12799	1245	1283	0.0	38	G5BHG2	1240	1278	0.0	38
Q5S006	PF13855	1011	1069	0.05898305084745763	58	G5BHG2	1006	1064	0.0	58
Q5S006	PF13855	1173	1231	0.0	58	G5BHG2	1168	1226	1.9029491525423727	58
Q5S006	PF16095	1543	1739	0.6505279187817261	196	G5BHG2	1538	1734	0.4396091370558376	196
Q00780	PF00386	616	740	10.403432000000006	124	G5BG25	547	671	10.401784000000003	124
Q00780	PF01391	158	206	0.0	48	G5BG25	129	177	0.0	48
Q00780	PF01391	468	495	0.0	27	G5BG25	439	465	0.0	26
Q00780	PF01391	519	564	0.0	45	G5BG25	115	156	0.0	41
Q8CHP5	PF09282	13	37	0.0	24	G5BB98	34	58	0.0	24
Q99LJ6	PF00255	23	130	3.9432777777777765	107	G5AUI7	24	131	4.235972222222223	107
Q8R184	PF14160	184	287	1.0993461538461538	103	G5C6M9	184	287	1.1428076923076924	103
Q8R184	PF14161	4	94	0.0	90	G5C6M9	5	94	0.0	89
P61022	PF13499	112	178	5.762328358208956	66	G5BM10	113	179	6.389238805970148	66
P26323	PF00178	281	359	1.4822405063291135	78	G5BRN6	204	282	1.3991772151898738	78
P26323	PF02198	114	196	0.07409638554216869	82	G5BRN6	59	141	0.08127710843373495	82
Q9Z2H7	PF00595	117	179	1.1124444444444443	62	G5AXK4	73	134	0.16969354838709674	61
Q8BQM8	PF00400	53	90	10.996157894736841	37	G5BRE1	11	48	11.023657894736843	37
Q8BQM8	PF00400	315	352	7.997421052631579	37	G5BRE1	273	310	5.227473684210526	37
Q8BQM8	PF00400	554	591	6.704157894736843	37	G5BRE1	512	549	7.375947368421049	37
Q8BQM8	PF00400	717	756	2.212225	39	G5BRE1	675	714	2.215699999999999	39
Q8BQM8	PF00400	761	801	6.185731707317072	40	G5BRE1	719	759	6.3697073170731695	40
Q8BQM8	PF00400	993	1025	0.35939393939393943	32	G5BRE1	951	983	0.269060606060606	32
Q8BQM8	PF00400	1697	1729	1.7150303030303038	32	G5BRE1	1584	1616	1.7304545454545457	32
Q8BQM8	PF00400	1937	1966	4.4346	29	G5BRE1	1810	1838	0.02844827586206897	28
Q8BQM8	PF03451	5	46	31.427857142857142	41	G5BRE1	629	670	28.200523809523805	41
Q8BQM8	PF03451	661	713	22.346264150943398	52	G5BRE1	619	671	22.347584905660376	52
Q8BQM8	PF03451	1352	1409	0.488206896551724	57	G5BRE1	1297	1354	3.4771551724137937	57
Q8BQM8	PF12894	380	459	1.817675	79	G5BRE1	338	417	1.7337875	79
Q8BQM8	PF12894	1748	1827	9.073375000000002	79	G5BRE1	1635	1714	8.327424999999996	79
Q9DAX9	PF13374	474	507	0.11258823529411764	33	G5AX23	475	508	0.10617647058823527	33
Q9DAX9	PF13424	399	460	0.0	61	G5AX23	400	461	0.0	61
Q9JHG6	PF04847	73	243	2.549538011695907	170	G5AM17	50	219	2.9161764705882347	169
Q9D485	PF06565	70	173	11.772798076923074	103	G5BK98	59	196	5.852166666666664	137
Q9D485	PF06565	219	307	12.868898876404495	88	G5BK98	57	145	7.942505617977525	88
Q9D485	PF06565	317	359	0.6512325581395348	42	G5BK98	154	196	2.2841162790697678	42
Q9D485	PF06565	418	528	12.719378378378384	110	G5BK98	252	362	14.581396396396404	110
Q810M1	PF14713	111	231	5.218438016528926	120	G5AME6	1	121	4.653867768595043	120
Q9CPW7	PF12171	79	104	0.06000000000000001	25	G5AR51	126	151	0.05884615384615385	25
Q8CCF0	PF01798	99	315	5.257557603686637	216	G5CBF5	225	440	5.363953703703704	215
Q8CCF0	PF09785	406	464	0.034474576271186434	58	G5CBF5	496	554	0.0339322033898305	58
O70237	PF00096	162	185	0.0	23	G5AT37	156	179	0.0	23
O70237	PF00096	191	213	0.0	22	G5AT37	185	207	0.0	22
O70237	PF00096	219	241	0.0	22	G5AT37	213	235	0.0	22
O70237	PF00096	275	297	0.0	22	G5AT37	269	291	0.0	22
O70237	PF00096	303	326	0.0	23	G5AT37	297	320	0.0	23
P62325	PF07742	49	123	1.9372266666666669	74	G5BSJ8	46	120	2.2404399999999995	74
Q8BGS2	PF01722	11	78	1.8812352941176476	67	G5BRC4	12	79	1.8659852941176471	67
P70701	PF00110	63	269	4.2888502415458944	206	G5AKL3	64	269	4.3103155339805825	205
Q5M8N0	PF15043	5	162	3.095360759493672	157	G5BA18	6	165	1.19040625	159
O70281	PF13469	69	261	5.912378238341971	192	G5BIR8	70	262	5.571849740932641	192
Q9JK54	PF00010	118	171	0.025666666666666664	53	G5AZB2	125	178	0.025166666666666667	53
Q9ER35	PF03881	50	307	2.0288410852713183	257	G5BJB3	1	309	4.359932038834951	308
Q9Z103	PF00046	767	808	4.2983809523809535	41	G5AYZ8	769	810	4.2904285714285715	41
Q3USJ8	PF00018	475	520	0.3563043478260869	45	G5ASA9	446	491	0.2835652173913044	45
Q3USJ8	PF00611	54	101	0.0	47	G5ASA9	1	48	0.0	47
Q3USJ8	PF14604	573	624	0.14442307692307693	51	G5ASA9	544	595	0.1140576923076923	51
O35226	PF02809	211	226	2.826875	15	G5AJZ8	236	251	3.1065625000000003	15
O35226	PF02809	281	295	0.349	14	G5AJZ8	320	334	0.3476666666666667	14
O35226	PF13519	9	112	5.818913461538463	103	G5AJZ8	34	137	5.884423076923077	103
Q8BPY9	PF00004	445	575	7.8840992366412195	130	G5B3T9	439	569	7.7877022900763375	130
Q8BPY9	PF09336	645	679	0.11842857142857145	34	G5B3T9	639	673	0.124	34
Q925E1	PF00595	73	135	10.999365079365079	62	G5BKS4	139	201	11.691603174603172	62
Q9JIL4	PF00595	10	86	7.870532467532468	76	G5BBL9	11	87	8.690623376623375	76
Q9JIL4	PF00595	140	207	2.9201323529411765	67	G5BBL9	139	206	4.244	67
Q9JIL4	PF00595	245	318	9.599729729729725	73	G5BBL9	244	317	7.230689189189187	73
Q9JIL4	PF00595	384	453	3.2531571428571437	69	G5BBL9	381	450	4.105328571428572	69
P97801	PF06003	22	284	3.492441064638784	262	G5C0H9	28	295	2.539011194029849	267
Q8CDC7	PF00651	37	139	2.9091941747572814	102	G5BK23	38	140	2.3516796116504857	102
Q6PFY1	PF00018	473	517	2.5218888888888893	44	G5AQR1	474	518	1.9263111111111115	44
Q6PFY1	PF00611	20	98	0.14901265822784807	78	G5AQR1	14	99	3.0514534883720934	85
Q6PFY1	PF14604	550	601	0.05517307692307693	51	G5AQR1	551	602	0.0479423076923077	51
Q6PR54	PF12231	24	360	6.017673590504449	336	G5B602	89	425	4.672560830860533	336
P54797	PF05742	0	256	4.514700389105056	256	G5CA25	1	257	3.863785992217896	256
Q920M5	PF00400	77	108	2.62125	31	G5BVP4	78	109	2.5704375	31
Q920M5	PF00400	121	159	13.743102564102564	38	G5BVP4	122	160	14.704256410256413	38
Q920M5	PF00400	173	202	0.3679333333333333	29	G5BVP4	174	203	0.3668	29
Q920M5	PF08953	3	68	10.442257575757576	65	G5BVP4	4	69	10.36427272727273	65
Q920M5	PF16300	343	385	0.20244186046511628	42	G5BVP4	344	386	0.8560930232558139	42
Q61160	PF00531	100	178	0.27318987341772155	78	G5BSS5	101	179	0.3948607594936708	78
Q61160	PF01335	18	82	6.6359538461538445	64	G5BSS5	19	83	3.4119230769230757	64
Q80UG5	PF00735	292	568	1.1714368231046928	276	G5AQT3	268	544	1.1754729241877253	276
Q9JJN2	PF00046	2069	2125	0.036771929824561414	56	G5BUW1	997	1053	0.03691228070175438	56
Q9JJN2	PF00046	2166	2222	10.404701754385963	56	G5BUW1	1094	1150	10.404912280701755	56
Q9JJN2	PF00046	2542	2598	4.063631578947368	56	G5BUW1	1471	1527	4.067842105263157	56
Q9JJN2	PF00046	2865	2921	3.900684210526316	56	G5BUW1	1795	1851	3.920754385964912	56
Q9JJN2	PF00096	696	720	0.0	24	G5BUW1	488	512	0.09264	24
Q9JJN2	PF00096	1563	1587	0.0	24	G5BUW1	488	512	0.09264	24
Q9D711	PF02678	21	117	0.4660927835051547	96	G5C236	22	118	0.5326082474226805	96
Q9D711	PF05726	170	276	8.81004672897196	106	G5C236	171	277	8.414476635514019	106
Q8R3W5	PF09631	61	160	13.280129999999994	99	G5BGP6	62	161	13.227600000000002	99
Q8R0L9	PF10198	309	415	0.0	106	G5BX87	310	416	0.0	106
Q99JB2	PF01145	40	208	0.8946508875739643	168	G5BXC2	41	209	0.7282011834319527	168
Q99JB2	PF16200	259	319	1.245475409836066	60	G5BXC2	260	320	2.934393442622952	60
Q9WVR4	PF00013	230	288	0.09076271186440678	58	G5B5D2	166	206	0.10829268292682928	40
Q9WVR4	PF00013	294	361	6.778897058823531	67	G5B5D2	212	279	6.315514705882354	67
Q9WVR4	PF05641	71	125	0.1036545454545455	54	G5B5D2	46	100	1.7127272727272724	54
Q9WVR4	PF12235	363	482	0.0	119	G5B5D2	281	395	0.0	114
Q9WVR4	PF16096	503	577	0.13350666666666666	74	G5B5D2	418	490	0.13716438356164384	72
Q9WVR4	PF17904	132	185	6.059333333333334	53	G5B5D2	107	159	12.296698113207546	52
Q9WVR4	PF18336	43	61	0.0	18	G5B5D2	18	36	0.0	18
Q3UQ84	PF00587	404	605	3.0333960396039603	201	G5BH39	397	598	7.4785099009900975	201
Q3UQ84	PF02824	65	125	0.4147704918032787	60	G5BH39	68	128	0.0	60
Q3UQ84	PF03129	619	709	3.895472527472528	90	G5BH39	612	702	3.0631428571428563	90
Q3UQ84	PF07973	233	265	0.09769696969696967	32	G5BH39	236	268	0.13284848484848488	32
P97863	PF00859	208	497	0.17213448275862064	289	G5AP55	38	325	0.06748611111111111	287
O88890	PF00017	6	84	14.512506329113922	78	G5BCS2	7	85	14.190481012658225	78
P13405	PF01857	638	757	16.491883333333334	119	G5BFH6	601	720	15.87949166666666	119
P13405	PF01858	366	566	7.2130845771144285	200	G5BFH6	328	528	7.085388059701492	200
P13405	PF08934	760	917	2.169924050632911	157	G5BFH6	723	880	2.163164556962025	157
P13405	PF11934	109	219	23.01933333333333	110	G5BFH6	71	181	24.36472072072073	110
Q9D945	PF10169	2	118	5.041094017094017	116	G5AMC9	3	113	2.7347837837837843	110
Q6RFH4	PF15666	67	154	1.9405	87	G5B1D9	35	127	4.469784946236558	92
Q505B7	PF01951	30	167	4.485934782608696	137	G5B5J5	43	179	4.525595588235294	136
P60853	PF06818	377	566	0.1213157894736842	189	G5AUC7	382	575	0.07547938144329898	193
Q8R123	PF00994	18	173	3.231519230769228	155	G5BDE2	74	229	3.3947564102564103	155
Q8R123	PF01507	303	458	1.7547435897435897	155	G5BDE2	359	508	2.99128	149
Q04997	PF00019	262	364	0.6949320388349514	102	G5AKI6	263	366	0.6485673076923075	103
Q80V85	PF00622	350	456	15.861485981308418	106	G5B5K7	290	396	15.825149532710276	106
Q80V85	PF13765	296	345	1.11556	49	G5B5K7	236	285	1.1211400000000002	49
Q9D4B2	PF13181	439	464	2.335961538461538	25	G5B0L3	441	466	1.5569999999999995	25
P46684	PF00096	301	325	0.0	24	G5AQB4	259	283	0.0	24
P46684	PF00096	331	355	0.0	24	G5AQB4	289	313	0.0	24
P46684	PF00096	361	383	0.0	22	G5AQB4	319	341	0.0	22
P46684	PF18366	217	263	0.20821276595744687	46	G5AQB4	175	221	0.2076170212765958	46
Q3TTJ4	PF15379	174	276	2.672495145631068	102	G5ANI8	146	248	0.03185436893203883	102
Q61660	PF00250	120	203	3.887809523809524	83	G5AQV5	121	204	3.892083333333333	83
Q08369	PF00320	215	247	0.0	32	G5AMF6	185	217	0.0	32
Q08369	PF00320	269	302	0.0	33	G5AMF6	239	272	0.0	33
Q9R1Q8	PF00307	25	134	1.3731181818181817	109	G5B1E2	26	135	1.4395999999999998	109
Q9R1Q8	PF00402	173	197	0.1008	24	G5B1E2	174	198	0.07612000000000001	24
Q8CBQ5	PF00454	128	414	5.7682160278745656	286	G5B023	156	442	4.704142857142858	286
O08686	PF00046	137	193	0.0	56	G5BRN2	99	155	0.0	56
Q7TN22	PF00085	394	493	9.255579999999997	99	G5BLP2	391	490	11.848310000000005	99
Q7TN22	PF13848	533	721	8.878534391534387	188	G5BLP2	530	718	13.27443386243386	188
Q3UHK8	PF10427	1059	1185	0.0	126	G5B947	1015	1141	0.0	126
Q3UHK8	PF16608	1492	1625	0.06416417910447761	133	G5B947	1405	1537	0.023090225563909782	132
Q64285	PF00135	25	541	5.492001934235972	516	G5ANW7	26	565	6.578229629629626	539
P19221	PF00089	360	609	2.5421560000000007	249	G5ATC4	339	626	1.5777291666666655	287
P19221	PF09396	312	359	0.0	47	G5ATC4	309	338	0.01933333333333333	29
P19221	PF00051	108	186	0.2589240506329113	78	G5ATC4	109	187	0.016202531645569618	78
P19221	PF00051	214	292	2.459924050632912	78	G5ATC4	214	292	2.5321139240506327	78
P19221	PF00594	48	88	0.8829512195121954	40	G5ATC4	49	89	0.2459024390243903	40
O88573	PF05110	7	506	0.299618	499	G5C957	123	634	0.871162109375	511
O88573	PF18875	765	779	30.905733333333334	14	G5C957	813	827	13.271333333333335	14
O88573	PF18876	953	1212	7.702842307692308	259	G5C957	1004	1259	4.434132812499999	255
Q6A037	PF11977	614	766	6.272692810457516	152	G5BT81	603	755	6.278150326797388	152
Q3U3W5	PF06325	174	232	0.5257627118644067	58	G5BQF6	170	228	0.5260508474576271	58
Q8CEC5	PF00071	5	167	11.420429447852767	162	G5BFP8	6	168	11.038067484662577	162
Q8R2K1	PF05025	4	146	6.758167832167832	142	G5AVA7	5	157	5.071359477124185	152
Q9CQ75	PF05047	32	82	0.1174705882352941	50	G5AR57	23	73	0.0	50
Q9JM58	PF00041	238	314	6.141545454545455	76	G5C5A8	250	326	6.143363636363636	76
Q9JM58	PF09067	135	229	0.011000000000000001	94	G5C5A8	147	241	0.011000000000000001	94
A2A5E6	PF12874	77	100	0.06341666666666666	23	G5B0K9	161	184	0.04079166666666666	23
A2A5E6	PF12874	227	251	0.0	24	G5B0K9	303	327	0.0	24
A2A5E6	PF12874	296	320	0.0	24	G5B0K9	372	396	0.0	24
Q99PL6	PF00789	333	405	1.4438082191780817	72	G5BZA1	306	378	1.3209041095890413	72
Q99PL6	PF09409	168	252	0.0904470588235294	84	G5BZA1	141	225	0.3663647058823529	84
Q8K019	PF15440	156	747	1.0363125	591	G5C1A7	157	747	0.6916362098138747	590
Q8BVI4	PF00106	32	190	2.651547169811321	158	G5APR4	1	159	1.4276666666666662	158
Q61206	PF13472	43	202	7.080731250000001	159	G5BH11	44	203	6.422987500000002	159
O08641	PF00018	286	333	6.9867500000000025	47	G5C0X6	313	360	1.3571458333333335	47
O08641	PF04366	91	208	7.8941016949152525	117	G5C0X6	118	235	7.875686440677966	117
Q8CC86	PF17767	15	142	7.3787734375	127	G5AWF4	16	143	7.7097812500000025	127
Q8CC86	PF17956	420	520	0.0	100	G5AWF4	421	520	0.4814799999999999	99
O70460	PF00048	30	89	7.576449999999999	59	G5B066	31	90	7.711333333333332	59
Q6ZPV2	PF00176	531	822	4.421530821917806	291	G5BM08	532	823	4.482551369863012	291
Q6ZPV2	PF00271	1108	1216	8.062660550458713	108	G5BM08	1106	1214	8.025532110091744	108
Q6ZPV2	PF13892	275	404	1.849176923076924	129	G5BM08	276	405	1.847315384615385	129
Q99L47	PF17830	326	362	2.8512432432432435	36	G5AYW9	264	300	2.8622702702702703	36
Q99L47	PF18253	1	42	0.042571428571428566	41	G5AYW9	2	43	0.043428571428571434	41
Q9CX53	PF06372	0	165	7.772174698795179	165	G5CA69	1	167	7.454251497005987	166
Q3UWZ0	PF00622	346	452	2.210130841121496	106	G5BD36	349	453	2.4454380952380954	104
Q3UWZ0	PF00643	94	128	1.3224571428571432	34	G5BD36	97	130	0.06235294117647059	33
Q3UWZ0	PF13765	295	341	0.2722765957446808	46	G5BD36	297	343	1.0125744680851063	46
Q3UWZ0	PF15227	15	55	0.0	40	G5BD36	16	56	0.04058536585365854	40
E9Q4P1	PF00400	19	50	2.92284375	31	G5AYC9	172	203	0.5925312500000001	31
E9Q4P1	PF00400	191	226	12.84080555555556	35	G5AYC9	126	161	12.734777777777774	35
E9Q4P1	PF00400	237	269	0.5746969696969698	32	G5AYC9	172	204	0.5937878787878789	32
E9Q4P1	PF00400	375	393	1.0388421052631578	18	G5AYC9	310	328	1.114210526315789	18
E9Q4P1	PF01363	282	351	0.6604285714285716	69	G5AYC9	217	286	0.6590571428571427	69
Q99KB8	PF00753	62	221	3.945012499999996	159	G5BY63	14	173	3.25749375	159
Q99KB8	PF16123	222	303	0.0	81	G5BY63	174	255	0.0	81
Q9EQN3	PF01166	317	370	5.041333333333334	53	G5BW16	323	376	5.048925925925926	53
P60897	PF05160	5	59	0.0	54	G5BLD0	6	59	0.0065740740740740725	53
Q3U4B4	PF00561	80	380	6.077139534883718	300	G5BT03	79	379	6.342139534883722	300
P97868	PF04564	253	325	2.4983287671232874	72	G5B948	238	310	2.5081369863013685	72
P97868	PF08783	3	75	0.009246575342465755	72	G5B948	4	76	0.009246575342465755	72
P97868	PF13696	156	176	0.0	20	G5B948	141	161	0.0	20
Q8K4P8	PF00168	209	313	0.08397142857142857	104	G5AV45	201	305	0.05591428571428572	104
Q8K4P8	PF00397	827	856	0.026	29	G5AV45	819	848	0.026	29
Q8K4P8	PF00632	1299	1603	4.7295377049180285	304	G5AV45	1290	1594	4.09497682119205	304
Q8K4P8	PF16562	64	182	2.472453781512605	118	G5AV45	56	174	1.4996722689075637	118
Q8K4P8	PF18436	946	1011	10.843106060606058	65	G5AV45	937	1002	9.955757575757577	65
Q8BFY6	PF13405	176	202	0.0	26	G5BUA3	170	196	0.0	26
Q8BFY6	PF13499	110	169	2.275383333333333	59	G5BUA3	104	163	7.5955	59
Q60591	PF00554	411	571	1.1307515527950311	160	G5AYZ4	411	571	1.1327577639751552	160
Q60591	PF16179	581	678	3.2837551020408164	97	G5AYZ4	581	678	3.2806836734693885	97
Q62227	PF00104	64	238	4.115285714285714	174	G5AUS5	65	239	3.731548571428573	174
Q9ESJ4	PF00018	2	48	7.703999999999998	46	G5AVL4	3	49	8.290319148936169	46
Q9ESJ4	PF09431	539	674	8.169257352941173	135	G5AVL4	543	678	8.111904411764701	135
Q9Z1N9	PF00130	489	538	2.0990200000000003	49	G5BL08	457	506	3.59112	49
Q9Z1N9	PF00168	51	89	21.100615384615384	38	G5BL08	20	58	21.107256410256408	38
Q9Z1N9	PF00168	612	720	6.3057247706422	108	G5BL08	580	688	6.313633027522934	108
Q9Z1N9	PF00168	1449	1558	3.1432545454545453	109	G5BL08	1437	1546	0.9734363636363637	109
Q9Z1N9	PF06292	929	1032	8.282644230769229	103	G5BL08	897	1001	8.203933333333335	104
Q9Z1N9	PF10540	1275	1414	4.7652785714285715	139	G5BL08	1244	1383	5.547664285714284	139
P48725	PF10495	2700	2778	14.929341772151895	78	G5C7V2	2909	2987	14.882215189873413	78
P70377	PF00167	69	194	3.9957698412698415	125	G5AXM1	70	195	3.9957698412698415	125
O70548	PF09470	3	166	0.0	163	G5BRX1	4	177	0.02277456647398844	173
Q9Z1B3	PF00387	539	653	0.6892086956521739	114	G5BAR9	459	573	0.6404782608695649	114
Q9Z1B3	PF00388	317	467	0.6125960264900664	150	G5BAR9	237	387	0.6129139072847682	150
Q9Z1B3	PF06631	904	942	0.0	38	G5BAR9	824	862	0.0	38
Q9Z1B3	PF08703	1002	1172	0.4486842105263159	170	G5BAR9	922	1092	0.4607076023391813	170
Q9Z1B3	PF09279	215	306	1.2752065217391306	91	G5BAR9	135	226	1.286391304347826	91
Q9Z1B3	PF17787	81	144	8.189078125	63	G5BAR9	1	64	7.943062499999997	63
Q8BH61	PF00868	47	163	6.030034188034186	116	G5BAS8	48	164	6.267675213675213	116
Q8BH61	PF00927	518	622	11.853438095238097	104	G5BAS8	519	623	6.712542857142856	104
Q8BH61	PF00927	630	726	0.7985463917525769	96	G5BAS8	631	727	5.439185567010306	96
Q8BH61	PF01841	310	396	10.881011494252878	86	G5BAS8	311	397	10.91508045977011	86
Q80Y84	PF00628	311	356	4.0833260869565216	45	G5B381	251	296	2.813152173913044	45
Q80Y84	PF00628	1178	1222	0.0	44	G5B381	1118	1162	0.006222222222222223	44
Q80Y84	PF00628	1491	1535	0.6340666666666667	44	G5B381	1431	1475	0.6324888888888888	44
Q80Y84	PF01388	99	181	3.4743614457831327	82	G5B381	39	121	3.53132530120482	82
Q80Y84	PF02373	485	601	9.848384615384617	116	G5B381	425	541	9.173777777777772	116
Q80Y84	PF02928	691	743	3.670943396226415	52	G5B381	631	683	3.678698113207548	52
Q80Y84	PF08429	756	1087	0.24393072289156614	331	G5B381	696	1027	0.2136656626506024	331
Q8CDD8	PF16017	117	222	5.415386792452834	105	G5BEV7	117	222	5.401245283018866	105
Q8BFX3	PF02214	61	104	1.334272727272727	43	G5ATT6	2	45	0.6838409090909091	43
Q05860	PF02181	983	1327	7.410336231884055	344	G5BGS0	912	1218	6.2452540716612335	306
O35492	PF00069	303	619	4.945539432176656	316	G5BRG8	158	474	4.975744479495268	316
Q5F293	PF00096	738	760	0.0	22	G5B5C3	746	768	0.0	22
Q5F293	PF00651	19	154	2.8825808823529413	135	G5B5C3	20	157	2.8443115942028983	137
O08663	PF00557	167	434	3.0456119402985085	267	G5C0T5	205	471	1.619475655430712	266
E9QMW4	PF16043	785	851	0.016835820895522387	66	G5C0J8	425	490	0.01663076923076923	65
Q6ZQM0	PF13920	325	367	0.0	42	G5B757	308	350	0.0	42
Q61880	PF08423	83	336	8.335338582677167	253	G5AYT3	84	337	7.993358267716537	253
Q99MZ7	PF13561	141	263	10.571878048780492	122	G5BZ94	10	128	12.418714285714291	118
O88492	PF03036	1173	1395	0.5568520179372196	222	G5BZ99	1090	1307	2.5049816513761463	217
Q8BXJ8	PF12874	35	57	0.6651739130434783	22	G5BIR3	75	97	0.0	22
Q8BXJ8	PF12874	169	192	0.0	23	G5BIR3	74	97	0.0	23
Q8BXJ8	PF12874	296	320	0.0072000000000000015	24	G5BIR3	201	225	0.00576	24
Q8BXJ8	PF12874	359	383	0.0	24	G5BIR3	264	288	0.0	24
Q920A0	PF13855	152	208	0.28991228070175434	56	G5B362	152	208	0.29696491228070176	56
Q8BIQ5	PF00076	17	87	0.4856338028169014	70	G5BT18	18	88	0.4746760563380282	70
Q8BIQ5	PF14304	535	575	12.138731707317074	40	G5BT18	553	593	12.134317073170731	40
Q8BIQ5	PF14327	112	190	3.2958860759493684	78	G5BT18	113	191	3.2945949367088616	78
Q9JMB8	PF00041	599	686	2.5129886363636365	87	G5BIC1	551	638	3.0430227272727266	87
Q9JMB8	PF00041	804	890	3.8332988505747125	86	G5BIC1	756	842	3.423528735632184	86
Q9JMB8	PF13927	49	103	0.07190909090909092	54	G5BIC1	290	341	10.377230769230767	51
Q9JMB8	PF13927	145	199	1.9716	54	G5BIC1	89	151	2.793888888888888	62
Q9JMB8	PF13927	226	300	0.01568	74	G5BIC1	178	252	0.016533333333333334	74
Q9JMB8	PF13927	501	578	8.862666666666664	77	G5BIC1	453	530	6.879705128205125	77
Q9JMB8	PF07679	317	402	6.759023255813954	85	G5BIC1	269	354	7.06398837209302	85
Q9JMB8	PF07679	409	491	0.2682530120481927	82	G5BIC1	361	443	0.28430120481927723	82
Q8R2T8	PF09734	167	321	4.047154838709678	154	G5AT36	168	322	4.505916129032259	154
Q8R2T8	PF17682	24	130	8.831607476635511	106	G5AT36	25	131	8.164168224299065	106
P14211	PF00262	27	256	4.327791304347826	229	G5BYW1	26	255	4.334639130434783	229
P14211	PF00262	258	331	0.7191486486486479	73	G5BYW1	257	330	0.5845270270270272	73
Q99MJ9	PF00270	157	331	0.7508571428571429	174	G5B802	161	335	0.7465942857142855	174
Q99MJ9	PF00271	383	479	3.4253711340206205	96	G5B802	387	483	3.4219484536082487	96
Q99MJ9	PF08152	567	661	2.7989473684210533	94	G5B802	571	665	2.838589473684212	94
P22858	PF01279	34	126	0.0	92	G5BLK8	35	127	0.0	92
P45448	PF00104	357	450	8.495276595744677	93	G5BSK0	299	391	15.101478260869575	92
P45448	PF00105	105	172	0.020514705882352942	67	G5BSK0	45	112	0.02022058823529412	67
Q04735	PF00069	164	445	5.902925531914892	281	G5AZG0	169	450	6.8779787234042535	281
O88322	PF00058	1225	1265	0.1223170731707317	40	G5BLP0	1362	1402	0.12121951219512195	40
O88322	PF00058	1268	1310	0.08616279069767442	42	G5BLP0	1405	1446	0.0880952380952381	41
O88322	PF00086	974	1032	3.0610169491525423	58	G5BLP0	1045	1103	0.8165762711864406	58
O88322	PF00086	1046	1111	1.2259848484848483	65	G5BLP0	1183	1248	1.2247727272727271	65
O88322	PF06119	180	271	5.071880434782608	91	G5BLP0	178	270	5.13922580645161	92
O88322	PF07474	549	734	4.160725806451612	185	G5BLP0	554	739	5.007112903225806	185
O88322	PF07645	823	864	1.933428571428572	41	G5BLP0	827	868	0.5694285714285714	41
O88322	PF07645	914	945	0.06593750000000001	31	G5BLP0	827	859	0.0	32
Q5QNQ6	PF01237	518	893	1.4929308510638306	375	G5BBT9	279	660	1.5347356020942406	381
Q8R1B4	PF01399	710	843	4.27668656716418	133	G5BRD3	713	846	4.277761194029851	133
Q8R1B4	PF05470	30	702	3.2063224368499266	672	G5BRD3	31	705	3.068576296296297	674
O88898	PF00870	167	356	5.6955368421052635	189	G5CA58	168	357	5.6955368421052635	189
O88898	PF07647	540	602	6.059730158730156	62	G5CA58	541	603	6.059730158730156	62
O88898	PF07710	390	429	0.186575	39	G5CA58	391	430	0.186575	39
Q9CQ33	PF00651	432	557	13.025007936507935	125	G5C033	436	561	11.700658730158729	125
Q9CQ33	PF00651	661	758	3.8892959183673455	97	G5C033	665	762	3.873622448979592	97
Q9CQ33	PF01344	223	266	4.0630454545454535	43	G5C033	227	270	4.062818181818183	43
Q9CQ33	PF01344	279	322	3.270068181818182	43	G5C033	283	326	3.2697500000000006	43
Q9CQ33	PF07646	113	160	15.66725	47	G5C033	117	164	15.666833333333333	47
Q9CQ33	PF13418	64	111	12.642395833333332	47	G5C033	68	115	12.642270833333335	47
Q9DB85	PF05148	238	456	4.783698630136986	218	G5BBQ6	231	449	4.344885321100915	218
P08226	PF01442	72	279	0.011923076923076923	207	G5CBM7	75	271	0.028324873096446695	196
Q62448	PF02020	825	902	8.638487179487184	77	G5BFG6	856	933	8.600871794871798	77
Q62448	PF02847	546	653	5.854990740740737	107	G5BFG6	577	684	5.859907407407403	107
Q62448	PF02854	77	306	2.5641086956521746	229	G5BFG6	107	336	2.5640217391304363	229
Q9JIA7	PF00781	151	284	2.0306567164179112	133	G5B891	206	339	1.3538805970149257	133
Q9WV86	PF00004	244	380	3.54765693430657	136	G5BMD0	244	380	3.5326642335766425	136
Q9WV86	PF09336	449	488	0.13712500000000002	39	G5BMD0	449	488	0.14752500000000002	39
Q9WV86	PF17862	402	443	0.019642857142857142	41	G5BMD0	402	443	0.105	41
P30678	PF00503	22	362	8.155609970674494	340	G5AKR4	23	363	6.0536598240469255	340
Q8R5K4	PF03813	186	322	0.9279781021897808	136	G5B047	178	306	0.922906976744186	128
Q8R5K4	PF17403	329	467	14.736705035971227	138	G5B047	313	451	14.657460431654675	138
Q8R5K4	PF17404	472	633	3.07830864197531	161	G5B047	456	617	2.1130370370370377	161
Q8R5K4	PF17405	647	851	1.4262829268292687	204	G5B047	631	835	0.8547365853658537	204
Q8R5K4	PF17406	853	1008	10.092608974358978	155	G5B047	837	992	12.267756410256407	155
Q8R5K4	PF17407	1012	1142	6.703442748091602	130	G5B047	996	1126	7.454664122137403	130
P28862	PF00045	295	337	4.8977674418604655	42	G5BUC5	291	333	4.311093023255814	42
P28862	PF00045	340	381	10.813166666666666	41	G5BUC5	336	377	11.003214285714293	41
P28862	PF00045	387	432	10.278934782608689	45	G5BUC5	383	428	5.957934782608696	45
P28862	PF00045	452	476	0.006000000000000001	24	G5BUC5	447	471	0.0	24
P28862	PF00413	107	263	4.325681528662421	156	G5BUC5	108	264	7.1047643312101885	156
P28862	PF01471	30	86	0.05956140350877194	56	G5BUC5	31	87	0.1520175438596491	56
O88856	PF13469	67	260	4.366293814432988	193	G5BGM6	69	261	2.8351139896373057	192
Q497V5	PF00575	902	975	8.349243243243242	73	G5C9T9	942	1015	8.276783783783786	73
Q497V5	PF09371	213	386	1.8724482758620675	173	G5C9T9	239	411	4.1296011560693655	172
Q497V5	PF12836	697	761	0.4224307692307692	64	G5C9T9	728	792	0.3536923076923077	64
Q497V5	PF16921	532	657	4.102761904761904	125	G5C9T9	563	688	4.893111111111113	125
Q497V5	PF17674	807	879	4.842315068493151	72	G5C9T9	847	919	6.108054794520547	72
P52950	PF00046	183	237	0.0	54	G5AR22	99	186	0.0	87
Q9D1J3	PF02037	11	41	0.04661290322580645	30	G5BBA3	1	31	0.04548387096774193	30
Q9Z2I8	PF00549	307	421	11.366347826086953	114	G5AXP6	267	380	11.102061403508772	113
Q9Z2I8	PF08442	110	245	4.0578970588235315	135	G5AXP6	70	205	4.085477941176471	135
Q9D1R2	PF08433	21	346	5.054193251533745	325	G5AUH9	4	329	4.3977208588957035	325
Q9Z1P6	PF07347	4	100	0.008402061855670103	96	G5B4M3	5	101	0.015876288659793816	96
A2AG58	PF15440	12	572	1.033288770053476	560	G5B3X5	19	553	0.7625308411214954	534
Q9Z1T1	PF01602	43	583	9.781373382624775	540	G5ASU7	43	598	10.638683453237405	555
Q9Z1T1	PF14796	823	968	1.4003630136986298	145	G5ASU7	821	966	0.6615410958904108	145
Q9Z1T1	PF14797	727	792	0.0	65	G5ASU7	729	791	0.0	62
Q8R0T2	PF00096	290	310	0.0	20	G5BYL3	291	311	0.0	20
Q8R0T2	PF00096	316	338	0.0	22	G5BYL3	317	339	0.0	22
Q8R0T2	PF00096	344	366	0.06391304347826086	22	G5BYL3	345	367	0.06434782608695654	22
Q8R0T2	PF00096	372	394	0.061739130434782616	22	G5BYL3	373	395	0.062173913043478274	22
Q8R0T2	PF00096	402	422	0.0	20	G5BYL3	406	426	0.0	20
Q8R0T2	PF00096	428	450	0.0	22	G5BYL3	432	454	0.0	22
Q8R0T2	PF00096	456	478	1.3253913043478258	22	G5BYL3	460	482	1.3322608695652176	22
Q8R0T2	PF00096	484	506	0.0	22	G5BYL3	488	510	0.0	22
Q8R0T2	PF00096	512	534	0.0	22	G5BYL3	516	538	0.0	22
Q8R0T2	PF00096	540	562	0.0	22	G5BYL3	544	566	0.0	22
Q8R0T2	PF05001	62	74	0.0	12	G5BYL3	60	72	0.0	12
Q8R0T2	PF05001	120	129	0.0	9	G5BYL3	118	127	0.0	9
Q8R0T2	PF05001	139	151	0.0	12	G5BYL3	116	128	0.0	12
B9EJA2	PF00023	799	827	0.2923448275862069	28	G5B3Q6	784	811	1.3243928571428576	27
B9EJA2	PF09727	33	136	1.1557115384615382	103	G5B3Q6	7	111	1.1496666666666668	104
B9EJA2	PF12796	703	794	3.4188913043478286	91	G5B3Q6	688	779	3.8906739130434778	91
Q63955	PF00046	274	330	2.8542105263157893	56	G5C842	275	331	2.8542105263157893	56
Q63955	PF00157	183	255	0.3991917808219178	72	G5C842	184	256	0.3991917808219178	72
Q9CZJ0	PF00149	58	254	0.6622335025380712	196	G5C6P3	59	255	0.6622335025380712	196
P40201	PF00176	492	761	8.358818518518524	269	G5BDL1	502	771	8.359955555555551	269
P40201	PF00271	789	899	9.113873873873873	110	G5BDL1	799	909	9.019603603603604	110
P40201	PF00385	273	351	2.339417721518987	78	G5BDL1	283	361	2.348721518987342	78
P40201	PF00385	386	440	0.20207272727272726	54	G5BDL1	396	450	0.21934545454545448	54
P40201	PF13907	1409	1498	6.223866666666666	89	G5BDL1	1419	1508	6.2228666666666665	89
P40201	PF18375	1121	1207	0.0	86	G5BDL1	1131	1217	0.0	86
Q8BKN5	PF04130	715	975	6.538601532567049	260	G5AZH2	693	952	7.520096153846159	259
Q8BKN5	PF17681	270	626	12.985941176470588	356	G5AZH2	271	604	11.524482035928148	333
P97766	PF09443	130	164	3.5364285714285715	34	G5B9W8	121	155	0.3952571428571429	34
O88545	PF01398	36	143	5.14626851851852	107	G5AN14	89	196	5.366250000000001	107
O88545	PF13012	190	303	2.949315789473685	113	G5AN14	243	356	2.982622807017545	113
P01942	PF00042	6	106	1.583386138613861	100	G5BXY1	7	107	2.480524752475248	100
Q8JZV4	PF00076	310	377	4.339294117647058	67	G5C012	343	410	3.820764705882352	67
Q80UU2	PF01248	101	179	11.196316455696204	78	G5C5D7	107	185	8.338683544303795	78
P15508	PF00307	54	157	12.114221153846152	103	G5BD06	59	162	12.153278846153846	103
P15508	PF00307	173	277	14.960676190476189	104	G5BD06	178	282	14.919847619047616	104
P15508	PF00435	302	410	5.805697247706423	108	G5BD06	307	415	8.94277981651376	108
P15508	PF00435	418	516	1.034292929292929	98	G5BD06	431	529	1.0358787878787878	98
P15508	PF00435	521	626	0.4727641509433961	105	G5BD06	534	639	0.005754716981132076	105
P15508	PF00435	629	732	5.5012019230769225	103	G5BD06	642	745	5.576576923076923	103
P15508	PF00435	735	837	0.0	102	G5BD06	748	850	0.09898058252427183	102
P15508	PF00435	844	941	0.8003061224489799	97	G5BD06	857	954	0.2452142857142857	97
P15508	PF00435	949	1049	3.6054257425742566	100	G5BD06	962	1062	0.2682574257425741	100
P15508	PF00435	1053	1156	0.09759615384615383	103	G5BD06	1066	1200	0.09529629629629632	134
P15508	PF00435	1161	1249	0.039606741573033705	88	G5BD06	1206	1294	0.015775280898876403	88
P15508	PF00435	1266	1367	2.3228529411764707	101	G5BD06	1311	1412	0.733392156862745	101
P15508	PF00435	1380	1454	0.02006666666666667	74	G5BD06	1425	1493	0.03869565217391304	68
P15508	PF00435	1472	1573	0.08327450980392156	101	G5BD06	1511	1612	0.452186274509804	101
P15508	PF00435	1575	1679	2.4007142857142862	104	G5BD06	1614	1718	4.3520666666666665	104
P15508	PF00435	1681	1783	0.15900970873786408	102	G5BD06	1720	1823	0.19373076923076912	103
P15508	PF00435	1788	1889	0.30013725490196075	101	G5BD06	1828	1929	0.7078137254901959	101
P15508	PF00435	1896	1996	1.082188118811881	100	G5BD06	1936	2035	1.0831299999999997	99
P15508	PF00435	2003	2063	0.2086885245901639	60	G5BD06	2043	2103	0.2089344262295082	60
Q9CXZ1	PF04800	75	168	2.604606382978723	93	G5C6Y6	76	169	1.7134042553191495	93
Q8VD75	PF01608	853	1001	2.2913020134228184	148	G5BG68	809	961	1.216052287581699	152
Q8VD75	PF07651	62	303	2.9982107438016516	241	G5BG68	1	242	3.0009876033057856	241
Q8VD75	PF16515	481	571	0.174021978021978	90	G5BG68	420	518	0.024505050505050502	98
Q8C8M1	PF15396	1	196	2.190801020408163	195	G5BLL7	2	197	2.191428571428572	195
Q9DCB8	PF01521	48	146	0.6472121212121209	98	G5C1M4	49	153	0.6142666666666666	104
Q8VD66	PF00561	69	322	2.6182244094488203	253	G5BXC8	70	323	2.612822834645669	253
Q5SW75	PF00782	314	442	4.241139534883722	128	G5BVP5	289	417	4.253356589147287	128
Q5SW75	PF08766	249	301	7.344962264150943	52	G5BVP5	224	276	7.562886792452831	52
Q52KE7	PF00134	86	201	5.777129310344828	115	G5B254	63	178	5.804543103448276	115
Q52KE7	PF02984	213	296	17.253571428571416	83	G5B254	190	273	16.080690476190473	83
Q9DBY5	PF00385	39	59	11.197857142857144	20	G5AYU2	1	21	11.185476190476189	20
Q9DBY5	PF17218	358	388	15.217161290322574	30	G5AYU2	320	350	15.196806451612902	30
Q14AM7	PF15251	90	272	2.066240437158469	182	G5BSC5	10	192	2.019459016393442	182
Q5SUC9	PF02630	119	255	15.077248175182481	136	G5B5I6	125	261	13.189569343065696	136
Q4VA45	PF18658	114	167	0.6612222222222223	53	G5B6G4	1	54	0.6611296296296296	53
Q4VA45	PF18658	264	325	0.13483870967741934	61	G5B6G4	148	209	0.15579032258064515	61
Q4VA45	PF18658	416	455	1.8071	39	G5B6G4	296	334	2.026717948717949	38
Q4VA45	PF18658	590	644	1.3894363636363636	54	G5B6G4	1	54	0.6611296296296296	53
Q6P1I3	PF09404	8	443	6.8800871559633	435	G5ALG2	9	443	7.8010919540229855	434
Q6Y7W8	PF02213	536	580	11.9254	44	G5ASX0	525	569	11.919666666666664	44
Q99LC2	PF00400	104	133	0.08066666666666666	29	G5AW11	105	134	0.06949999999999999	29
Q99LC2	PF00400	165	200	0.4709166666666669	35	G5AW11	166	201	0.4820833333333335	35
Q99LC2	PF00400	259	289	0.04129032258064517	30	G5AW11	260	290	0.04129032258064517	30
Q99LC2	PF00400	294	332	1.8037948717948724	38	G5AW11	295	333	1.8071025641025649	38
Q99LC2	PF00400	389	423	0.0	34	G5AW11	390	424	0.0	34
Q99LC2	PF16699	7	59	9.194	52	G5AW11	8	60	9.194	52
P01108	PF00010	354	406	4.634056603773585	52	G5B9M9	308	360	3.1617547169811315	52
P01108	PF01056	148	344	0.0	196	G5B9M9	110	298	0.0	188
P01108	PF02344	407	436	0.056699999999999987	29	G5B9M9	361	390	0.0	29
P06837	PF00612	31	51	0.0	20	G5AMX0	92	112	0.0	20
P06837	PF06614	70	226	0.0	156	G5AMX0	132	301	0.10899408284023668	169
P06837	PF10580	1	30	0.0	29	G5AMX0	62	91	5.606933333333332	29
Q80ZC9	PF15356	25	133	0.0	108	G5C3D2	28	136	0.0	108
Q8BTW8	PF00919	99	202	8.446201923076924	103	G5BPV0	102	205	8.449086538461536	103
Q8BTW8	PF01938	501	573	0.9593287671232876	72	G5BPV0	516	588	1.4509726027397258	72
Q8BTW8	PF04055	250	445	3.2535969387755097	195	G5BPV0	253	460	0.6964903846153848	207
Q91YN0	PF10154	41	544	1.8699543650793655	503	G5AS02	42	543	1.6490278884462166	501
Q8K2A6	PF00561	91	391	7.571362126245848	300	G5BT02	92	392	8.396205980066446	300
Q8VCD7	PF02373	176	292	2.7868803418803414	116	G5BQF9	177	291	2.4709739130434776	114
Q8VCD7	PF02375	16	50	1.6210000000000002	34	G5BQF9	17	51	1.6134285714285714	34
Q8VCD7	PF13831	709	744	0.4159722222222222	35	G5BQF9	701	736	0.3839444444444444	35
Q8VCD7	PF13832	751	861	4.9060000000000015	110	G5BQF9	743	853	2.5160270270270266	110
Q8VCD7	PF18104	879	913	0.08254285714285714	34	G5BQF9	871	905	1.2765428571428568	34
Q8VCD7	PF18104	937	971	2.1843714285714286	34	G5BQF9	929	963	2.1749428571428573	34
A2ALV5	PF17825	86	1448	3.6235649303008137	1362	G5BWS2	1	1406	4.728065433854908	1405
Q8BZS9	PF04408	458	547	4.5026	89	G5C971	176	265	7.973022222222222	89
Q8BZS9	PF07717	616	696	0.8948888888888891	80	G5C971	334	414	0.6309876543209874	80
Q8VDU0	PF02188	490	509	0.07980000000000001	19	G5BQV0	490	509	0.0	19
Q8VDU0	PF02188	543	564	0.0	21	G5BQV0	545	566	0.0	21
Q8VDU0	PF02188	594	614	0.7885238095238094	20	G5BQV0	596	616	1.802238095238095	20
Q8VDU0	PF02188	628	649	22.77290909090909	21	G5BQV0	630	651	22.769318181818186	21
Q8VDU0	PF13176	64	96	3.6118484848484846	32	G5BQV0	65	97	3.5563939393939394	32
Q8VDU0	PF13176	203	237	0.3794571428571429	34	G5BQV0	204	238	0.37891428571428576	34
Q8VDU0	PF13181	322	352	0.10016129032258064	30	G5BQV0	323	353	0.1	30
Q8VDU0	PF13424	101	156	0.10624999999999996	55	G5BQV0	102	157	0.11044642857142856	55
Q8VDU0	PF13424	242	313	3.776319444444444	71	G5BQV0	243	314	3.773958333333337	71
Q8BYN5	PF00041	177	257	0.9904197530864196	80	G5B9T7	175	255	0.9859382716049376	80
Q8BYN5	PF00622	362	467	2.04861320754717	105	G5B9T7	350	455	2.5152169811320757	105
P23708	PF02045	261	316	0.1207142857142857	55	G5BNH0	264	319	0.1207142857142857	55
Q8R5H1	PF00443	288	470	2.6561311475409846	182	G5ARI9	260	389	0.8982769230769231	129
Q8R5H1	PF06337	26	117	7.379054347826086	91	G5ARI9	27	118	7.377739130434782	91
Q8R5H1	PF14533	471	599	0.2476356589147285	128	G5ARI9	390	518	0.3143953488372095	128
Q8R5H1	PF14836	135	221	0.7452298850574712	86	G5ARI9	136	222	0.7453103448275862	86
Q640Q5	PF18101	687	824	4.519659420289855	137	G5ATU6	596	733	4.514971014492753	137
Q7TMK9	PF00076	163	228	7.4547878787878785	65	G5B6Z5	164	229	7.4547878787878785	65
Q7TMK9	PF00076	244	306	0.4073015873015872	62	G5B6Z5	245	307	0.4026825396825397	62
Q7TMK9	PF00076	339	400	0.14680645161290326	61	G5B6Z5	340	401	0.1465645161290323	61
Q7TMK9	PF18360	33	102	5.610728571428571	69	G5B6Z5	34	103	5.610728571428571	69
P70158	PF00149	101	293	3.296186528497408	192	G5B3W3	1	126	0.2362698412698413	125
Q8BJY1	PF10508	0	503	2.926535714285714	503	G5AXS9	1	504	3.086111332007951	503
Q7TSI3	PF04499	127	375	6.492606425702809	248	G5BW01	134	382	6.529903614457832	248
Q7TSI3	PF04499	375	517	3.320972027972027	142	G5BW01	382	524	3.2726083916083915	142
Q8CI71	PF10474	722	956	6.4143446808510625	234	G5B3I3	733	991	5.857803088803087	258
Q8CI71	PF10475	53	344	4.804592465753425	291	G5B3I3	97	388	4.876349315068494	291
O70263	PF00595	278	359	1.7403536585365855	81	G5C9V1	277	358	8.9795	81
O70263	PF00595	385	463	8.989037974683544	78	G5C9V1	384	462	10.259012658227846	78
O70263	PF00595	512	588	9.800857142857136	76	G5C9V1	514	590	8.742597402597404	76
O70263	PF00595	638	719	6.341195121951219	81	G5C9V1	641	722	9.437243902439024	81
O70263	PF13920	41	85	11.7024	44	G5C9V1	42	86	8.870088888888889	44
Q8BQH6	PF00431	29	139	11.749846846846847	110	G5C9L9	50	160	12.909720720720715	110
Q8BQH6	PF00431	144	251	11.008074074074074	107	G5C9L9	165	272	5.362999999999998	107
Q8BQH6	PF00431	256	369	10.564078947368424	113	G5C9L9	277	390	12.523096491228069	113
P97357	PF14929	63	422	5.735316666666665	359	G5ANM4	97	456	3.6000888888888847	359
Q62433	PF03096	33	315	3.21579151943463	282	G5C6Q8	38	320	3.7148657243816268	282
Q61268	PF15119	28	120	0.33511827956989243	92	G5CBM4	29	118	0.4912666666666667	89
Q3TC46	PF09770	476	715	9.13857916666667	239	G5AP20	510	748	9.17987029288703	238
Q3ULM0	PF15794	55	274	0.4771363636363637	219	G5BVY2	99	319	0.44528959276018104	220
Q6PDL0	PF05783	29	487	5.298664488017428	458	G5BDH0	30	488	5.446769063180822	458
Q3UTJ2	PF00018	948	992	6.018777777777778	44	G5B2V9	443	487	6.033333333333332	44
Q3UTJ2	PF00018	1023	1070	0.009541666666666664	47	G5B2V9	518	565	0.01945833333333333	47
Q3UTJ2	PF02208	169	210	0.0	41	G5B2V9	77	118	0.0	41
Q3UTJ2	PF14604	1127	1177	0.6299215686274511	50	G5B2V9	622	672	0.6232352941176471	50
Q8BKY8	PF02536	68	358	2.6038728522336783	290	G5C455	74	364	2.7173814432989705	290
O88413	PF01167	212	454	2.1606008230452667	242	G5AS14	180	422	2.1903127572016463	242
O88413	PF16322	30	79	0.0	49	G5AS14	19	68	0.0	49
O88413	PF16322	83	151	0.10440579710144933	68	G5AS14	72	139	0.15698529411764706	67
Q8CG72	PF03747	41	342	3.3721158940397347	301	G5C6F4	1	292	6.326123287671231	291
Q9DAD6	PF00235	2	128	4.254023622047248	126	G5BQ08	3	128	7.055571428571433	125
P80560	PF00102	755	988	5.866585470085468	233	G5C8S2	879	1112	4.066944444444445	233
P80560	PF11548	494	581	1.2889886363636365	87	G5C8S2	461	548	0.14651136363636366	87
P80560	PF14948	69	114	0.029239130434782608	45	G5C8S2	54	99	0.2744565217391305	45
Q64692	PF00777	95	352	3.0293372093023265	257	G5BDL3	96	353	3.4132829457364338	257
Q9Z0L3	PF00068	74	179	2.4668301886792445	105	G5C6P9	64	169	1.9506037735849049	105
Q9Z0L3	PF00068	314	419	0.5756886792452831	105	G5C6P9	328	433	1.4488679245283007	105
Q99JU7	PF12496	54	181	0.003921875	127	G5AJY6	83	210	0.051640625	127
Q99JU7	PF13716	184	319	11.304698529411766	135	G5AJY6	213	348	12.35353676470588	135
Q6A085	PF00096	148	170	0.0	22	G5BYK2	264	286	0.0	22
Q6A085	PF00096	177	198	0.0	21	G5BYK2	293	314	0.0	21
Q6A085	PF00096	204	226	0.0	22	G5BYK2	320	342	0.0	22
Q6A085	PF00096	232	254	0.0	22	G5BYK2	348	370	0.0	22
Q6A085	PF00096	260	282	0.0	22	G5BYK2	376	398	0.0	22
Q6A085	PF00096	288	310	0.0	22	G5BYK2	404	426	0.0	22
Q6A085	PF00096	316	338	0.0	22	G5BYK2	432	454	0.0	22
Q6A085	PF00096	344	366	0.0	22	G5BYK2	460	482	0.0	22
Q6A085	PF00096	372	394	0.8958695652173914	22	G5BYK2	488	510	0.8852608695652172	22
Q6A085	PF00096	400	422	0.0	22	G5BYK2	516	538	0.0	22
Q6A085	PF00096	428	450	0.6343478260869566	22	G5BYK2	544	566	0.6268260869565218	22
Q6A085	PF00096	456	478	0.0	22	G5BYK2	600	622	0.0	22
Q6A085	PF00096	484	506	0.0	22	G5BYK2	628	650	0.0	22
Q6A085	PF00096	712	734	0.0	22	G5BYK2	862	884	0.0	22
P46460	PF00004	255	395	3.0247446808510636	140	G5BMY6	253	393	3.000503546099291	140
P46460	PF00004	538	667	8.79526923076923	129	G5BMY6	536	665	8.342853846153847	129
P46460	PF02359	4	82	2.0615696202531644	78	G5BMY6	2	80	2.551126582278481	78
P46460	PF02933	110	158	14.658551020408163	48	G5BMY6	108	156	14.588163265306122	48
P46460	PF17862	422	460	0.0	38	G5BMY6	420	458	0.0	38
Q9CX97	PF00400	287	323	0.33108108108108114	36	G5AR55	287	323	3.9462162162162153	36
Q9CX97	PF12894	45	128	7.683357142857145	83	G5AR55	45	128	7.409928571428576	83
Q8R015	PF14942	33	178	0.08178767123287671	145	G5BAT8	37	182	0.015739726027397264	145
P10820	PF00168	415	495	1.1796543209876538	80	G5B1A0	416	496	2.110617283950617	80
P10820	PF01823	149	365	0.9196129032258068	216	G5B1A0	150	366	0.9605207373271891	216
Q7TSC1	PF07001	0	187	0.0	187	G5C3E7	1	188	0.0	187
Q91V09	PF00400	208	243	0.5329444444444444	35	G5BJH5	209	244	1.4014722222222218	35
Q91V09	PF00400	446	479	8.847029411764705	33	G5BJH5	447	480	8.847029411764705	33
Q9CYF5	PF00415	56	116	12.70296721311475	60	G5C6B3	57	111	14.956963636363644	54
Q9CYF5	PF00415	297	346	0.07020000000000001	49	G5C6B3	292	341	0.21058000000000002	49
Q9CYF5	PF00415	408	454	4.053574468085107	46	G5C6B3	403	449	4.1626170212765965	46
Q9CYF5	PF13540	172	201	0.6868333333333331	29	G5C6B3	167	196	0.7512333333333333	29
Q9CYF5	PF13540	228	257	8.192333333333336	29	G5C6B3	223	252	1.2284000000000002	29
Q80VI1	PF00643	164	204	0.6661951219512193	40	G5AXC5	165	205	0.0	40
Q80VI1	PF13445	20	56	0.0	36	G5AXC5	21	57	0.0	36
Q9CPV3	PF10210	46	141	0.2841145833333334	95	G5B012	48	142	0.19808510638297874	94
Q8CIG9	PF12937	5	46	13.120119047619045	41	G5C645	3	44	13.747619047619047	41
O70138	PF00045	284	325	6.904690476190478	41	G5BUC2	288	329	7.88202380952381	41
O70138	PF00045	329	370	12.140452380952382	41	G5BUC2	333	374	12.167333333333332	41
O70138	PF00045	376	420	5.988377777777778	44	G5BUC2	380	423	11.1095	43
O70138	PF00413	106	261	5.588448717948717	155	G5BUC2	110	265	5.3831410256410255	155
O70138	PF01471	29	85	1.1747368421052629	56	G5BUC2	31	89	7.380661016949151	58
Q641K1	PF00246	898	975	0.8024615384615384	77	G5ARM4	721	798	0.8307692307692306	77
Q641K1	PF18027	703	777	0.7392666666666668	74	G5ARM4	655	728	1.3107702702702704	73
Q76LS9	PF04424	142	265	4.93177419354839	123	G5AJY4	140	257	4.4336355932203375	117
Q6P9R2	PF00069	16	290	7.263312727272734	274	G5C5P7	17	291	7.325730909090914	274
Q6P9R2	PF12202	433	490	10.534637931034483	57	G5C5P7	434	491	10.311896551724141	57
A2RSY6	PF02005	236	541	10.059323529411763	305	G5ATN7	230	537	9.891383116883114	307
A2RSY6	PF02005	652	681	0.018466666666666662	29	G5ATN7	573	602	0.0	29
Q8CJ27	PF00307	1081	1223	13.006664335664336	142	G5BM73	1102	1244	13.8185034965035	142
Q8CJ27	PF00612	1316	1334	7.230894736842107	18	G5BM73	1337	1355	0.06410526315789475	18
Q8CJ27	PF00612	1362	1379	14.590111111111113	17	G5BM73	1383	1400	0.8313888888888888	17
Q8CJ27	PF00612	1431	1449	9.469157894736844	18	G5BM73	1451	1469	9.246052631578948	18
Q8CJ27	PF00612	1504	1520	0.0	16	G5BM73	1524	1539	0.0	15
Q8CJ27	PF00612	1600	1620	10.188714285714287	20	G5BM73	1619	1638	19.6609	19
Q8CJ27	PF00612	1625	1643	0.3911052631578947	18	G5BM73	1644	1661	1.3858888888888887	17
Q8CJ27	PF00612	1696	1716	0.0	20	G5BM73	1715	1735	6.3342857142857145	20
Q8CJ27	PF00612	1720	1738	0.04421052631578948	18	G5BM73	1739	1757	0.0	18
Q8CJ27	PF00612	1770	1789	0.044	19	G5BM73	1789	1808	0.0	19
Q8CJ27	PF00612	1794	1812	0.7394210526315789	18	G5BM73	1813	1830	0.017666666666666667	17
Q8CJ27	PF00612	1842	1862	6.831809523809524	20	G5BM73	1861	1880	1.24155	19
Q8CJ27	PF00612	1865	1885	0.0	20	G5BM73	1884	1904	0.0	20
Q8CJ27	PF00612	1938	1956	0.32794736842105265	18	G5BM73	1957	1975	11.90642105263158	18
Q8CJ27	PF00612	1989	2006	6.218388888888889	17	G5BM73	2008	2025	4.271	17
Q8CJ27	PF00612	2011	2030	0.3255	19	G5BM73	2030	2049	0.39475	19
Q8CJ27	PF00612	2159	2177	4.960736842105263	18	G5BM73	2178	2196	0.3916842105263158	18
Q8CJ27	PF00612	2207	2227	10.037	20	G5BM73	2226	2246	1.477142857142857	20
Q8CJ27	PF00612	2232	2249	1.2853888888888887	17	G5BM73	2251	2268	6.97711111111111	17
Q8CJ27	PF00612	2280	2298	0.23789473684210524	18	G5BM73	2296	2314	0.16631578947368422	18
Q8CJ27	PF00612	2302	2321	1.0338500000000002	19	G5BM73	2318	2337	0.6320999999999999	19
Q8CJ27	PF00612	2344	2363	8.067650000000002	19	G5BM73	2227	2246	1.537	19
Q8CJ27	PF00612	2366	2385	0.05425	19	G5BM73	2462	2481	15.39845	19
Q8CJ27	PF00612	2416	2435	0.16075	19	G5BM73	2295	2314	0.158	19
Q8CJ27	PF00612	2491	2508	8.011333333333333	17	G5BM73	2391	2408	6.165722222222222	17
Q8CJ27	PF00612	2563	2579	0.03941176470588235	16	G5BM73	2464	2479	15.636375	15
Q8CJ27	PF00612	2603	2621	0.157	18	G5BM73	2666	2684	1.4081052631578943	18
Q8CJ27	PF00612	2675	2693	0.18815789473684208	18	G5BM73	2571	2589	0.0910526315789474	18
Q8CJ27	PF00612	2725	2742	24.894000000000005	17	G5BM73	1716	1733	7.3900000000000015	17
Q8CJ27	PF00612	2786	2804	22.282631578947374	18	G5BM73	2798	2816	0.7253157894736842	18
Q8CJ27	PF00612	2853	2867	0.0	14	G5BM73	2865	2879	0.0	14
Q8CJ27	PF15780	29	125	9.067432989690724	96	G5BM73	40	136	11.084865979381439	96
Q62086	PF01731	166	250	8.11809411764706	84	G5AJS7	167	251	7.637423529411764	84
Q9JL56	PF03009	69	309	13.925336099585063	240	G5AY23	70	310	8.830385892116182	240
Q99N91	PF00468	49	91	0.5949534883720929	42	G5B7V4	48	90	10.617214285714287	42
P07742	PF00317	141	211	0.279450704225352	70	G5B9C2	136	206	0.2360422535211268	70
P07742	PF02867	215	737	4.010432122370942	522	G5B9C2	210	733	3.932148854961832	523
P07742	PF03477	6	88	2.6787590361445783	82	G5B9C2	1	83	2.676060240963855	82
Q80XC6	PF08424	318	655	7.787553254437869	337	G5AZZ1	308	674	5.82462670299728	366
Q9WV68	PF13561	37	269	7.027776824034334	232	G5BXX0	37	269	6.8952618025751065	232
Q9JHU3	PF00069	6	287	2.2965780141843983	281	G5AL42	7	288	2.284567375886525	281
P08071	PF00405	23	350	3.9111189024390263	327	G5ANP4	62	363	2.790552980132451	301
P08071	PF00405	362	690	3.834167173252281	328	G5ANP4	375	703	3.1507142857142854	328
Q9JKF1	PF00307	47	157	5.7156216216216205	110	G5B1S6	152	262	6.32427927927928	110
Q9JKF1	PF00612	748	765	0.0	17	G5B1S6	853	870	0.0	17
Q9JKF1	PF00612	777	795	0.3926315789473685	18	G5B1S6	882	900	0.3132631578947369	18
Q9JKF1	PF00612	808	825	0.0931111111111111	17	G5B1S6	913	930	0.069	17
Q9JKF1	PF00612	838	855	0.4656111111111112	17	G5B1S6	943	960	0.429	17
Q9JKF1	PF00616	1024	1236	2.7161173708920177	212	G5B1S6	1129	1341	2.6669107981220637	212
Q9JKF1	PF03836	1451	1578	0.02398437500000001	127	G5B1S6	1556	1683	0.10554687499999997	127
Q99KH8	PF00069	23	273	4.999561752988049	250	G5C352	36	286	5.063569721115536	250
O35450	PF00515	284	316	0.0	32	G5C3H9	286	318	0.0	32
O35450	PF13432	213	280	0.5488970588235295	67	G5C3H9	215	282	0.14288235294117646	67
Q8BJW6	PF08662	215	410	6.356959183673473	195	G5AZN4	207	402	8.00814795918367	195
Q8BGH7	PF00786	27	42	0.0	15	G5BPG1	28	43	0.0	15
Q8BZ05	PF00169	482	570	7.4717528089887635	88	G5AYN3	478	544	7.4460149253731345	66
Q8BZ05	PF00169	599	675	3.2540779220779226	76	G5AYN3	573	649	3.1971038961038967	76
Q8BZ05	PF00169	916	996	10.70201234567901	80	G5AYN3	845	925	10.641296296296296	80
Q8BZ05	PF00169	1429	1527	3.988808080808081	98	G5AYN3	1335	1433	6.711373737373736	98
Q8BZ05	PF00536	9	65	8.259912280701755	56	G5AYN3	10	66	2.5921929824561403	56
Q8BZ05	PF00620	1126	1275	9.226406666666668	149	G5AYN3	1055	1204	11.844560000000001	149
Q8BZ05	PF00788	1327	1413	2.450494252873563	86	G5AYN3	1233	1319	2.3702643678160915	86
Q8BZ05	PF01412	685	798	11.586622807017536	113	G5AYN3	659	772	11.610736842105265	113
G3X9K3	PF01369	694	878	8.034508108108103	184	G5BJW8	697	881	7.758183783783783	184
G3X9K3	PF09324	1216	1297	3.2207073170731704	81	G5BJW8	1219	1300	3.219524390243904	81
G3X9K3	PF12783	416	574	16.84075471698113	158	G5BJW8	419	577	16.841993710691828	158
G3X9K3	PF16213	28	210	2.2080109289617487	182	G5BJW8	29	211	2.205994535519125	182
Q62376	PF00076	104	173	0.8367857142857141	69	G5BAF7	105	174	0.7435285714285715	69
Q62376	PF12220	3	93	3.409428571428572	90	G5BAF7	4	94	3.387	90
Q8BGQ2	PF16019	61	278	2.7990229357798158	217	G5ATZ3	62	279	2.7994311926605504	217
Q8CI17	PF03281	125	417	3.7659078498293495	292	G5BFJ8	59	351	3.8390750853242315	292
Q8BJW5	PF08168	199	242	6.6768409090909095	43	G5BVE5	200	243	10.113795454545453	43
Q8BK06	PF12937	178	227	17.396419999999992	49	G5B5V4	370	419	19.0958	49
Q922R1	PF03676	14	406	2.999908396946564	392	G5C642	15	411	4.063657430730478	396
Q9DAJ4	PF00400	17	52	0.0	35	G5BYX9	18	53	0.0	35
Q9DAJ4	PF00400	57	94	7.868210526315789	37	G5BYX9	58	95	8.919131578947368	37
Q9DAJ4	PF00400	98	136	1.0995384615384616	38	G5BYX9	99	137	1.0647435897435895	38
Q9DAJ4	PF00400	222	262	1.056048780487805	40	G5BYX9	223	263	2.581317073170732	40
Q99MR6	PF04959	644	849	1.0543640776699028	205	G5AV51	646	847	1.0758069306930695	201
Q99MR6	PF12066	152	261	6.341863636363637	109	G5AV51	153	262	6.316590909090907	109
P53395	PF00198	249	478	0.6362347826086959	229	G5AYQ0	250	479	0.5559608695652173	229
P53395	PF00364	65	137	2.7265616438356157	72	G5AYQ0	66	138	2.828095890410958	72
P53395	PF02817	171	205	0.8338285714285714	34	G5AYQ0	172	206	0.04928571428571429	34
Q9R0Q1	PF00168	373	480	0.4370462962962962	107	G5B2L2	377	484	0.4350185185185187	107
Q9R0Q1	PF00168	527	634	0.5432777777777777	107	G5B2L2	531	638	0.6055555555555556	107
Q9R0Q1	PF02318	8	121	3.5799649122807016	113	G5B2L2	9	122	3.5944298245614035	113
Q6PFE3	PF00176	298	574	5.812169675090246	276	G5C4C5	321	597	8.400310469314077	276
Q6PFE3	PF00271	621	734	11.54095614035088	113	G5C4C5	639	752	11.462622807017539	113
Q61466	PF02201	293	362	7.4059	69	G5AU04	255	324	7.5828142857142815	69
Q99KP6	PF00400	254	291	6.463368421052631	37	G5AYE3	436	473	6.518842105263157	37
Q99KP6	PF00400	352	377	0.4097307692307694	25	G5AYE3	448	472	4.54304	24
Q99KP6	PF00400	384	419	1.2101111111111114	35	G5AYE3	532	566	0.5724857142857146	34
Q99KP6	PF00400	466	501	0.6266666666666668	35	G5AYE3	531	566	0.5718611111111113	35
Q99KP6	PF04564	7	53	0.1305531914893617	46	G5AYE3	121	167	0.1276595744680851	46
Q99KP6	PF08606	67	132	0.10522727272727272	65	G5AYE3	181	246	0.1192121212121212	65
Q9QZA0	PF00194	47	294	5.407786290322579	247	G5ARI0	48	295	5.521596774193549	247
Q8BGC4	PF00107	183	318	5.0583602941176435	135	G5C0L4	152	287	5.837176470588237	135
Q8BGC4	PF08240	63	122	1.7637999999999996	59	G5C0L4	32	91	1.8059333333333327	59
Q3UMW8	PF15014	40	331	8.496938356164385	291	G5ASH9	1	292	7.883489726027401	291
Q8BM65	PF15439	93	458	0.006475409836065574	365	G5BDS6	1	330	0.05601515151515151	329
Q8BM65	PF15452	500	583	0.06927380952380953	83	G5BDS6	373	456	0.05161904761904762	83
Q9D7H2	PF00400	33	65	15.649878787878787	32	G5AV81	52	84	15.974303030303032	32
Q9D7H2	PF00400	70	108	0.0	38	G5AV81	89	126	0.0008421052631578947	37
Q9D7H2	PF00400	112	149	0.7057368421052634	37	G5AV81	131	168	2.2955526315789463	37
Q9D7H2	PF00400	154	192	0.2882051282051282	38	G5AV81	173	211	0.3148205128205129	38
Q9D7H2	PF00400	196	235	7.8857500000000025	39	G5AV81	215	254	0.41635	39
Q9D7H2	PF00400	239	280	18.286761904761907	41	G5AV81	258	299	20.324404761904766	41
Q9D7H2	PF00400	287	324	3.2691315789473694	37	G5AV81	306	342	6.6042162162162175	36
P31311	PF00046	241	297	11.912456140350876	56	G5BD57	253	309	11.910526315789475	56
P31311	PF12045	25	159	0.05047407407407408	134	G5BD57	25	160	0.048897058823529405	135
Q8BGD8	PF02297	11	61	0.0	50	G5AKB8	1	51	0.0	50
P53657	PF00224	85	436	6.212082386363636	351	G5BDG0	81	388	6.2327824675324734	307
P53657	PF02887	453	570	12.422228813559327	117	G5BDG0	405	522	12.841940677966099	117
Q6PCN7	PF00176	242	714	7.268173361522192	472	G5BSK6	215	690	5.804357142857139	475
Q6PCN7	PF00271	830	943	12.127605263157895	113	G5BSK6	806	919	12.235552631578946	113
Q6PCN7	PF08797	76	149	12.847621621621624	73	G5BSK6	49	122	6.159864864864866	73
Q6PCN7	PF13920	750	798	0.17048979591836733	48	G5BSK6	726	774	0.16965306122448978	48
Q62288	PF00086	315	378	0.095453125	63	G5B032	251	314	0.09562499999999996	63
Q62288	PF07648	137	181	0.0	44	G5B032	73	116	0.09772727272727272	43
Q62288	PF10591	198	306	1.2686330275229356	108	G5B032	134	242	1.405394495412844	108
Q8CFC2	PF01530	28	56	0.0	28	G5C8A4	91	119	0.0	28
Q8CFC2	PF01530	442	468	0.0	26	G5C8A4	471	497	0.0	26
Q8CFC2	PF01530	486	514	0.0	28	G5C8A4	515	543	0.0	28
Q8CFC2	PF01530	800	828	0.0	28	G5C8A4	829	857	0.0	28
Q8CFC2	PF01530	844	872	0.0	28	G5C8A4	873	901	0.0	28
Q8CFC2	PF01530	893	921	0.0	28	G5C8A4	922	950	0.0	28
Q8CFC2	PF01530	946	974	0.0	28	G5C8A4	975	1003	0.0	28
Q8CFC2	PF08474	561	616	0.016392857142857143	55	G5C8A4	590	645	0.021857142857142856	55
Q8CFC2	PF08474	618	791	0.32763218390804594	173	G5C8A4	647	820	0.32664942528735635	173
P97310	PF00493	460	682	5.356201793721971	222	G5ALM3	495	729	7.4851148936170135	234
P97310	PF12619	71	179	0.0	108	G5ALM3	113	214	0.4626470588235295	101
P97310	PF14551	196	284	4.644348314606742	88	G5ALM3	231	319	4.689044943820226	88
P97310	PF17207	293	419	0.6581181102362207	126	G5ALM3	328	454	0.6790157480314962	126
P97310	PF17855	717	801	1.7909999999999997	84	G5ALM3	763	847	1.8088117647058808	84
Q5EBG8	PF10504	35	172	5.145775362318844	137	G5BDK4	96	233	5.000572463768117	137
P25801	PF00412	29	86	0.18370689655172415	57	G5BPX6	99	156	0.1808965517241379	57
P25801	PF00412	93	149	0.4030350877192983	56	G5BPX6	163	219	0.3994561403508771	56
P63011	PF00071	23	182	7.166293750000004	159	G5B4D4	24	183	6.649587500000003	159
P52479	PF00443	408	785	4.7395846560846575	377	G5BJF2	404	781	3.525507936507935	377
P52479	PF07145	77	92	0.7818749999999999	15	G5BJF2	74	89	1.1466875	15
O70443	PF00503	13	343	7.083157099697889	330	G5B623	14	344	7.172510574018134	330
Q6PE15	PF12146	68	171	8.146307692307692	103	G5B1E3	64	167	7.675461538461537	103
Q8BJW7	PF02732	267	438	7.641418604651159	171	G5C4J5	257	440	7.090510869565219	183
P39039	PF00059	135	236	4.519588235294117	101	G5C4H7	146	247	4.684617647058823	101
P39039	PF01391	36	87	0.010134615384615384	51	G5C4H7	47	98	0.012826923076923078	51
Q8CG73	PF00168	790	897	4.9703888888888885	107	G5BSE2	968	1075	8.64164814814815	107
Q8CG73	PF11618	597	737	9.189524822695024	140	G5BSE2	598	738	8.239680851063829	140
Q8CG73	PF18111	1135	1255	9.76784297520661	120	G5BSE2	1280	1400	8.007107438016527	120
Q64332	PF02078	127	212	0.19063953488372093	85	G5APJ0	42	127	0.2770697674418605	85
Q64332	PF02750	228	416	5.9389259259259175	188	G5APJ0	204	392	3.87240740740741	188
Q9JKC8	PF00928	164	416	0.5274664031620554	252	G5C7I3	165	417	0.5176442687747037	252
Q9JKC8	PF01217	0	127	13.653257812499993	127	G5C7I3	1	128	11.549484375	127
Q9JLJ0	PF10601	89	158	1.7102714285714284	69	G5B4G8	91	160	3.2512571428571433	69
Q9JLH8	PF03250	3	142	3.6282857142857146	139	G5AJZ5	4	143	3.629742857142857	139
O88569	PF00076	22	86	5.055815384615387	64	G5BD43	22	86	4.979461538461539	64
O88569	PF00076	113	173	6.691459016393441	60	G5BD43	113	173	6.648524590163934	60
Q8BP92	PF13202	69	90	0.0	21	G5AL18	27	48	0.0	21
Q8BP92	PF13202	201	213	0.0	12	G5AL18	159	171	0.0	12
Q8BP92	PF13499	240	291	0.6041346153846155	51	G5AL18	198	249	0.6059230769230769	51
Q8K0D0	PF00069	191	472	5.904021276595747	281	G5C0S6	192	473	5.904000000000004	281
O88441	PF10568	40	161	1.829540983606557	121	G5BU22	29	150	1.8190327868852456	121
O88441	PF17171	186	248	8.07385714285714	62	G5BU22	175	237	8.100650793650793	62
Q9DAY5	PF17065	0	184	14.937178378378384	184	G5C7R2	1	185	15.587864130434776	184
Q9D8U4	PF00386	159	283	12.513616	124	G5BEM5	151	275	12.300232000000001	124
Q9D8U4	PF01391	53	103	0.0	50	G5BEM5	45	95	0.0	50
Q9D8U4	PF01391	90	148	0.0	58	G5BEM5	82	140	0.023389830508474582	58
P26450	PF00017	332	407	0.4614868421052633	75	G5C7Q9	333	408	0.4598684210526316	75
P26450	PF00017	623	697	2.344933333333334	74	G5C7Q9	628	702	2.337533333333333	74
P26450	PF00620	128	276	3.5211744966442957	148	G5C7Q9	129	277	5.878402684563758	148
P26450	PF16454	430	597	2.307577380952381	167	G5C7Q9	431	594	2.361018292682927	163
O55091	PF01205	180	287	4.282916666666666	107	G5BLQ3	180	287	4.625287037037037	107
O55091	PF05773	10	111	4.015892156862745	101	G5BLQ3	11	112	7.129578431372549	101
P29121	PF00082	145	282	3.966275362318837	137	G5BW47	157	303	3.531013605442176	146
P29121	PF01483	487	571	9.363388235294119	84	G5BW47	442	526	1.1732705882352938	84
P29121	PF16470	33	109	1.164220779220779	76	G5BW47	50	126	2.710831168831168	76
Q99JX3	PF04495	70	203	0.6336492537313434	133	G5BLX1	71	204	0.6304029850746271	133
Q80TJ1	PF00169	520	619	13.489099999999995	99	G5BBX1	377	476	13.882849999999996	99
Q80TJ1	PF06292	838	941	4.581682692307694	103	G5BBX1	701	804	4.5757115384615386	103
Q9D9C7	PF15830	0	248	0.44214056224899606	248	G5BZW0	1	214	1.4520375586854462	213
Q6GQU2	PF00651	32	132	1.26790099009901	100	G5C8Q0	33	133	1.2653564356435645	100
Q6GQU2	PF01344	274	302	22.006551724137925	28	G5C8Q0	275	303	20.00886206896552	28
Q6GQU2	PF01344	311	351	6.022121951219513	40	G5C8Q0	312	352	6.019243902439026	40
Q6GQU2	PF01344	357	401	1.8212888888888892	44	G5C8Q0	358	402	1.8240222222222224	44
Q6GQU2	PF01344	407	447	12.239975609756096	40	G5C8Q0	408	448	12.213707317073169	40
Q6GQU2	PF01344	459	494	0.6899722222222223	35	G5C8Q0	460	495	0.7134166666666668	35
Q6GQU2	PF01344	496	543	4.6791874999999985	47	G5C8Q0	497	544	4.6779375	47
Q6GQU2	PF07707	138	236	6.959161616161616	98	G5C8Q0	139	237	6.507636363636362	98
Q62440	PF00400	577	601	3.1496400000000007	24	G5B8E5	672	696	2.5259199999999997	24
Q62440	PF00400	607	643	0.0	36	G5B8E5	702	738	0.0	36
Q62440	PF03920	0	126	2.097133858267717	126	G5B8E5	1	126	2.150547619047619	125
P97785	PF02351	28	107	1.1234875	79	G5BKB3	29	108	1.128875	79
P97785	PF02351	153	232	0.184575	79	G5BKB3	149	228	0.1847625	79
P97785	PF02351	242	336	2.5924842105263157	94	G5BKB3	238	332	2.5775999999999994	94
Q99JG7	PF12180	214	247	0.0	33	G5BCH3	124	156	0.0	32
Q99JG7	PF16516	257	336	0.97685	79	G5BCH3	167	238	0.18604166666666666	71
Q8R242	PF00704	98	340	2.3488065843621397	242	G5C926	112	354	1.8487448559670785	242
Q9JJU8	PF04908	15	97	7.884012048192773	82	G5BZ93	31	113	7.174000000000001	82
Q8R2L5	PF01084	70	120	0.3352549019607844	50	G5AT12	72	122	0.2799019607843137	50
Q3UVC0	PF07714	675	937	9.442304182509506	262	G5AKT0	664	926	9.440365019011406	262
Q3UVC0	PF13543	23	151	0.0068372093023255824	128	G5AKT0	24	152	0.0068372093023255824	128
Q9D1Q1	PF10175	7	135	0.3571007751937985	128	G5BKQ8	24	152	0.3529147286821705	128
Q9CPN8	PF00013	197	260	5.306812500000001	63	G5BHC3	115	178	5.308109375	63
Q9CPN8	PF00013	279	343	0.0	64	G5BHC3	197	261	0.0	64
Q9CPN8	PF00013	407	470	2.857328125	63	G5BHC3	325	388	2.268609375	63
Q9CPN8	PF00013	490	549	0.0523	59	G5BHC3	408	473	0.0	65
Q9CPN8	PF00076	85	149	4.153138461538462	64	G5BHC3	8	67	4.5176500000000015	59
O08538	PF00147	283	446	8.573865853658532	163	G5AZ90	196	413	7.662344036697247	217
A2AA28	PF10294	62	196	14.006340740740738	134	G5AQT8	39	180	5.9151056338028205	141
P20181	PF00243	145	254	0.20819090909090912	109	G5CAN4	145	254	0.20681818181818173	109
O35737	PF00076	29	81	0.020245283018867924	52	G5C7B7	2	54	0.025132075471698108	52
O35737	PF00076	113	180	1.31939705882353	67	G5C7B7	86	153	1.3163382352941169	67
O35737	PF00076	292	353	0.6636290322580645	61	G5C7B7	265	326	0.6697096774193546	61
O35737	PF08080	254	289	0.08041666666666665	35	G5C7B7	227	262	0.08000000000000003	35
Q8R2U4	PF05891	7	222	7.1953888888888935	215	G5ASC2	133	348	6.13460465116279	215
Q8R2K8	PF15465	0	105	14.737990566037741	105	G5BH34	1	100	15.066949494949494	99
Q8R2K8	PF15465	100	110	0.0	10	G5BH34	91	100	0.0	9
Q8CGW4	PF00505	365	432	2.880573529411765	67	G5BKW8	344	411	2.8727205882352944	67
Q9DAM5	PF00153	17	109	4.398709677419356	92	G5BNB7	18	110	4.47441935483871	92
Q9DAM5	PF00153	115	202	3.4233977272727283	87	G5BNB7	116	203	5.617863636363636	87
Q9DAM5	PF00153	212	309	8.119989795918366	97	G5BNB7	213	310	10.78334693877551	97
Q99LZ3	PF05916	49	125	0.1399090909090909	76	G5C639	50	126	0.1394025974025974	76
Q99LZ3	PF16922	164	222	3.552610169491527	58	G5C639	165	223	3.609603448275863	58
Q9D3J9	PF15133	0	292	1.0075119453924921	292	G5B868	1	293	0.5369453924914678	292
Q91X46	PF00621	125	300	0.8354772727272729	175	G5ATM8	169	344	0.8313636363636366	175
Q8BZW8	PF01436	223	249	0.3636666666666667	26	G5BKE0	224	250	11.545925925925927	26
Q8BZW8	PF01436	277	302	7.957884615384615	25	G5BKE0	278	303	7.937961538461537	25
Q8BZW8	PF01436	529	556	11.834464285714288	27	G5BKE0	531	558	11.6525	27
Q8BZW8	PF13905	77	172	19.562947916666673	95	G5BKE0	78	173	15.124979166666664	95
Q3V1T4	PF13640	587	678	11.295195652173913	91	G5AQI1	528	619	12.234826086956526	91
Q8BXK8	PF00071	72	229	7.941436708860762	157	G5AY43	19	176	7.942715189873422	157
Q8BXK8	PF01412	610	721	0.0773660714285714	111	G5AY43	504	615	0.14898214285714287	111
Q8BXK8	PF12796	738	825	18.074852272727274	87	G5AY43	632	719	18.07231818181818	87
Q9D0K0	PF00566	144	246	12.849796116504855	102	G5BN50	145	249	17.05913333333333	104
P52293	PF01749	12	97	0.0	85	G5BVE9	13	98	0.010232558139534885	85
P52293	PF00514	108	148	2.1489512195121963	40	G5BVE9	109	149	2.137487804878049	40
P52293	PF00514	150	189	9.934525	39	G5BVE9	151	190	7.0477750000000015	39
P52293	PF00514	193	237	4.400955555555553	44	G5BVE9	194	238	2.8679333333333323	44
P52293	PF00514	249	278	3.4879	29	G5BVE9	250	279	3.9734333333333343	29
P52293	PF00514	282	320	0.10292307692307692	38	G5BVE9	283	321	0.2726666666666667	38
P52293	PF00514	323	363	0.13395121951219516	40	G5BVE9	324	364	0.19434146341463407	40
P52293	PF00514	366	404	12.153333333333334	38	G5BVE9	367	405	20.637717948717953	38
P52293	PF00514	409	446	27.163236842105263	37	G5BVE9	410	447	29.294342105263162	37
P52293	PF16186	457	508	0.3534038461538459	51	G5BVE9	458	509	0.3382115384615384	51
Q8BVR6	PF00622	360	387	7.044857142857143	27	G5BR70	361	387	7.156444444444445	26
Q61908	PF08991	5	58	0.047666666666666656	53	G5B9E0	6	59	0.02333333333333333	53
Q60949	PF00566	890	1100	14.958976303317534	210	G5C3W2	671	881	14.965137440758284	210
Q60949	PF00640	276	371	11.856875000000002	95	G5C3W2	151	244	12.124989361702125	93
Q60949	PF11830	776	831	0.4451964285714287	55	G5C3W2	557	612	0.3718214285714286	55
P59672	PF07647	714	768	0.06294545454545455	54	G5BCF4	639	692	0.0638888888888889	53
P59672	PF00536	784	845	2.4857419354838703	61	G5BCF4	719	780	2.4827258064516124	61
P59672	PF00640	977	1082	10.281971698113207	105	G5BCF4	912	1017	10.27466037735849	105
P59672	PF12796	60	135	0.19818421052631574	75	G5BCF4	1	76	0.1641315789473684	75
P59672	PF12796	159	224	2.040242424242424	65	G5BCF4	79	144	2.6895151515151507	65
P59672	PF12796	230	293	16.334906250000003	63	G5BCF4	150	213	16.330031250000008	63
Q8BGT5	PF00155	111	498	2.661899484536081	387	G5BAE5	120	508	2.235496143958868	388
O08792	PF01833	252	330	17.422772151898734	78	G5BYA3	217	295	17.425987341772153	78
O08792	PF16422	22	245	6.535531249999997	223	G5BYA3	1	210	4.326247619047619	209
O08792	PF16423	337	380	1.7059772727272728	43	G5BYA3	302	345	0.06381818181818183	43
Q8C456	PF11768	47	590	6.991748161764701	543	G5C8M2	46	589	9.09820404411765	543
Q68FF7	PF15301	231	578	0.02336206896551725	347	G5BEQ2	77	411	0.02420658682634732	334
Q69Z98	PF00069	32	269	7.0564033613445405	237	G5C8L0	258	477	7.369745454545453	219
Q71KU9	PF00147	81	292	2.8102924528301885	211	G5AP78	83	293	4.8128056872037925	210
P54254	PF08517	549	616	8.937867647058821	67	G5BT39	546	612	9.067268656716418	66
Q922M3	PF02214	33	123	3.8516043956043973	90	G5BDR7	65	155	4.511164835164837	90
Q8R3P9	PF12796	806	893	5.740454545454547	87	G5BU37	805	892	5.600840909090909	87
Q8R3P9	PF16770	7	87	1.2330617283950611	80	G5BU37	8	88	1.1203703703703702	80
Q69ZH9	PF00620	915	1065	3.5769271523178796	150	G5BY34	1004	1154	3.5638675496688736	150
Q69ZH9	PF15410	686	703	2.4466666666666668	17	G5BY34	801	817	0.04382352941176471	16
Q69ZH9	PF17820	98	147	3.8379800000000004	49	G5BY34	209	258	8.691559999999999	49
Q9D0B0	PF00076	16	83	0.09452941176470588	67	G5B772	16	83	0.09458823529411764	67
Q9D0B0	PF00076	113	174	0.022096774193548385	61	G5B772	113	174	0.01767741935483871	61
Q9D2V7	PF00400	72	104	0.09709090909090913	32	G5C0J3	54	86	0.4314545454545455	32
Q9D2V7	PF00400	158	195	0.7187105263157896	37	G5C0J3	140	177	0.2416315789473684	37
Q9D2V7	PF00400	583	619	0.033081081081081085	36	G5C0J3	565	601	0.030918918918918924	36
Q9D2V7	PF00400	628	660	2.135090909090909	32	G5C0J3	610	645	1.4592500000000002	35
Q9D2V7	PF08953	19	60	7.611880952380952	41	G5C0J3	1	42	1.0558333333333334	41
Q9D2V7	PF08953	466	528	0.0642857142857143	62	G5C0J3	448	510	0.0630952380952381	62
Q9D2V7	PF16300	337	378	0.0	41	G5C0J3	319	360	0.4502857142857143	41
Q9D2V7	PF16300	804	848	0.020888888888888887	44	G5C0J3	789	833	0.0	44
O35601	PF07653	502	556	0.0	54	G5BLT1	519	573	0.0	54
O35601	PF14603	734	812	0.1069873417721519	78	G5BLT1	508	605	0.0	97
Q91ZT9	PF07525	246	284	5.772692307692307	38	G5BWC0	247	285	5.3519999999999985	38
Q91ZT9	PF12796	99	178	0.4607374999999999	79	G5BWC0	100	179	0.43685	79
Q91ZT9	PF13637	53	95	0.0	42	G5BWC0	54	96	0.0	42
Q9WTX8	PF05557	53	661	0.10365681444991784	608	G5BI86	54	661	0.2864431630971992	607
Q9R1S8	PF00648	253	534	6.383113475177304	281	G5BUL7	220	501	6.501737588652484	281
Q9R1S8	PF01067	693	798	3.262905660377358	105	G5BUL7	660	765	4.1137169811320735	105
Q9R1S8	PF04212	34	67	1.0898235294117646	33	G5BUL7	1	34	1.3269411764705883	33
Q9R1S8	PF04212	86	150	0.6404	64	G5BUL7	53	117	0.6364615384615385	64
Q8CD92	PF13432	569	626	9.079965517241382	57	G5B3Y0	566	623	7.764568965517241	57
Q9D9J8	PF01273	46	218	1.2247109826589593	172	G5BPV4	42	213	3.8136686046511623	171
Q9CWD8	PF10609	65	309	4.7187755102040825	244	G5CAL7	66	310	4.531657142857143	244
Q8BIR2	PF12813	115	225	15.450459459459456	110	G5AM68	116	226	11.341954954954955	110
Q7TN79	PF10469	50	246	3.147446700507613	196	G5C774	32	228	3.128771573604061	196
Q7TN79	PF10470	255	310	0.0	55	G5C774	237	292	0.029428571428571436	55
O88593	PF01510	39	166	2.6688906250000013	127	G5AUY8	51	178	1.0978124999999996	127
Q8CC88	PF07728	103	259	0.7214522292993629	156	G5BA94	105	261	0.7557770700636941	156
Q8CC88	PF07728	440	597	3.77287341772152	157	G5BA94	442	599	3.129765822784809	157
Q8CC88	PF07728	774	912	1.4096546762589923	138	G5BA94	776	914	3.4275035971223016	138
Q60930	PF01459	15	287	0.7981355311355309	272	G5C7J1	4	276	0.8120915750915749	272
Q08652	PF00061	5	132	0.8665156249999998	127	G5AQA4	6	133	4.533203124999999	127
P51885	PF01462	36	64	0.0	28	G5BSJ5	233	261	0.02086206896551724	28
P51885	PF13516	184	195	0.0	11	G5BSJ5	381	392	0.0	11
P51885	PF13855	65	101	0.9044864864864864	36	G5BSJ5	262	298	0.926054054054054	36
P51885	PF13855	136	170	20.68408571428571	34	G5BSJ5	333	367	7.938714285714287	34
P51885	PF13855	205	265	5.010852459016394	60	G5BSJ5	402	462	6.543016393442625	60
Q9D1A2	PF01546	94	206	0.18499115044247788	112	G5BAR1	95	207	0.16132743362831864	112
Q9D1A2	PF07687	207	365	4.333377358490567	158	G5BAR1	208	371	3.6872865853658534	163
Q9D2N4	PF00569	239	279	0.0	40	G5BGH9	421	461	0.0	40
Q9D2N4	PF09068	43	121	21.026822784810133	78	G5BGH9	172	250	34.60672151898733	78
Q9D2N4	PF09069	150	231	4.887097560975612	81	G5BGH9	332	413	0.83890243902439	81
Q80Z71	PF00041	264	336	2.344452054794521	72	G5ARS0	249	321	1.7466712328767129	72
Q80Z71	PF00041	360	431	0.012833333333333334	71	G5ARS0	345	416	0.013083333333333334	71
Q80Z71	PF00041	445	516	6.355194444444446	71	G5ARS0	430	501	5.806555555555557	71
Q80Z71	PF00041	531	604	11.190297297297297	73	G5ARS0	516	589	8.668310810810812	73
Q80Z71	PF00041	620	693	0.5249594594594594	73	G5ARS0	869	942	0.2548783783783784	73
Q80Z71	PF00041	709	780	0.09086111111111113	71	G5ARS0	694	765	0.11344444444444444	71
Q80Z71	PF00041	795	870	0.048855263157894735	75	G5ARS0	692	767	0.1074736842105263	75
Q80Z71	PF00041	709	780	0.09086111111111113	71	G5ARS0	694	765	0.11344444444444444	71
Q80Z71	PF00041	971	1045	0.2366933333333333	74	G5ARS0	692	766	0.10890666666666664	74
Q80Z71	PF00041	1060	1133	1.882689189189189	73	G5ARS0	869	942	0.2548783783783784	73
Q80Z71	PF00041	1148	1221	0.2253243243243243	73	G5ARS0	869	942	0.2548783783783784	73
Q80Z71	PF00041	1235	1309	3.328266666666667	74	G5ARS0	956	1030	1.40536	74
Q80Z71	PF00147	1328	1537	3.8205428571428586	209	G5ARS0	1049	1258	3.081714285714287	209
Q80Z71	PF18720	170	196	0.0	26	G5ARS0	155	181	0.0	26
Q80Z71	PF18720	201	228	0.026785714285714284	27	G5ARS0	186	213	0.0	27
Q7TQF2	PF05048	718	867	2.270973333333333	149	G5C1D8	725	874	1.0589133333333338	149
Q7TQF2	PF12937	5	49	13.887088888888886	44	G5C1D8	6	50	13.865555555555556	44
Q7TQF2	PF13229	421	567	5.516408163265307	146	G5C1D8	426	572	5.51139455782313	146
Q9WVF8	PF15000	0	108	0.027064220183486244	108	G5BZZ4	1	109	0.02701834862385322	108
O09053	PF01612	50	221	6.6827267441860485	171	G5C9Z1	57	227	6.0427134502923945	170
O09053	PF00270	514	673	7.217500000000001	159	G5C9Z1	531	690	7.977131250000004	159
O09053	PF00271	728	822	7.3740315789473705	94	G5C9Z1	745	839	7.698221052631579	94
O09053	PF00570	1120	1174	0.07254545454545454	54	G5C9Z1	1130	1183	0.07203703703703704	53
O09053	PF09382	920	1016	0.3015670103092784	96	G5C9Z1	937	1032	5.286531249999999	95
O09053	PF14493	1223	1316	9.121617021276592	93	G5C9Z1	1232	1325	6.984393617021282	93
O09053	PF16124	835	904	0.11168571428571428	69	G5C9Z1	852	921	0.8496285714285714	69
Q3U821	PF00400	46	84	4.551538461538461	38	G5BZH6	48	86	4.86051282051282	38
Q3U821	PF00400	205	228	0.17854166666666665	23	G5BZH6	207	230	0.3027916666666666	23
Q3U821	PF00400	439	471	6.232090909090909	32	G5BZH6	441	473	7.128787878787879	32
Q5SQM0	PF00400	65	90	12.604576923076925	25	G5B8W1	3	28	6.906807692307693	25
Q5SQM0	PF00400	104	135	9.1605	31	G5B8W1	42	73	9.227468750000002	31
Q5SQM0	PF00400	314	352	2.9825897435897453	38	G5B8W1	252	290	3.0454615384615384	38
Q5SQM0	PF00400	554	590	1.3277027027027029	36	G5B8W1	492	528	1.3297567567567563	36
Q5SQM0	PF00400	720	756	0.7906756756756756	36	G5B8W1	658	694	0.7920270270270272	36
Q5SQM0	PF00400	761	795	1.2060857142857144	34	G5B8W1	699	733	2.045457142857143	34
Q5SQM0	PF00400	993	1024	0.3349374999999999	31	G5B8W1	931	962	0.2981562500000001	31
Q5SQM0	PF00400	1231	1265	15.587657142857143	34	G5B8W1	1169	1203	16.273171428571427	34
Q5SQM0	PF00400	1682	1714	0.6086666666666667	32	G5B8W1	1620	1652	3.608939393939394	32
Q5SQM0	PF00400	1922	1954	12.729	32	G5B8W1	1860	1892	12.77921212121212	32
Q5SQM0	PF03451	5	47	30.84220930232558	42	G5B8W1	609	651	27.468720930232568	42
Q5SQM0	PF03451	666	713	24.613083333333336	47	G5B8W1	604	651	24.60739583333334	47
Q5SQM0	PF03451	1341	1400	0.2335	59	G5B8W1	1279	1338	0.2338833333333334	59
Q5SQM0	PF12894	372	458	6.483551724137932	86	G5B8W1	310	396	6.622218390804592	86
Q5SQM0	PF12894	1734	1809	10.09140789473684	75	G5B8W1	1672	1747	8.76367105263158	75
P18654	PF00069	67	326	4.544034615384613	259	G5B3X2	47	304	4.596492248062017	257
P18654	PF00069	421	678	9.731426356589145	257	G5B3X2	399	656	9.734337209302325	257
P18654	PF00433	350	386	6.251	36	G5B3X2	328	364	8.412324324324327	36
P26928	PF00024	24	102	0.008860759493670886	78	G5BZW9	25	103	0.17649367088607595	78
P26928	PF00051	123	185	0.0196031746031746	62	G5BZW9	116	178	0.0196031746031746	62
P26928	PF00051	190	267	1.4853846153846153	77	G5BZW9	183	260	0.08865384615384615	77
P26928	PF00051	291	369	0.01120253164556962	78	G5BZW9	275	353	0.30574683544303805	78
P26928	PF00051	378	456	0.14082278481012658	78	G5BZW9	362	440	0.015443037974683544	78
P26928	PF00089	568	708	5.980070921985817	140	G5BZW9	469	609	14.061659574468086	140
Q6P3A8	PF02779	67	242	5.613971590909091	175	G5BGH0	70	245	5.734625	175
Q6P3A8	PF02780	259	377	2.3253865546218484	118	G5BGH0	262	380	3.0657310924369754	118
Q6GQW0	PF00023	608	635	0.7753928571428572	27	G5BPD8	240	267	0.7790714285714291	27
Q6GQW0	PF00651	920	1024	13.577095238095234	104	G5BPD8	552	656	13.577933333333334	104
Q6GQW0	PF12796	653	718	16.847272727272724	65	G5BPD8	285	350	16.921696969696974	65
P30677	PF00503	40	343	7.013365131578946	303	G5BLA5	1	304	7.682555921052629	303
Q9CQU8	PF10502	25	92	0.5103970588235294	67	G5C8K0	26	93	0.5077352941176471	67
Q9CQU8	PF10502	101	145	0.0	44	G5C8K0	102	146	0.0	44
Q5PRE5	PF14771	0	60	1.1500327868852458	60	G5C7K1	1	61	1.1490655737704918	60
Q5PRE5	PF14771	47	120	11.881824324324324	73	G5C7K1	48	121	7.05848648648649	73
Q9D9M2	PF00443	38	365	7.1107164634146365	327	G5ATV6	24	359	6.233005952380954	335
Q91YW3	PF00515	107	136	0.0	29	G5B162	147	176	0.0	29
Q91YW3	PF13181	222	254	1.4644848484848485	32	G5B162	262	294	0.41260606060606064	32
Q91YW3	PF13432	40	93	5.984037037037039	53	G5B162	55	108	6.055425925925926	53
Q91YW3	PF00226	393	458	0.06862121212121212	65	G5B162	433	498	0.06930303030303027	65
Q8C4S8	PF02141	653	786	14.86380597014926	133	G5B569	566	697	13.174113636363636	131
Q8C4S8	PF03455	919	964	0.2916304347826087	45	G5B569	918	963	0.271	45
Q8C4S8	PF03456	576	643	3.871838235294118	67	G5B569	489	556	3.839044117647058	67
Q9CQG2	PF05971	0	290	3.241979381443296	290	G5BCT9	1	291	3.240512027491408	290
Q5EG47	PF00069	42	278	4.081616033755274	236	G5C4R6	1	267	5.9356966292134805	266
Q5EG47	PF16579	405	479	0.032106666666666665	74	G5C4R6	394	468	0.01864	74
Q3UB74	PF05964	182	232	0.8071960784313728	50	G5C495	167	217	0.894156862745098	50
Q3UB74	PF05965	238	317	0.07743750000000002	79	G5C495	223	302	0.0959625	79
Q80YQ2	PF11573	1	1079	6.9160880444856385	1078	G5C777	5	1008	6.803652390438229	1003
Q8K2P6	PF00355	17	92	7.093644736842101	75	G5BU31	22	97	7.03005263157895	75
Q8BLR5	PF01369	537	686	5.712693333333334	149	G5B413	517	666	4.521680000000002	149
Q8BLR5	PF15410	727	840	4.418921052631582	113	G5B413	707	820	4.408061403508771	113
Q8CGF1	PF00130	617	660	6.743681818181818	43	G5AW27	608	651	8.282409090909091	43
Q8CGF1	PF00620	686	857	2.7078837209302318	171	G5AW27	677	848	2.7863372093023266	171
Q80SW1	PF00670	288	448	8.224130434782609	160	G5BD70	289	449	8.224546583850938	160
Q80SW1	PF05221	103	238	7.802875000000004	135	G5BD70	104	239	7.80327941176471	135
Q6IE32	PF00050	37	84	0.1890625	47	G5BQ80	9	56	0.0548936170212766	47
Q9QYG0	PF03096	40	317	7.28736690647482	277	G5BFW4	41	318	5.8099964028776965	277
Q8QZS1	PF16113	45	374	4.1498666666666635	329	G5BGL1	36	365	3.4409787878787887	329
Q3U2A8	PF00133	112	733	3.0586527331189686	621	G5C3C8	114	782	4.869908819133034	668
Q3U2A8	PF08264	779	927	1.0280805369127526	148	G5C3C8	828	976	0.5346107382550337	148
A2A5Z6	PF00168	17	101	1.7272117647058831	84	G5BVF0	15	99	1.6605764705882355	84
A2A5Z6	PF00397	158	187	0.0	29	G5BVF0	156	185	0.0	29
A2A5Z6	PF00397	252	281	1.9805	29	G5BVF0	250	279	1.9926333333333333	29
A2A5Z6	PF00397	298	327	0.032	29	G5BVF0	296	325	0.0322	29
A2A5Z6	PF00632	442	746	4.107285245901637	304	G5BVF0	440	744	3.8187901639344313	304
O54917	PF02319	64	127	8.012531249999997	63	G5AKS1	29	92	8.331859375000004	63
O54917	PF16421	142	235	7.6015319148936165	93	G5AKS1	107	205	9.81647474747475	98
Q8VBT1	PF09728	145	452	1.103551948051949	307	G5AUD8	146	453	1.1783863636363632	307
Q61241	PF00069	16	271	7.033953124999997	255	G5BGT7	17	272	6.864394531250001	255
P53026	PF00687	24	210	12.092796791443849	186	G5BEX1	73	259	12.088048128342244	186
Q9DAA7	PF17670	19	133	0.0	114	G5AM36	37	150	0.11867543859649125	113
Q8R149	PF09736	477	607	0.03309160305343512	130	G5BQH0	488	617	0.03329457364341086	129
Q9QXL2	PF00225	57	370	3.142229299363056	313	G5BHF4	33	346	3.262560509554141	313
Q9QXL2	PF00400	1335	1370	4.675750000000002	35	G5BHF4	1264	1299	4.879833333333333	35
Q9QXL2	PF00400	1480	1520	1.7295609756097563	40	G5BHF4	1409	1449	1.7497804878048795	40
Q9QXL2	PF00400	1615	1649	0.3653714285714285	34	G5BHF4	1544	1578	0.3587714285714286	34
Q9Z1D8	PF00096	340	362	0.5181739130434782	22	G5AX96	234	256	0.5100869565217392	22
Q9Z1D8	PF00096	368	390	0.0	22	G5AX96	262	284	0.0	22
Q9Z1D8	PF00096	396	418	0.0	22	G5AX96	290	312	0.0	22
Q9Z1D8	PF00096	426	446	0.0	20	G5AX96	320	340	0.0	20
Q9Z1D8	PF00096	539	561	0.0	22	G5AX96	437	459	0.0	22
Q9Z1D8	PF00096	567	589	0.0	22	G5AX96	465	487	0.0	22
Q9Z1D8	PF00096	595	617	0.0	22	G5AX96	493	515	0.0	22
Q9Z1D8	PF00096	623	645	0.0	22	G5AX96	521	543	0.0	22
Q9Z1D8	PF00096	707	729	0.0	22	G5AX96	605	627	0.0	22
Q9Z1D8	PF00096	763	785	0.0	22	G5AX96	661	683	0.0	22
Q9Z1D8	PF01352	219	248	11.8116	29	G5AX96	106	134	4.899379310344829	28
O35143	PF04568	33	93	0.0	60	G5AP86	32	92	0.0	60
Q9D1H0	PF17066	0	252	0.0	252	G5AKW5	12	269	0.0	257
Q3UYG8	PF01661	140	199	3.2553166666666664	59	G5AMI0	1	60	4.283600000000002	59
Q9DBL7	PF01121	357	531	6.520691428571429	174	G5B0J5	359	533	7.167451428571432	174
Q9DBL7	PF01467	194	337	8.609270833333335	143	G5B0J5	196	339	11.583652777777779	143
Q9CXU0	PF09748	8	124	5.00068376068376	116	G5BJC4	9	125	4.99651282051282	116
Q8BGF6	PF04727	110	246	12.851934306569346	136	G5BQF4	111	246	10.583096296296292	135
Q80V62	PF14631	19	1413	6.822306093189957	1394	G5BX77	2	1392	6.993846872753414	1390
Q8CDB0	PF00069	86	367	5.396070921985813	281	G5BBB7	76	357	5.391031914893615	281
Q9D0M0	PF01138	89	165	12.709324675324671	76	G5ANM9	172	248	10.657766233766234	76
Q9D0M0	PF03725	196	259	6.540515625000002	63	G5ANM9	279	342	11.347015625000004	63
P51908	PF18774	26	158	9.990052631578944	132	G5BPM8	13	145	8.350774436090227	132
Q9QWR8	PF16499	27	307	5.038886120996441	280	G5BPR2	1	281	4.1332918149466185	280
Q9QWR8	PF17450	310	393	10.903964285714288	83	G5BPR2	350	433	9.367797619047616	83
Q8K262	PF15205	37	105	0.1672608695652174	68	G5BRK4	7	74	0.4794705882352941	67
Q8BVP1	PF00622	345	452	5.5568240740740755	107	G5C6V0	156	263	4.409009259259259	107
Q8BVP1	PF13765	293	341	2.6800204081632653	48	G5C6V0	104	152	6.9938979591836725	48
Q69Z66	PF00249	115	158	0.28863636363636364	43	G5APP0	110	153	0.028409090909090905	43
Q69Z66	PF01398	566	669	4.373317307692306	103	G5APP0	560	663	2.89175	103
Q69Z66	PF04433	370	451	0.18600000000000003	81	G5APP0	364	445	0.18652439024390247	81
Q5RJI5	PF00069	75	226	10.297019736842103	151	G5BVZ9	1	151	9.625867549668873	150
Q5F201	PF00400	56	96	5.292365853658536	40	G5B5H0	58	98	4.667609756097559	40
Q5F201	PF00400	106	140	18.645057142857144	34	G5B5H0	108	142	20.94431428571429	34
Q5F201	PF00400	456	488	2.117727272727272	32	G5B5H0	449	481	2.371212121212121	32
Q5F201	PF00400	535	572	0.13939473684210527	37	G5B5H0	528	565	0.15860526315789475	37
Q5F201	PF00400	578	613	5.167805555555557	35	G5B5H0	571	606	5.351944444444445	35
Q9D6J4	PF03992	252	325	0.4321891891891891	73	G5BPU7	162	235	0.2307027027027026	73
Q501J6	PF00270	115	285	3.662713450292397	170	G5AYT2	116	286	3.662713450292397	170
Q501J6	PF00271	324	432	6.390587155963303	108	G5AYT2	325	433	6.390587155963303	108
Q8R1Q8	PF05783	42	511	4.911914893617026	469	G5BIV6	43	513	4.879161358811039	470
Q9D0E5	PF13499	93	137	7.5007999999999955	44	G5BK45	94	137	6.715139534883725	43
Q9D0E5	PF13833	25	46	12.480954545454544	21	G5BK45	26	47	18.18140909090909	21
Q9CRC9	PF01182	14	234	3.4578416289592764	220	G5APB2	15	235	3.5747466063348425	220
Q9EPZ6	PF00907	146	335	2.342894736842105	189	G5BDZ1	138	327	4.472426315789472	189
Q8CCN5	PF12490	573	791	5.0121278538812755	218	G5AX26	345	563	4.156365296803654	218
O54692	PF06248	8	561	3.560254512635383	553	G5B7G3	9	561	3.6521446654611216	552
Q8BND4	PF13519	3	131	8.384581395348839	128	G5C975	4	108	8.946038095238096	104
Q8BND4	PF15300	776	837	10.60177419354839	61	G5C975	752	813	9.524064516129028	61
Q3UIW8	PF13445	22	66	0.4400222222222222	44	G5BFY9	23	67	0.4421555555555555	44
O35638	PF08514	157	264	11.320888888888891	107	G5BC48	158	265	11.321916666666665	107
Q8K1C0	PF03372	169	532	3.8224423076923064	363	G5ATJ5	170	533	3.4579478021978	363
Q80YR5	PF00076	452	521	0.5474857142857142	69	G5C0Q9	424	493	0.5387142857142857	69
Q80YR5	PF02037	24	57	0.03705882352941176	33	G5C0Q9	30	63	0.03688235294117647	33
Q8C0S4	PF13176	1196	1221	10.645346153846157	25	G5C5N5	1304	1329	10.305692307692308	25
Q8C0S4	PF13181	790	817	0.07778571428571428	27	G5C5N5	891	918	0.04496428571428572	27
Q8C0S4	PF13432	724	785	0.08380645161290322	61	G5C5N5	825	886	0.09656451612903227	61
Q8C0S4	PF14559	894	957	7.250062500000001	63	G5C5N5	1006	1069	4.076546875	63
Q9D1E6	PF01302	160	228	5.713884057971012	68	G5BK09	161	229	6.211608695652178	68
Q9D1E6	PF14560	10	90	6.241481481481483	80	G5BK09	11	91	4.912716049382714	80
Q8C6M1	PF00443	144	664	2.6474318618042214	520	G5ASB5	139	689	2.374411978221418	550
Q8C6M1	PF02148	29	90	4.748548387096774	61	G5ASB5	30	91	4.897241935483871	61
Q8C6M1	PF06337	711	776	0.8551363636363635	65	G5ASB5	760	828	7.712695652173914	68
Q8C6M1	PF06337	818	889	10.572513888888887	71	G5ASB5	759	830	8.619013888888889	71
P35991	PF00017	280	361	1.676304878048779	81	G5C2S6	281	362	1.6763414634146327	81
P35991	PF00018	219	265	5.382765957446809	46	G5C2S6	220	266	4.016936170212765	46
P35991	PF00169	4	132	4.0439379844961225	128	G5C2S6	5	133	1.823248062015504	128
P35991	PF00779	140	166	0.09444444444444444	26	G5C2S6	141	167	0.09444444444444444	26
P35991	PF07714	401	649	8.02867068273092	248	G5C2S6	402	650	8.171891566265057	248
Q64693	PF09310	6	254	0.3942489959839356	248	G5CB11	7	255	0.5278995983935741	248
P01029	PF00207	779	866	3.924147727272728	87	G5C3H6	776	863	1.4768295454545446	87
P01029	PF01759	1609	1717	0.7107522935779816	108	G5C3H6	1612	1720	1.1699266055045872	108
P01029	PF01821	699	733	0.022	34	G5C3H6	696	730	0.0	34
P01029	PF01835	139	230	3.0928695652173914	91	G5C3H6	142	233	2.6744130434782605	91
P01029	PF07677	1474	1563	10.400111111111109	89	G5C3H6	1477	1566	7.125477777777783	89
P01029	PF07678	980	1310	9.340021148036252	330	G5C3H6	979	1309	9.295682779456193	330
P01029	PF07703	471	607	17.21824817518248	136	G5C3H6	468	604	17.672518248175173	136
P01029	PF17791	232	318	0.106551724137931	86	G5C3H6	235	321	0.1160114942528736	86
Q80X32	PF17724	0	187	0.0	187	G5BQ19	49	236	0.0	187
Q8C624	PF15382	62	127	0.1669696969696969	65	G5API0	32	96	0.13246153846153844	64
Q8BLH7	PF09649	529	560	0.2860625	31	G5BYN5	487	518	0.27984374999999995	31
P07310	PF00217	153	366	3.1674439252336435	213	G5BKU0	154	369	3.1394120370370384	215
P07310	PF02807	23	93	5.2087887323943685	70	G5BKU0	24	94	5.212549295774648	70
Q5SSK3	PF12836	79	127	0.35920408163265294	48	G5BVM5	84	132	0.130265306122449	48
Q9Z1M8	PF07807	444	550	0.20401869158878505	106	G5AR56	474	580	0.2021495327102804	106
Q9Z1M8	PF07808	75	295	1.3345746606334847	220	G5AR56	76	324	4.329510040160642	248
Q4U4S6	PF08043	342	357	0.09675	15	G5AUH2	384	399	0.0	15
Q4U4S6	PF08043	384	397	11.8455	13	G5AUH2	426	439	11.925357142857148	13
Q4U4S6	PF08043	419	434	0.3696875	15	G5AUH2	460	475	0.0	15
Q4U4S6	PF08043	457	472	0.0	15	G5AUH2	498	513	2.4815625	15
Q4U4S6	PF08043	535	550	0.0	15	G5AUH2	576	591	0.0	15
Q4U4S6	PF08043	573	588	0.0	15	G5AUH2	614	629	0.0	15
Q4U4S6	PF08043	608	622	0.0	14	G5AUH2	649	663	0.0	14
Q4U4S6	PF08043	641	655	0.0	14	G5AUH2	682	696	0.0	14
Q4U4S6	PF08043	678	692	0.0	14	G5AUH2	719	733	0.0	14
Q4U4S6	PF08043	783	798	0.0	15	G5AUH2	824	839	0.0	15
Q4U4S6	PF08043	821	836	0.0	15	G5AUH2	862	877	0.0	15
Q4U4S6	PF08043	860	875	0.0	15	G5AUH2	901	916	0.0	15
Q4U4S6	PF08043	893	908	20.549625	15	G5AUH2	934	949	11.178	15
Q4U4S6	PF08043	931	946	4.1777500000000005	15	G5AUH2	972	987	7.8805	15
Q4U4S6	PF08043	1005	1020	0.0	15	G5AUH2	1046	1061	0.0	15
Q4U4S6	PF08043	1078	1092	0.01693333333333334	14	G5AUH2	1119	1133	0.03386666666666667	14
Q4U4S6	PF08043	1116	1131	0.0	15	G5AUH2	1157	1172	0.0	15
Q4U4S6	PF08043	1153	1168	0.0	15	G5AUH2	1194	1209	0.0	15
Q4U4S6	PF08043	1255	1270	26.722249999999995	15	G5AUH2	1297	1312	26.71025	15
Q4U4S6	PF08043	1291	1304	9.11357142857143	13	G5AUH2	1333	1346	32.85735714285714	13
Q9R0C8	PF00017	671	745	0.5750266666666667	74	G5C6Z6	620	694	0.603	74
Q9R0C8	PF00130	513	561	0.1673061224489796	48	G5C6Z6	462	510	0.16687755102040816	48
Q9R0C8	PF00169	414	500	10.885954022988503	86	G5C6Z6	363	449	10.879632183908047	86
Q9R0C8	PF00621	195	368	3.763982758620692	173	G5C6Z6	176	317	4.370732394366199	141
Q9R0C8	PF07653	596	656	0.0	60	G5C6Z6	545	605	0.0	60
Q9R0C8	PF07653	797	844	0.02233333333333333	47	G5C6Z6	746	793	0.0141875	47
Q9R0C8	PF11971	19	70	1.44875	51	G5C6Z6	46	89	0.0	43
Q9CWQ3	PF09768	50	190	0.08389361702127658	140	G5BEB0	56	192	1.8774014598540143	136
P62071	PF00071	33	175	8.528657342657349	142	G5BUE4	38	180	9.118223776223774	142
O55230	PF08423	87	313	9.265713656387666	226	G5B756	107	333	9.162295154185024	226
Q9CQJ6	PF01253	112	180	0.2789130434782609	68	G5AWR5	115	183	0.2797971014492754	68
Q9CXA2	PF05544	21	350	5.914433333333332	329	G5B7F0	22	351	7.324487878787877	329
Q99NA2	PF00010	231	282	1.193173076923077	51	G5BU88	229	280	1.283076923076923	51
Q68FD5	PF00637	564	677	1.9349210526315788	113	G5C895	516	632	3.4048461538461536	116
Q68FD5	PF00637	687	825	13.72807913669066	138	G5C895	642	738	9.512206185567008	96
Q68FD5	PF00637	888	967	0.8404875	79	G5C895	709	796	6.673045454545454	87
Q68FD5	PF00637	978	1118	8.060411347517729	140	G5C895	807	947	8.048574468085107	140
Q68FD5	PF00637	1128	1257	4.208323076923077	129	G5C895	957	1085	3.9867519379844967	128
Q68FD5	PF00637	1275	1416	9.817845070422534	141	G5C895	1089	1230	8.454830985915494	141
Q68FD5	PF00637	1426	1478	0.05545283018867925	52	G5C895	1240	1291	0.04923076923076923	51
Q68FD5	PF01394	18	55	3.4030789473684213	37	G5C895	19	56	3.3724736842105263	37
Q68FD5	PF01394	147	186	4.894075	39	G5C895	148	187	4.875825000000002	39
Q68FD5	PF01394	197	233	14.87064864864865	36	G5C895	198	234	14.857648648648649	36
Q68FD5	PF01394	255	287	16.499303030303032	32	G5C895	256	288	16.49860606060606	32
Q68FD5	PF01394	295	329	4.105857142857142	34	G5C895	296	330	4.088057142857143	34
Q68FD5	PF09268	330	353	1.523625	23	G5C895	331	354	1.5166666666666668	23
Q68FD5	PF13838	355	420	6.178378787878788	65	G5C895	356	421	6.9247121212121225	65
P22315	PF00762	66	384	2.0242445141065826	318	G5BCD3	76	396	2.2026666666666674	320
P61327	PF02792	4	145	5.847584507042254	141	G5C9K8	5	146	5.882397163120568	141
Q8R2K4	PF02969	9	72	0.13909375	63	G5AYJ1	10	73	0.1403125	63
Q8R2K4	PF07571	241	329	8.743651685393258	88	G5AYJ1	242	330	7.756786516853932	88
Q3TYX8	PF02759	41	162	3.7501639344262285	121	G5AZJ9	42	207	0.5849698795180724	165
Q8R3A2	PF10170	12	105	2.2169148936170218	93	G5BVB0	78	179	1.4174705882352945	101
Q8BFQ9	PF01344	232	275	11.942863636363628	43	G5BLK7	233	276	12.208795454545452	43
Q8BFQ9	PF01344	278	318	0.18207317073170734	40	G5BLK7	279	319	0.06341463414634146	40
Q9Z2R6	PF05351	79	235	0.7951847133757965	156	G5BVH3	78	234	0.7638471337579614	156
Q8K3G9	PF00169	279	373	6.037894736842108	94	G5C463	270	364	4.8770210526315765	94
Q8K3G9	PF00640	491	606	3.8681724137931033	115	G5C463	558	667	4.399818181818182	109
Q8K3G9	PF16746	6	246	0.988323651452282	240	G5C463	7	237	1.0800476190476187	230
Q4VC33	PF10607	160	299	3.1518071428571433	139	G5BCJ4	168	307	3.103671428571428	139
P50396	PF00996	15	434	5.101976190476188	419	G5BFK9	7	426	5.132292857142856	419
Q8VC16	PF13516	335	349	0.0	14	G5C5R5	336	350	0.0	14
Q9JMA1	PF00443	104	478	4.070373333333333	374	G5BTS3	144	519	4.063265957446808	375
Q8R071	PF03770	242	452	2.8892369668246447	210	G5BM15	73	283	2.855535545023696	210
Q8BQ89	PF14954	97	327	5.1402554112554135	230	G5BBN1	18	267	9.656955999999994	249
Q9CZG3	PF07258	115	180	1.5043636363636363	65	G5AVK5	116	180	4.581138461538462	64
P22005	PF01160	24	69	0.5308913043478259	45	G5ASM7	25	70	0.5312608695652173	45
Q8K0V4	PF04065	2	231	0.059221739130434776	229	G5CBF6	3	232	0.05951739130434783	229
Q8K0V4	PF04153	620	744	7.591039999999999	124	G5CBF6	616	729	1.5477543859649123	113
Q8R2R5	PF14580	43	165	4.262032520325202	122	G5AML2	44	167	0.5500161290322579	123
Q8CJG1	PF02170	237	362	0.21685714285714286	125	G5C6F1	230	355	0.21680952380952376	125
Q8CJG1	PF02171	514	814	7.0998571428571395	300	G5C6F1	507	807	6.7728637873754165	300
Q8CJG1	PF08699	173	223	6.3164313725490215	50	G5C6F1	166	216	6.315686274509809	50
Q8CJG1	PF16486	33	163	3.1475954198473275	130	G5C6F1	26	156	3.1471603053435118	130
Q8CJG1	PF16487	426	507	8.356524390243901	81	G5C6F1	419	500	8.358756097560978	81
Q8CJG1	PF16488	371	417	0.0	46	G5C6F1	364	410	0.0	46
Q6P3A9	PF00025	7	169	5.509079754601227	162	G5B9Z3	66	227	5.8545308641975335	161
Q0VDQ9	PF00096	259	278	0.0	19	G5AZE0	260	286	0.0	26
Q0VDQ9	PF00096	287	309	0.0	22	G5AZE0	295	317	0.0	22
Q0VDQ9	PF00096	315	337	0.0	22	G5AZE0	323	345	0.0	22
Q0VDQ9	PF00096	343	365	0.0	22	G5AZE0	351	373	0.0	22
Q0VDQ9	PF00096	399	422	0.0	23	G5AZE0	407	430	0.0	23
Q0VDQ9	PF13912	371	395	1.18572	24	G5AZE0	379	403	1.18528	24
Q61468	PF06060	29	621	4.064564924114668	592	G5BXV0	28	584	3.066280071813286	556
P08042	PF00096	181	203	0.15565217391304348	22	G5B5X4	179	201	0.12065217391304348	22
P08042	PF00096	267	287	0.0	20	G5B5X4	265	285	0.0	20
P08042	PF00096	293	315	0.0	22	G5B5X4	291	313	0.0	22
P08042	PF00096	321	343	0.0	22	G5B5X4	319	341	0.05826086956521739	22
P08042	PF00096	349	369	0.0	20	G5B5X4	347	367	0.0	20
P08042	PF00096	377	399	0.0	22	G5B5X4	375	396	0.0	21
P08042	PF01352	5	45	0.06258536585365855	40	G5B5X4	3	43	0.8865121951219515	40
P08042	PF13465	223	248	0.0	25	G5B5X4	221	246	0.0	25
Q9EPL9	PF00441	300	459	2.8491625	159	G5B306	301	460	4.736099999999999	159
Q9EPL9	PF01756	512	685	8.772798850574716	173	G5B306	513	686	9.705632183908042	173
Q9EPL9	PF02770	154	265	6.509125	111	G5B306	155	266	6.202035714285714	111
Q80ZK0	PF00338	36	131	5.697999999999998	95	G5BNJ7	32	127	5.60425	95
Q61333	PF06046	157	685	4.806052930056707	528	G5AWG8	120	649	5.76120754716981	529
P48758	PF00106	6	145	2.0377428571428573	139	G5AM12	6	145	3.844749999999999	139
Q9CQV8	PF00244	10	230	5.590995475113122	220	G5BB30	11	231	5.101796380090498	220
Q80WS1	PF08443	113	301	3.9985502645502655	188	G5BPM5	114	302	4.011084656084657	188
Q61189	PF03517	34	158	3.0345039999999988	124	G5AW72	35	160	3.735222222222223	125
Q80SY3	PF01992	15	345	6.353208459214501	330	G5ATW5	16	346	7.080610271903322	330
P35288	PF00071	10	168	4.113572327044028	158	G5AKH5	11	169	4.032811320754714	158
Q9CY28	PF01926	187	227	22.369365853658532	40	G5C365	50	90	17.167975609756105	40
B2RUP2	PF00168	111	261	0.7959602649006623	150	G5BNA2	113	263	0.8005827814569537	150
B2RUP2	PF00168	924	1022	9.358070707070707	98	G5BNA2	926	1023	5.633510204081633	97
B2RUP2	PF10540	787	829	21.670790697674423	42	G5BNA2	789	831	21.561302325581398	42
B2RUP2	PF10540	829	892	0.035625000000000004	63	G5BNA2	831	894	0.001828125	63
O54972	PF01753	532	568	0.0	36	G5C2T4	506	542	0.0	36
O54972	PF07531	148	235	5.672397727272728	87	G5C2T4	126	213	6.223215909090911	87
O54972	PF08788	355	420	0.0258939393939394	65	G5C2T4	331	395	0.02638461538461538	64
Q8BVE8	PF00505	458	505	7.410458333333334	47	G5BCI4	480	527	6.6664166666666675	47
Q8BVE8	PF00855	219	330	2.1331785714285707	111	G5BCI4	243	354	2.0500446428571424	111
Q8BVE8	PF00855	879	967	4.18858426966292	88	G5BCI4	893	974	5.397426829268293	81
Q8BVE8	PF00856	1073	1179	8.111915887850468	106	G5BCI4	1080	1186	8.095028037383177	106
Q8BVE8	PF17907	1021	1059	0.0	38	G5BCI4	1028	1066	0.0	38
Q8BVE8	PF17982	1281	1326	0.0	45	G5BCI4	1288	1333	0.0	45
Q8K182	PF00057	94	129	0.0	35	G5APP6	175	210	0.0	35
Q8K182	PF00090	544	586	0.0	42	G5APP6	620	662	0.01619047619047619	42
Q8K182	PF01823	267	489	1.8777757847533632	222	G5APP6	348	568	2.1644886877828062	220
Q2KN98	PF00307	1013	1116	11.384951923076926	103	G5B626	1014	1117	11.384951923076926	103
Q8BYR2	PF00069	704	1008	3.5917737704918027	304	G5BMD1	706	1010	3.597167213114754	304
Q8BYR2	PF00627	101	137	0.8368648648648648	36	G5BMD1	103	139	0.8387297297297298	36
Q9D5E4	PF14580	91	203	6.383265486725667	112	G5BMW8	92	206	4.525939130434783	114
O55183	PF03298	6	204	4.65253266331658	198	G5B9S3	7	205	3.8214924623115554	198
Q9Z1J3	PF00266	61	422	2.418348066298342	361	G5B845	60	421	2.427513812154697	361
P24788	PF00069	429	526	11.798591836734696	97	G5ATH3	415	511	12.005793814432991	96
Q8BGC0	PF00076	135	212	0.981307692307692	77	G5ANA3	132	209	0.9805641025641024	77
Q8BGC0	PF00076	289	342	0.2508888888888889	53	G5ANA3	286	339	0.24975925925925924	53
P58196	PF03803	97	315	6.563671232876715	218	G5BME8	253	464	8.250900943396223	211
Q8BVE3	PF03224	18	341	7.684533950617293	323	G5B615	19	342	7.6844166666666744	323
Q8BVE3	PF11698	348	463	2.3719827586206894	115	G5B615	349	464	2.3719827586206894	115
P37238	PF00104	320	484	9.988060606060607	164	G5APJ1	321	485	10.272363636363636	164
P37238	PF00105	137	203	0.01455223880597015	66	G5APJ1	138	204	0.014477611940298504	66
P37238	PF12577	30	107	0.0	77	G5APJ1	31	108	0.0665897435897436	77
Q9WVL5	PF07496	481	525	1.1329999999999998	44	G5APD2	445	489	0.1848444444444444	44
Q9WVL5	PF13589	37	149	5.418637168141592	112	G5APD2	1	113	4.437176991150444	112
Q9WVL5	PF17942	326	435	7.3568545454545475	109	G5APD2	290	399	8.301690909090912	109
Q8CGF6	PF00400	659	687	14.248931034482755	28	G5BQV2	667	695	14.251137931034483	28
Q8CGF6	PF00400	745	782	23.124526315789474	37	G5BQV2	753	790	23.125421052631573	37
Q8CGF6	PF12894	787	849	1.0186666666666668	62	G5BQV2	795	857	1.0191746031746034	62
Q8CGF6	PF17814	12	39	19.83503571428572	27	G5BQV2	13	40	19.162785714285715	27
P10749	PF00340	147	263	6.057239316239319	116	G5B006	179	296	5.436779661016951	117
P10749	PF02394	0	101	11.835862745098035	101	G5B006	35	136	7.5850784313725494	101
Q9Z0M5	PF00561	78	377	6.398023333333336	299	G5B0Y6	81	380	4.963773333333337	299
Q80XI3	PF02020	1500	1577	9.688846153846152	77	G5C4X2	1504	1581	9.687576923076923	77
Q80XI3	PF02847	1216	1326	12.86126126126126	110	G5C4X2	1220	1330	6.226324324324326	110
Q80XI3	PF02854	749	975	1.272414096916301	226	G5C4X2	752	978	1.2207004405286357	226
P17950	PF05760	0	96	0.5717731958762886	96	G5BYV3	1	77	0.6557792207792208	76
Q80TS5	PF00096	145	167	0.0	22	G5C242	133	155	0.0	22
Q80TS5	PF00096	201	223	0.0	22	G5C242	189	211	0.0	22
Q80TS5	PF00096	229	251	0.0	22	G5C242	217	239	0.0	22
Q80TS5	PF00096	487	510	0.0	23	G5C242	476	499	0.0	23
Q80TS5	PF00096	699	722	0.0215	23	G5C242	688	711	2.1515	23
Q80TS5	PF00096	1128	1150	0.0	22	G5C242	1117	1139	0.0	22
Q80TS5	PF13912	448	472	0.0	24	G5C242	437	461	0.0	24
Q80TS5	PF13912	937	961	0.0	24	G5C242	926	950	0.0	24
Q80TS5	PF13912	965	990	0.4994230769230769	25	G5C242	954	979	0.4983846153846155	25
Q8BLN5	PF13243	384	720	4.2680504451038574	336	G5C7V6	324	660	5.8978130563798175	336
Q8BLN5	PF13249	87	329	9.60732098765432	242	G5C7V6	27	269	8.558374485596707	242
Q9JHD1	PF00439	712	794	0.03924096385542169	82	G5B3I6	575	657	0.09712048192771083	82
Q9JHD1	PF00583	519	602	10.638107142857141	83	G5B3I6	382	465	10.638488095238094	83
Q9JHD1	PF06466	139	307	7.726147928994081	168	G5B3I6	1	169	8.628792899408285	168
Q9CQS2	PF04135	2	51	4.6654	49	G5C2A0	3	52	5.9854199999999995	49
P49138	PF00069	72	310	5.835343096234308	238	G5BP22	181	419	6.2738702928870245	238
Q8BVA4	PF02205	567	588	6.650545454545455	21	G5B395	594	614	6.934523809523809	20
Q8BVA4	PF03250	12	87	0.0678815789473684	75	G5B395	13	87	0.06850666666666666	74
P07750	PF00727	27	139	1.6007876106194685	112	G5ASQ0	27	138	5.8699821428571415	111
Q9D967	PF12689	2	106	0.3442571428571428	104	G5B287	3	106	10.044683168316832	103
Q91YL3	PF00485	100	286	8.829491978609628	186	G5C8B3	86	272	9.170989304812835	186
Q91YL3	PF14681	328	531	6.888617647058823	203	G5C8B3	314	517	6.883480392156861	203
Q80Y20	PF00076	49	104	14.570714285714288	55	G5BV20	52	107	3.571428571428572e-05	55
Q80Y20	PF08241	411	499	6.783449438202248	88	G5BV20	414	505	9.925434782608695	91
Q80Y20	PF09004	0	36	0.0	36	G5BV20	3	39	0.14183783783783782	36
Q80Y20	PF13532	149	333	1.267637837837838	184	G5BV20	152	336	1.1248324324324328	184
Q9JIF7	PF01602	23	522	9.756719999999993	499	G5BUE3	24	523	9.757071999999992	499
Q9JIF7	PF07718	666	806	3.83772340425532	140	G5BUE3	667	807	3.83772340425532	140
Q9JIF7	PF14806	812	943	0.2736818181818181	131	G5BUE3	813	944	0.2852575757575757	131
Q7TT37	PF04762	0	954	5.207859685863878	954	G5BAD3	1	954	5.672339622641504	953
Q8BJF9	PF03357	15	184	0.0036470588235294117	169	G5C5J3	29	198	0.003588235294117647	169
Q61039	PF00010	99	150	9.103288461538463	51	G5B403	48	99	9.832057692307693	51
Q8K5B8	PF00046	212	268	0.03963157894736842	56	G5BIE7	212	268	0.03963157894736842	56
Q9CQV5	PF14955	35	166	7.8589393939393934	131	G5ASR4	54	185	7.118274809160303	131
Q8VCI0	PF04916	39	544	4.379715415019756	505	G5BV59	1	506	5.38129841897233	505
Q99N93	PF00252	61	189	4.052798449612403	128	G5AP17	62	190	1.5510465116279062	128
Q3TUL7	PF15802	31	503	7.801577167019026	472	G5BLX5	32	474	5.9420925507900675	442
Q91X58	PF01428	9	48	0.0	39	G5AKK4	10	49	0.33785	39
Q91X58	PF01428	99	136	0.0	37	G5AKK4	100	136	0.0	36
P27671	PF00169	24	128	13.838933333333335	104	G5B3N8	25	128	12.81091346153846	103
P27671	PF00169	462	586	6.538992	124	G5B3N8	459	583	6.504336	124
P27671	PF00617	1029	1207	0.993597765363129	178	G5B3N8	1034	1212	1.0781508379888272	178
P27671	PF00618	637	703	10.495298507462687	66	G5B3N8	644	710	15.012298507462685	66
P27671	PF00621	248	424	4.0211694915254235	176	G5B3N8	245	421	3.7837683615819206	176
Q8CH40	PF00293	138	256	1.6596050420168067	118	G5C797	137	255	1.8027226890756296	118
Q8CH40	PF18290	43	125	1.9945903614457832	82	G5C797	43	124	5.008475609756098	81
Q8BZ71	PF00018	248	292	6.839155555555553	44	G5BED9	247	291	5.130444444444444	44
Q8BZ71	PF00130	88	135	0.08158333333333333	47	G5BED9	84	131	0.08193750000000001	47
Q8BZ71	PF07653	306	358	0.01858490566037736	52	G5BED9	305	357	0.01867924528301887	52
Q8BZ71	PF16664	145	233	1.5758314606741568	88	G5BED9	141	232	0.4259782608695653	91
Q61412	PF00046	148	204	3.3977017543859644	56	G5C1M9	144	200	3.384649122807017	56
Q61412	PF03826	300	316	0.21852941176470586	16	G5C1M9	296	312	0.21705882352941172	16
O35137	PF00046	202	258	0.7542631578947369	56	G5AS46	103	159	0.7578596491228069	56
O35137	PF03826	374	392	0.06968421052631578	18	G5AS46	276	294	0.11694736842105265	18
Q62087	PF01731	166	251	21.420453488372107	85	G5AJS8	167	252	13.813558139534885	85
A1L0T3	PF00530	71	167	0.03809278350515464	96	G5AXC6	64	160	0.03783505154639175	96
A1L0T3	PF00530	202	298	3.5738041237113403	96	G5AXC6	195	291	1.328659793814433	96
A1L0T3	PF00530	362	453	0.07833695652173912	91	G5AXC6	351	442	0.27844565217391304	91
A1L0T3	PF00530	487	583	0.8863814432989692	96	G5AXC6	476	572	0.16911340206185566	96
Q6P1Z5	PF13839	19	147	11.07907751937985	128	G5B4S3	20	148	11.814209302325585	128
Q9D1C8	PF03997	38	183	8.897321917808219	145	G5C5S4	39	183	9.021388888888891	144
Q8VIH1	PF00046	136	192	6.383333333333334	56	G5C2P0	171	260	0.5235222222222222	89
Q3V3N7	PF14779	22	275	2.177377952755906	253	G5BWY4	23	276	2.436216535433072	253
Q9CPZ1	PF15398	0	292	1.3128395904436865	292	G5ANI2	1	293	0.5849590443686007	292
Q14CH1	PF00266	49	480	3.4075995370370364	431	G5C756	19	450	2.1267060185185187	431
Q14CH1	PF03473	719	851	2.644578947368421	132	G5C756	699	831	4.640436090225563	132
Q14CH1	PF03476	571	687	2.474572649572649	116	G5C756	552	668	1.6197863247863251	116
P50516	PF00006	229	454	7.012880530973447	225	G5AL32	230	455	7.010876106194693	225
P50516	PF02874	22	82	0.099327868852459	60	G5AL32	23	83	0.09924590163934424	60
P50516	PF16886	98	220	0.4461056910569106	122	G5AL32	99	221	0.514772357723577	122
Q149F1	PF00849	243	389	8.396469387755099	146	G5BLZ3	231	377	8.399585034013603	146
Q9CQG3	PF01753	181	211	0.0	30	G5BG02	221	251	0.0	30
Q9CQG3	PF13392	66	104	0.2407435897435897	38	G5BG02	106	144	0.2357179487179488	38
O54785	PF00412	39	67	0.7851379310344828	28	G5BBU7	51	79	0.7787241379310346	28
O54785	PF00412	71	125	0.5912181818181819	54	G5BBU7	83	137	0.6255636363636361	54
O54785	PF00595	152	235	1.872107142857143	83	G5BBU7	164	247	0.7851428571428573	83
O54785	PF07714	332	598	5.557187265917604	266	G5BBU7	344	610	5.5538089887640405	266
Q8BZ36	PF04437	303	783	9.421428274428276	480	G5BI36	274	754	9.908041580041582	480
Q3TDK6	PF10259	17	275	7.847718146718148	258	G5B2L9	18	276	7.660861003861003	258
P59644	PF03372	424	717	6.871479591836739	293	G5BBU3	430	723	6.6657755102040825	293
P59644	PF17751	737	835	11.779505050505044	98	G5BBU3	743	841	11.673585858585858	98
Q8R3Y5	PF17740	119	366	0.15427822580645156	247	G5C9Y2	129	376	0.11303225806451615	247
Q8R3Y5	PF18017	26	109	14.454428571428569	83	G5C9Y2	36	119	14.617511904761903	83
Q6KAS7	PF00096	117	139	0.0	22	G5BJR7	106	128	0.0	22
Q6KAS7	PF00096	173	195	0.0	22	G5BJR7	162	184	0.0	22
Q6KAS7	PF00096	664	685	12.672136363636366	21	G5BJR7	653	674	16.476863636363635	21
Q6KAS7	PF13912	45	67	0.03173913043478261	22	G5BJR7	34	56	0.03173913043478261	22
Q6KAS7	PF13912	435	461	0.0	26	G5BJR7	424	450	0.0	26
Q6KAS7	PF13912	633	657	0.0	24	G5BJR7	622	646	0.0	24
Q6KAS7	PF13912	692	712	13.69957142857143	20	G5BJR7	681	701	9.66119047619048	20
Q6KAS7	PF13912	929	952	0.0	23	G5BJR7	918	941	0.0	23
Q6KAS7	PF13912	957	982	0.4962692307692307	25	G5BJR7	946	971	0.4960384615384616	25
Q8CCT7	PF01189	124	331	1.306230769230769	207	G5BYY6	103	283	1.1355303867403317	180
Q62443	PF00354	231	419	7.125280423280415	188	G5BJ53	355	543	7.1106031746031695	188
A2BGH0	PF01273	220	341	6.4742213114754135	121	G5BPV7	213	334	5.4421147540983625	121
A2BGH0	PF02886	421	610	6.8069105263157885	189	G5BPV7	414	602	5.692372340425536	188
Q3V0Q1	PF08393	675	1083	2.8846601466992667	408	G5BE71	489	922	2.5987695852534567	433
Q3V0Q1	PF12774	1212	1538	7.081305810397548	326	G5BE71	1011	1337	6.9088440366972526	326
Q3V0Q1	PF12775	1849	2026	4.101876404494382	177	G5BE71	1580	1756	4.3767683615819175	176
Q3V0Q1	PF12780	2220	2291	8.81247222222222	71	G5BE71	1951	2021	8.932718309859155	70
Q3V0Q1	PF17852	1705	1840	12.571360294117644	135	G5BE71	1476	1571	13.481500000000002	95
Q3V0Q1	PF17857	2061	2152	7.907728260869565	91	G5BE71	1792	1883	1.7946956521739132	91
Q9D864	PF00022	1	393	1.6167989821882949	392	G5BBI1	2	394	1.5966641221374036	392
Q3U182	PF12884	17	55	0.0	38	G5BES1	18	56	0.0	38
Q3U182	PF12885	167	321	0.0	154	G5BES1	168	320	0.0	152
Q3U182	PF12886	613	690	0.8081923076923077	77	G5BES1	608	685	0.706974358974359	77
Q8BHH2	PF00071	8	172	7.170690909090912	164	G5BLE0	9	173	7.43421818181818	164
Q8CI70	PF00560	74	91	0.04361111111111112	17	G5B196	75	92	0.008055555555555555	17
Q8CI70	PF13855	97	155	0.0	58	G5B196	98	156	0.0	58
Q9R0B6	PF00052	548	682	3.7355111111111103	134	G5AT58	481	615	0.6619629629629625	134
Q9R0B6	PF00053	279	327	0.0	48	G5AT58	213	261	0.0	48
Q9R0B6	PF00053	335	383	0.0	48	G5AT58	269	316	0.0	47
Q9R0B6	PF00053	391	435	0.0	44	G5AT58	325	369	0.0	44
Q9R0B6	PF00053	438	485	0.0	47	G5AT58	372	419	0.0	47
Q9R0B6	PF00053	683	704	0.19899999999999998	21	G5AT58	616	637	0.0	21
Q9R0B6	PF00053	718	755	0.01631578947368421	37	G5AT58	651	687	0.0	36
Q9R0B6	PF00053	766	813	0.0	47	G5AT58	699	746	0.0	47
Q9R0B6	PF00053	821	865	0.14911111111111108	44	G5AT58	754	798	0.0	44
Q9R0B6	PF00053	877	924	0.0	47	G5AT58	810	858	0.0	48
Q9R0B6	PF00053	927	968	2.5869999999999997	41	G5AT58	861	902	1.4161904761904762	41
Q9R0B6	PF00053	975	1020	0.04065217391304348	45	G5AT58	909	954	0.029521739130434783	45
Q9R0B6	PF00055	67	277	2.254445497630332	210	G5AT58	1	211	2.0852085308056867	210
P52430	PF01731	167	252	8.831593023255811	85	G5ANL3	163	248	17.90663953488372	85
Q4QRL3	PF19047	93	182	0.6256999999999999	89	G5B6P6	90	179	0.9864666666666668	89
O55188	PF07263	0	502	1.7729900596421468	502	G5BSU5	1	497	1.5637701612903223	496
P0C0A3	PF03357	18	176	0.0210062893081761	158	G5BJ56	19	177	0.018566037735849056	158
Q91YT0	PF01512	79	248	1.9207941176470589	169	G5BTW5	81	250	1.9215117647058837	169
Q91YT0	PF10531	276	324	0.21342857142857144	48	G5BTW5	278	326	0.21087755102040814	48
Q91YT0	PF10589	365	447	0.12201204819277107	82	G5BTW5	367	449	0.12022891566265062	82
P63073	PF01652	95	194	3.6293499999999983	99	G5BSJ9	26	125	3.786769999999999	99
Q5EE38	PF10341	10	117	3.4750648148148144	107	G5C667	11	118	2.530296296296296	107
P11531	PF00307	15	118	7.58475	103	G5B864	5	108	7.595067307692308	103
P11531	PF00307	135	238	12.330423076923076	103	G5B864	125	228	12.567990384615385	103
P11531	PF00397	3051	3078	0.0	27	G5B864	3049	3076	0.0	27
P11531	PF00435	342	447	1.0612641509433964	105	G5B864	335	440	2.242264150943396	105
P11531	PF00435	451	556	5.7375471698113225	105	G5B864	444	549	4.721490566037737	105
P11531	PF00435	725	828	0.07735576923076923	103	G5B864	718	820	0.015194174757281553	102
P11531	PF00435	834	934	4.208079207920792	100	G5B864	826	926	2.2682475247524763	100
P11531	PF00435	944	1046	0.02645631067961165	102	G5B864	936	1038	0.17202912621359215	102
P11531	PF00435	1049	1154	0.0	105	G5B864	1041	1146	0.0	105
P11531	PF00435	1163	1264	0.049745098039215695	101	G5B864	1155	1256	0.5066176470588236	101
P11531	PF00435	1573	1676	0.5632211538461539	103	G5B864	1573	1668	0.6613645833333334	95
P11531	PF00435	1680	1777	0.01864285714285715	97	G5B864	1672	1769	0.16464285714285715	97
P11531	PF00435	1878	1980	0.011650485436893204	102	G5B864	1870	1972	0.0	102
P11531	PF00435	2106	2209	0.07696153846153846	103	G5B864	2098	2201	0.11183653846153847	103
P11531	PF00435	2214	2316	3.04366990291262	102	G5B864	2206	2310	2.516142857142857	104
P11531	PF00435	2465	2569	0.3549428571428571	104	G5B864	2459	2563	0.3551904761904763	104
P11531	PF00435	2576	2678	0.057504854368932	102	G5B864	2570	2676	3.1865607476635525	106
P11531	PF00435	2682	2792	1.6670270270270269	110	G5B864	2680	2790	3.0533333333333337	110
P11531	PF00435	2927	3032	0.6795943396226416	105	G5B864	2925	3030	0.05715094339622642	105
P11531	PF00569	3300	3344	0.033222222222222215	44	G5B864	3298	3342	0.033222222222222215	44
P11531	PF09068	3082	3199	5.056686440677964	117	G5B864	3080	3197	5.058491525423725	117
P11531	PF09069	3203	3294	0.5470217391304348	91	G5B864	3201	3292	0.5473260869565219	91
Q8CGD2	PF00188	65	205	3.7124397163120566	140	G5BN26	66	206	3.7091205673758862	140
Q8CGD2	PF03815	292	383	0.0959891304347826	91	G5BN26	293	384	0.09584782608695652	91
Q8CGD2	PF03815	393	487	0.11984210526315787	94	G5BN26	394	488	0.06010526315789474	94
Q78T81	PF10358	5	151	5.044727891156463	146	G5BLF6	6	152	5.0404557823129235	146
P23116	PF01399	365	493	1.5411937984496125	128	G5BVV5	366	494	1.1332790697674413	128
Q62447	PF00134	36	147	13.277741071428574	111	G5BJP2	37	148	13.629839285714285	111
P59997	PF17811	303	340	16.389605263157893	37	G5BSB7	304	341	18.20084210526316	37
P59997	PF00646	894	932	7.784256410256412	38	G5BSB7	896	934	7.7772051282051295	38
P59997	PF02008	564	608	0.0	44	G5BSB7	565	609	0.0	44
P59997	PF16866	613	675	0.0	62	G5BSB7	614	676	0.0	62
P70186	PF13855	151	202	0.0	51	G5BSJ3	152	203	0.0	51
O89084	PF00233	417	658	3.289103305785127	241	G5BUG9	370	611	3.2854256198347103	241
O89084	PF18100	172	256	0.475858823529412	84	G5BUG9	116	199	0.4824880952380952	83
P98078	PF00640	69	173	5.564761904761905	104	G5AND9	70	174	5.4080666666666675	104
P33435	PF00413	112	267	4.182410256410258	155	G5BUC9	112	267	3.656608974358973	155
P33435	PF00045	290	331	0.07654761904761903	41	G5BUC9	290	331	0.07726190476190478	41
P33435	PF00045	334	376	10.50825581395349	42	G5BUC9	334	376	0.15890697674418605	42
P33435	PF00045	383	428	1.0841304347826088	45	G5BUC9	383	428	0.2942173913043479	45
P33435	PF00045	431	466	13.58769444444444	35	G5BUC9	431	466	13.595138888888883	35
P33435	PF01471	38	91	0.22762962962962965	53	G5BUC9	38	91	0.08703703703703702	53
Q80VW5	PF00595	142	216	8.897093333333334	74	G5B1Y9	181	255	7.838373333333334	74
Q80VW5	PF00595	286	356	8.78825352112676	70	G5B1Y9	325	395	8.50169014084507	70
Q80VW5	PF00595	830	896	0.8387611940298507	66	G5B1Y9	854	920	0.8860597014925375	66
Q7TNF9	PF15388	85	396	1.1629294871794875	311	G5C4P7	53	333	1.3107793594306043	280
O35652	PF00046	246	302	3.861192982456141	56	G5AQ88	218	274	3.843315789473684	56
O35652	PF00412	95	151	0.6803508771929827	56	G5AQ88	67	123	0.5100175438596493	56
O35652	PF00412	156	210	3.931745454545454	54	G5AQ88	128	182	3.909672727272728	54
Q8BW74	PF07716	223	276	0.0	53	G5BPA3	224	277	0.0	53
Q7M6Y5	PF17045	11	278	0.040044776119402985	267	G5C3Y3	12	279	0.08614925373134327	267
Q8C0D7	PF12998	5	106	0.0391372549019608	101	G5CAQ2	6	107	0.030990196078431374	101
Q9JHH6	PF00246	127	407	3.911234875444839	280	G5C1E5	35	314	4.231685714285712	279
Q8BFP9	PF02518	267	387	4.539512396694216	120	G5ALR0	352	472	4.510578512396693	120
Q8BFP9	PF10436	55	216	1.6402469135802469	161	G5ALR0	122	301	5.1885	179
Q9JMF3	PF00631	4	66	0.0	62	G5BXU6	5	67	0.0	62
P16301	PF02450	80	406	2.693639143730888	326	G5C682	79	405	4.580348623853207	326
Q3TES0	PF01369	654	842	9.027497354497354	188	G5BWQ4	569	757	9.028698412698414	188
Q3TES0	PF16453	863	999	8.466795620437953	136	G5BWQ4	778	914	8.194802919708028	136
Q8R2Q0	PF00643	220	258	4.020974358974359	38	G5BHQ0	218	256	4.025641025641025	38
Q8BFU0	PF15913	39	140	4.008382352941177	101	G5AZ89	97	198	3.8557352941176464	101
Q9JLM8	PF00069	405	662	10.110294573643413	257	G5B3M7	149	406	10.812069767441864	257
Q9JLM8	PF03607	241	262	1.2459999999999998	21	G5B3M7	1	22	1.1697727272727272	21
O35451	PF00170	320	381	0.33246774193548384	61	G5C3H8	324	385	0.33419354838709675	61
Q9JI48	PF04749	22	100	3.558291139240508	78	G5AT17	24	102	7.246696202531647	78
Q9JIX8	PF02037	71	105	0.04294285714285714	34	G5ASK3	28	62	0.056114285714285714	34
Q9JIX8	PF16294	1199	1235	0.4128648648648649	36	G5ASK3	1099	1134	0.41991666666666666	35
Q9QXY9	PF04882	7	95	13.657674157303369	88	G5BL56	8	96	13.62711235955056	88
Q9QXY9	PF04882	96	145	30.9594	49	G5BL56	97	145	31.586061224489804	48
Q9QXY9	PF04882	158	360	2.3903743842364533	202	G5BL56	159	361	2.7030147783251213	202
Q9D8M4	PF00327	87	137	11.777450980392153	50	G5BNK3	86	136	5.816588235294117	50
Q9D8M4	PF08079	12	82	0.0	70	G5BNK3	9	81	0.0402054794520548	72
P63046	PF00685	79	275	5.241340101522843	196	G5ALW1	1	197	5.279152284263958	196
P70379	PF00167	71	196	7.090706349206347	125	G5C8F3	8	133	7.106769841269842	125
Q3ULD5	PF01039	74	552	4.394584551148227	478	G5C0H5	75	556	4.8577966804979225	481
P12849	PF00027	160	235	2.0486578947368432	75	G5AZ14	161	236	2.0721447368421058	75
P12849	PF00027	273	358	5.484767441860464	85	G5AZ14	274	359	5.431976744186048	85
P12849	PF02197	24	60	5.63545945945946	36	G5AZ14	25	61	3.7814864864864863	36
Q9D7J9	PF00378	51	298	4.664568548387097	247	G5BBE8	52	299	3.5559919354838696	247
Q08642	PF03068	291	669	2.8471635883905013	378	G5BZN5	284	662	2.7940765171503936	378
Q08642	PF08526	8	121	4.891657894736842	113	G5BZN5	1	114	5.15092105263158	113
Q08642	PF08527	123	281	11.830855345911953	158	G5BZN5	116	274	10.421144654088042	158
Q8BH82	PF12706	143	343	3.4762835820895512	200	G5BI53	150	350	4.018646766169154	200
Q8CF25	PF11771	121	277	8.623445859872612	156	G5BYT6	93	249	5.866464968152866	156
Q9Z1R2	PF00240	18	86	0.8791884057971014	68	G5C3E8	19	87	0.8328840579710143	68
Q9Z1R2	PF12057	289	390	2.603705882352942	101	G5C3E8	265	366	2.5939803921568623	101
Q8R1S0	PF01494	201	324	1.9823870967741943	123	G5C1N4	195	297	4.364786407766992	102
Q8R1S0	PF01494	342	432	0.6122857142857148	90	G5C1N4	315	405	0.6194175824175822	90
Q6PDG8	PF19036	156	278	23.459398373983746	122	G5BZY0	185	307	23.48466666666667	122
Q6PDG8	PF19037	317	413	15.871505154639163	96	G5BZY0	346	442	16.26222680412372	96
Q6PDG8	PF19038	445	544	4.110000000000002	99	G5BZY0	474	573	4.13191	99
Q8BMU0	PF00096	194	218	0.0	24	G5BCF1	195	219	0.0	24
Q8BMU0	PF00096	224	248	0.0	24	G5BCF1	225	249	0.0	24
Q8BMU0	PF00096	284	308	0.0	24	G5BCF1	285	309	0.0	24
Q8BMU0	PF00096	344	367	0.0	23	G5BCF1	345	368	0.0	23
Q9D7H4	PF15063	2	71	0.2700714285714285	69	G5C0B6	3	70	0.18432352941176472	67
Q9JHC9	PF00178	209	288	0.6064125	79	G5BTT8	210	289	0.5775125000000001	79
Q9JHC9	PF12310	3	107	0.8742476190476189	104	G5BTT8	4	108	0.8141047619047619	104
Q9D8P7	PF10419	28	116	0.536179775280899	88	G5ARK4	26	114	0.6594157303370787	88
Q68ED3	PF01909	159	267	2.9717522935779828	108	G5C246	126	234	2.9698715596330287	108
Q68ED3	PF03828	321	380	3.90135	59	G5C246	288	347	3.8692333333333337	59
Q9D404	PF00109	41	290	4.221191999999999	249	G5BFA0	44	293	3.64784	249
Q9D404	PF02801	298	412	0.6362173913043477	114	G5BFA0	301	415	1.6643130434782611	114
Q8BJR6	PF00089	44	274	4.4950692640692615	230	G5AQC5	1	231	4.481493506493508	230
Q8VEJ9	PF00004	162	292	3.534931297709924	130	G5AK48	157	287	3.452305343511449	130
Q8VEJ9	PF04212	6	70	0.3251538461538461	64	G5AK48	1	65	0.34167692307692304	64
Q8VEJ9	PF09336	373	433	0.0	60	G5AK48	368	428	0.0	60
Q8VEJ9	PF17862	315	349	8.701285714285715	34	G5AK48	310	344	8.707	34
Q9WTX7	PF00412	40	95	0.0	55	G5BQD1	40	95	0.0	55
Q9WTX7	PF00412	101	158	0.01603448275862069	57	G5BQD1	101	158	0.0	57
Q9WTX7	PF00412	162	215	0.061092592592592615	53	G5BQD1	162	215	0.8321111111111109	53
Q9WTX7	PF00412	221	275	0.4553090909090909	54	G5BQD1	221	275	0.2595090909090909	54
Q9Z0F4	PF13499	108	176	0.08652173913043479	68	G5CAA7	121	189	0.10885507246376812	68
P97303	PF00651	26	131	6.54031132075472	105	G5C8Z5	27	132	6.5035566037735855	105
P97303	PF03131	616	693	0.09032051282051283	77	G5C8Z5	618	695	0.09032051282051283	77
Q8K1E6	PF13532	153	274	2.4183524590163925	121	G5AS40	64	191	1.3966406250000003	127
Q80XH1	PF10241	13	98	2.329069767441861	85	G5C5A5	14	99	2.671337209302325	85
Q8BPQ7	PF00566	878	1048	19.00533918128655	170	G5BGN5	925	1095	16.561918128654963	170
Q8BPQ7	PF02759	43	186	5.741548611111112	143	G5BGN5	89	232	5.621840277777778	143
Q8BPQ7	PF12068	254	390	6.390364963503648	136	G5BGN5	300	436	3.982642335766424	136
Q80UE6	PF00069	175	428	2.604137795275593	253	G5CA00	87	340	2.6046850393700782	253
Q80UE6	PF12202	449	511	3.587253968253969	62	G5CA00	361	424	3.5392500000000005	63
Q9QZ25	PF00795	54	217	7.050036585365848	163	G5BDQ8	30	193	8.775993902439026	163
Q9QZ25	PF19018	337	487	5.77341059602649	150	G5BDQ8	314	464	5.1971920529801325	150
Q91VA6	PF04379	254	336	0.09386746987951808	82	G5BVN6	211	293	0.10468674698795184	82
Q91VA6	PF08755	75	199	2.879296	124	G5BVN6	32	156	2.9267679999999987	124
Q80V23	PF00096	75	97	0.0	22	G5BX01	77	99	0.0	22
Q80V23	PF00096	103	125	0.0	22	G5BX01	105	127	0.0	22
Q80V23	PF00096	131	153	0.0	22	G5BX01	133	155	0.0	22
Q80V23	PF00096	159	181	0.0	22	G5BX01	161	183	0.0	22
Q80V23	PF00096	187	209	0.21	22	G5BX01	189	211	0.21	22
Q80V23	PF00096	243	264	0.0	21	G5BX01	245	266	0.0	21
Q99N92	PF01016	30	100	0.15274647887323944	70	G5C4J4	31	101	0.1528169014084507	70
O54825	PF05291	142	428	6.14441463414634	286	G5BNI9	143	429	4.972756097560974	286
Q6KAR6	PF06046	186	741	8.0609190647482	555	G5BPH1	177	732	7.3821025179856194	555
Q80ZQ9	PF01597	122	182	6.481688524590162	60	G5BAD2	111	170	6.554699999999999	59
Q61092	PF00052	249	379	1.684045801526718	130	G5B450	312	442	1.6038091603053442	130
Q61092	PF00053	27	80	0.0	53	G5B450	91	144	0.0	53
Q61092	PF00053	83	127	0.0	44	G5B450	147	191	0.0	44
Q61092	PF00053	138	183	0.0	45	G5B450	202	247	0.0	45
Q61092	PF00053	381	404	0.0	23	G5B450	444	467	0.0	23
Q61092	PF00053	461	503	0.0	42	G5B450	524	566	0.0	42
Q61092	PF00053	516	569	0.14285185185185187	53	G5B450	579	632	0.0	53
Q61092	PF00053	572	603	0.0	31	G5B450	635	666	0.0	31
O35739	PF00096	142	166	0.0	24	G5AVH1	143	167	0.0	24
O35739	PF00096	172	196	0.0	24	G5AVH1	173	197	0.0	24
O35739	PF00096	202	224	0.0	22	G5AVH1	203	225	0.0	22
P62301	PF00312	74	145	0.24415277777777775	71	G5B0I4	75	146	0.253625	71
P62301	PF08069	0	59	4.793400000000001	59	G5B0I4	1	60	4.793400000000001	59
O08900	PF00096	144	166	0.0	22	G5BRX7	170	192	0.0	22
O08900	PF00096	200	219	0.0	19	G5BRX7	226	245	0.0	19
Q9DAI6	PF05057	1133	1326	4.9825979381443295	193	G5C6R7	1137	1330	4.993855670103093	193
Q9DAI6	PF12394	110	171	11.840290322580648	61	G5C6R7	111	172	11.801887096774195	61
P97391	PF00068	21	126	0.2208679245283018	105	G5C4W0	40	145	0.2087735849056603	105
P58058	PF01513	114	403	4.157237931034485	289	G5ATH5	189	484	3.563898648648653	295
P99025	PF06399	1	83	4.917012048192771	82	G5BLZ8	2	84	4.956048780487804	82
Q8C015	PF00069	453	699	5.8401255060728765	246	G5BAR5	442	688	6.309283400809719	246
Q8C015	PF00786	9	61	0.0	52	G5BAR5	10	62	0.0	52
P03966	PF00010	379	431	0.2249622641509434	52	G5BI56	342	394	0.22745283018867926	52
P03966	PF01056	8	369	1.142522099447514	361	G5BI56	1	332	1.2530331325301205	331
Q8BFR5	PF00009	54	247	5.721685567010309	193	G5BRD5	55	261	5.4107004830917855	206
Q8BFR5	PF03143	344	438	4.473484210526316	94	G5BRD5	358	451	4.54513829787234	93
Q8BFR5	PF03144	271	338	2.439000000000001	67	G5BRD5	285	352	2.2994558823529405	67
Q3UW21	PF15083	48	96	0.0	48	G5BEW6	1	49	0.11663265306122447	48
P52633	PF00017	537	615	10.787620253164556	78	G5BB56	538	616	7.29774683544304	78
P52633	PF01017	175	244	0.14098571428571427	69	G5BB56	176	245	0.1621857142857143	69
P52633	PF02864	276	412	7.507321167883211	136	G5BB56	277	413	7.678598540145986	136
P52633	PF02865	1	111	0.5283963963963964	110	G5BB56	2	112	0.8300630630630631	110
P52633	PF14596	654	836	0.0	182	G5BB56	655	838	0.0	183
Q9JHP7	PF00630	27	125	0.3048181818181819	98	G5B9M5	28	126	4.799717171717169	98
Q9JHP7	PF05686	149	483	5.958737313432839	334	G5B9M5	150	484	5.925232835820893	334
Q8K411	PF00675	95	176	2.2634024390243903	81	G5B6T4	96	177	2.359829268292683	81
Q8K411	PF05193	244	426	4.977131147540984	182	G5B6T4	245	427	3.0753715846994525	182
Q8K411	PF05193	790	954	2.799181818181818	164	G5B6T4	791	951	3.416316770186336	160
Q8K411	PF08367	503	751	1.147807228915663	248	G5B6T4	504	752	2.1043293172690776	248
Q62252	PF00612	117	131	0.0	14	G5C497	102	116	0.0	14
Q62252	PF02197	13	50	3.151157894736842	37	G5C497	14	51	1.5680263157894736	37
Q8C6B2	PF08174	116	269	5.031110389610389	153	G5AXF8	117	270	5.569519480519482	153
Q8C569	PF13289	157	299	5.8298531468531465	142	G5AXW5	158	300	5.632685314685316	142
Q91WD4	PF07000	247	407	5.906403726708075	160	G5BJZ5	248	408	7.127534161490682	160
Q91WD4	PF18474	0	216	4.279539170506913	216	G5BJZ5	1	216	3.709092592592591	215
P62257	PF00179	29	143	1.902069565217392	114	G5BH82	12	126	1.6404347826086958	114
Q4JIM5	PF07714	287	537	10.211099601593633	250	G5C7J7	252	502	10.208087649402394	250
Q4JIM5	PF00017	172	247	3.824315789473684	75	G5C7J7	137	212	3.7900526315789467	75
Q4JIM5	PF00018	112	158	7.082553191489363	46	G5C7J7	77	123	5.23691489361702	46
Q4JIM5	PF08919	1082	1181	0.03783	99	G5C7J7	1042	1141	0.03816161616161616	99
Q8JZS9	PF00338	90	184	0.2540000000000001	94	G5ASA1	85	179	0.2306315789473685	94
Q76LW6	PF03045	85	181	4.241103092783504	96	G5BYV8	88	183	3.781770833333333	95
A2AR50	PF00169	461	570	13.2731	109	G5BLH6	433	542	8.572563636363636	109
A2AR50	PF00617	52	217	6.823897590361445	165	G5BLH6	53	218	6.832222891566267	165
Q9JJZ5	PF00629	398	540	2.5168741258741267	142	G5BKY5	413	555	3.0686853146853155	142
Q9JJZ5	PF07645	91	122	0.0	31	G5BKY5	104	134	0.0	30
Q9JJZ5	PF07645	171	204	0.02435294117647059	33	G5BKY5	184	217	0.0	33
Q9JJZ5	PF07645	216	254	0.0	38	G5BKY5	229	267	0.0	38
Q6A4J8	PF00443	214	518	5.876485245901638	304	G5BSC6	229	533	6.199563934426227	304
Q6A4J8	PF00917	76	195	1.4826916666666663	119	G5BSC6	91	210	1.4809749999999997	119
Q6A4J8	PF12436	620	865	6.097731707317075	245	G5BSC6	635	880	6.158987804878049	245
Q6A4J8	PF14533	903	1068	4.846024096385542	165	G5BSC6	892	1068	5.874796610169492	176
Q9CY52	PF04446	34	163	13.419292307692304	129	G5BKW7	35	164	9.60126153846154	129
Q9CY52	PF14413	166	281	8.111120689655175	115	G5BKW7	167	282	7.8726637931034515	115
O35593	PF01398	27	137	7.935792792792793	110	G5BT32	28	138	7.9358378378378385	110
O35593	PF13012	172	295	0.414717741935484	123	G5BT32	173	296	0.4528870967741937	123
P60879	PF00835	90	140	0.018823529411764704	50	G5B2B3	91	141	0.018980392156862744	50
Q8BSN5	PF00628	339	383	0.8250444444444448	44	G5B5A4	343	387	0.6445333333333332	44
Q8BR07	PF09730	73	798	0.5365647382920111	725	G5BW58	4	729	0.6899504132231401	725
Q571E5	PF00089	44	266	3.011565022421524	222	G5BYC7	45	268	2.086495535714286	223
Q571E5	PF00089	312	519	11.531567307692304	207	G5BYC7	314	511	7.648333333333337	197
Q5U4E2	PF00096	110	132	22.51221739130435	22	G5AML0	173	195	22.158434782608694	22
Q5U4E2	PF00096	140	160	0.0	20	G5AML0	203	223	0.0	20
Q5U4E2	PF00096	171	193	0.0	22	G5AML0	234	256	0.0	22
Q5U4E2	PF00096	256	278	0.0	22	G5AML0	321	343	0.0	22
Q5U4E2	PF00096	284	306	0.0	22	G5AML0	349	371	0.0	22
Q5U4E2	PF00096	380	402	0.0	22	G5AML0	460	482	0.0	22
Q5U4E2	PF00096	408	430	0.0	22	G5AML0	488	510	0.0	22
Q5U4E2	PF00096	436	458	0.0	22	G5AML0	516	538	0.0	22
Q5U4E2	PF00096	464	486	0.0	22	G5AML0	544	566	0.0	22
Q5U4E2	PF00096	492	514	0.0	22	G5AML0	572	594	0.0	22
Q91VH6	PF01875	20	291	1.9304889705882344	271	G5B3Y8	1	272	1.9419816176470597	271
Q8VE38	PF00175	172	291	4.552908333333335	119	G5BMH7	174	293	4.009408333333334	119
Q9DAD0	PF12494	30	122	0.08473118279569891	92	G5BQV5	31	126	0.6110104166666667	95
O89050	PF01344	466	492	5.668518518518519	26	G5C7Z6	474	500	5.670222222222222	26
O89050	PF06588	11	206	2.833836734693877	195	G5C7Z6	12	207	2.8340714285714284	195
O89050	PF13415	282	332	8.385647058823531	50	G5C7Z6	283	340	7.3751724137931065	57
Q99L27	PF00478	9	338	0.6047636363636366	329	G5B285	10	339	0.5911060606060611	329
P23506	PF01135	8	220	0.856230046948357	212	G5BMD3	67	330	1.476181818181818	263
Q920B9	PF00557	181	410	2.9736826086956523	229	G5BFV3	182	411	3.0098956521739133	229
Q920B9	PF08512	812	893	8.09960975609756	81	G5BFV3	813	894	8.09960975609756	81
Q920B9	PF08644	528	688	1.2102732919254655	160	G5BFV3	529	689	1.2102732919254655	160
Q920B9	PF14826	4	165	9.07366666666667	161	G5BFV3	5	166	9.640888888888886	161
O70583	PF00041	394	483	3.0410777777777773	89	G5B655	395	471	4.68638961038961	76
O70583	PF00622	552	666	6.115565217391306	114	G5B655	540	654	11.23466086956521	114
O70583	PF00643	173	209	2.698108108108108	36	G5B655	174	210	2.713027027027027	36
O70583	PF13445	9	56	0.0	47	G5B655	10	57	0.0	47
O70583	PF18568	322	373	0.028557692307692305	51	G5B655	323	374	0.028557692307692305	51
P55050	PF00061	4	130	0.06307874015748031	126	G5CAX0	5	131	0.3215196850393702	126
O35385	PF00149	173	308	12.424110294117648	135	G5C139	159	294	12.441058823529415	135
O35385	PF08321	99	161	8.055793650793651	62	G5C139	84	147	0.383546875	63
O35385	PF13499	658	725	0.1908235294117647	67	G5C139	601	668	0.2350294117647059	67
Q9QYS1	PF00110	51	363	5.087747603833868	312	G5BNQ8	52	330	6.963057553956837	278
O08810	PF00009	127	376	4.976835999999998	249	G5BJ06	129	378	5.045259999999999	249
O08810	PF00679	824	912	9.491382022471909	88	G5BJ06	826	914	9.49329213483146	88
O08810	PF03144	489	564	1.0060657894736846	75	G5BJ06	491	566	1.0059736842105265	75
O08810	PF03764	705	821	6.423752136752138	116	G5BJ06	707	823	6.216273504273503	116
O08810	PF14492	584	646	0.06958730158730159	62	G5BJ06	586	648	0.06676190476190477	62
O08810	PF16004	3	108	0.0011132075471698114	105	G5BJ06	4	110	0.0	106
Q80YG3	PF07646	195	234	0.400975	39	G5B966	195	234	0.038749999999999986	39
Q80YG3	PF13418	70	121	3.2632307692307694	51	G5B966	70	121	4.026115384615384	51
Q80YG3	PF13418	247	293	6.908191489361702	46	G5B966	247	293	6.902893617021281	46
Q80YG3	PF13854	11	53	17.24072093023256	42	G5B966	12	53	12.30254761904762	41
P50580	PF00557	24	227	2.771107843137255	203	G5BB88	1	204	0.9342254901960788	203
P22091	PF00010	187	238	0.2375384615384615	51	G5BI95	57	108	0.2631730769230769	51
Q8BVF4	PF15742	170	546	0.007334217506631298	376	G5AQI5	226	602	0.038628647214854116	376
P58459	PF00090	550	600	0.0	50	G5B4L2	793	843	0.0	50
P58459	PF01421	238	456	11.306219178082204	218	G5B4L2	364	605	9.18329752066115	241
P58459	PF01562	39	179	0.3478652482269504	140	G5B4L2	165	305	0.8618865248226952	140
P58459	PF05986	706	817	6.1304910714285725	111	G5B4L2	949	1060	5.9630625	111
P58459	PF08686	1069	1101	0.0	32	G5B4L2	1307	1339	0.0	32
P58459	PF17771	490	536	0.42393617021276603	46	G5B4L2	733	779	0.44	46
P58459	PF19030	828	883	0.0	55	G5B4L2	1071	1126	0.0	55
P58459	PF19030	887	943	0.2097368421052632	56	G5B4L2	1130	1186	0.18012280701754385	56
P58459	PF19030	947	1001	0.0	54	G5B4L2	1190	1244	0.06163636363636363	54
P58459	PF19030	1006	1055	0.0	49	G5B4L2	1249	1294	0.0	45
Q8CEC6	PF00160	495	643	5.8610000000000015	148	G5B0E6	426	574	6.329812080536914	148
Q8CEC6	PF00400	133	160	1.945071428571429	27	G5B0E6	64	91	2.263357142857143	27
Q8CEC6	PF00400	283	306	0.12270833333333332	23	G5B0E6	214	237	0.11433333333333333	23
O09100	PF00320	294	327	0.0	33	G5BII6	295	328	0.0	33
O09100	PF00320	348	381	0.0	33	G5BII6	349	382	0.0	33
Q9CXF7	PF00176	55	320	7.684669172932329	265	G5BA07	33	298	9.765917293233084	265
Q9CXF7	PF00271	356	452	10.00416494845361	96	G5BA07	327	423	10.011278350515463	96
Q91WS2	PF02758	23	42	0.0	19	G5C470	26	44	4.530263157894737	18
Q91WS2	PF17776	498	632	6.017066666666667	134	G5C470	164	297	7.183932835820893	133
Q91WS2	PF17779	443	494	1.3153461538461544	51	G5C470	111	160	6.22058	49
P53995	PF01851	1466	1497	4.14778125	31	G5BQY8	1465	1496	6.97415625	31
P53995	PF12859	149	198	2.6147600000000013	49	G5BQY8	150	198	1.9078367346938772	48
P53995	PF18122	1735	1894	8.254931249999998	159	G5BQY8	1734	1893	8.3261625	159
O35955	PF00227	36	216	3.5100939226519308	180	G5C681	37	217	4.629287292817678	180
O35955	PF12465	230	266	0.0	36	G5C681	231	267	0.7971621621621622	36
Q9Z0S1	PF00459	12	301	5.965868965517241	289	G5AQT0	156	445	7.004827586206898	289
Q9WV35	PF18778	45	222	8.857971910112363	177	G5BNG8	50	227	8.69111235955056	177
Q3UX83	PF00155	205	565	5.982368421052627	360	G5AS43	51	416	6.4942459016393475	365
P52432	PF01000	91	225	1.7050296296296292	134	G5BNM8	92	226	1.980992592592592	134
P52432	PF01193	61	90	2.0383	29	G5BNM8	62	91	3.0781333333333336	29
Q6P549	PF00536	1200	1253	0.0	53	G5AVT8	1361	1414	0.0	53
Q6P549	PF00017	20	101	11.386804878048782	81	G5AVT8	35	116	11.428414634146339	81
Q6P549	PF03372	429	718	3.3584482758620715	289	G5AVT8	582	872	2.97669759450172	290
Q6ZWV3	PF00252	16	164	0.2433020134228188	148	G5BFK5	1	149	0.2448590604026845	148
Q8BWQ4	PF01728	111	319	8.346220095693784	208	G5C1Q5	112	320	9.533172248803828	208
Q9D8U3	PF13848	63	249	5.688925133689837	186	G5BV46	66	252	6.899989304812832	186
Q8BZL1	PF13088	34	257	5.561540178571437	223	G5C3S7	35	258	5.805205357142852	223
Q8C4V1	PF00169	87	121	0.9239714285714288	34	G5C949	5	39	0.9193142857142859	34
Q8C4V1	PF00620	150	298	1.1390536912751676	148	G5C949	68	216	0.9368724832214764	148
Q9D1N2	PF00021	62	135	5.441202702702702	73	G5AWG1	65	138	3.933027027027027	73
Q9DB77	PF00675	48	193	1.2056095890410954	145	G5BV89	49	194	3.2867328767123283	145
Q9DB77	PF05193	198	377	3.1060888888888885	179	G5BV89	199	378	3.2114055555555554	179
Q8CFD4	PF00787	93	171	2.5138987341772148	78	G5BI83	46	124	1.330253164556962	78
Q9CPR5	PF00828	49	173	2.5474559999999995	124	G5B611	51	175	3.6801760000000003	124
Q5SXI5	PF00096	460	482	0.0	22	G5C9A7	358	380	0.03565217391304347	22
Q5SXI5	PF00096	519	540	0.0	21	G5C9A7	476	496	0.0	20
Q5SXI5	PF00096	550	572	0.0	22	G5C9A7	358	380	0.03565217391304347	22
Q5SXI5	PF01352	221	246	3.8608461538461536	25	G5C9A7	234	259	3.8836153846153847	25
Q5SXI5	PF02023	37	124	0.19868181818181813	87	G5C9A7	18	105	0.5607954545454548	87
Q8CFC7	PF09750	39	168	0.7858615384615382	129	G5CBM0	40	159	0.8333416666666668	119
Q8JZP9	PF00307	64	146	9.095325301204817	82	G5APX2	1	83	12.350807228915665	82
Q8JZP9	PF02187	207	275	7.68544927536232	68	G5APX2	144	212	7.679246376811595	68
Q8C341	PF07738	321	449	6.923922480620153	128	G5C7M6	269	390	7.4089836065573795	121
Q6ZPF4	PF02181	561	925	3.8081698630137013	364	G5AU14	562	933	4.613056451612906	371
Q6ZPF4	PF06367	280	471	6.664067708333335	191	G5AU14	281	472	6.660020833333338	191
Q6ZPF4	PF06371	27	143	3.9802820512820505	116	G5AU14	28	144	3.9885897435897446	116
Q6ZPF4	PF06371	220	277	16.922344827586205	57	G5AU14	221	278	18.38024137931034	57
Q9Z1X9	PF02724	18	387	8.059710810810815	369	G5CA14	19	405	8.051418604651158	386
Q9Z1X9	PF02724	388	561	2.133143678160921	173	G5CA14	406	579	4.179804597701152	173
Q8BH44	PF00400	84	114	0.046258064516129016	30	G5C6S8	80	110	0.046258064516129016	30
Q8BH44	PF00400	169	205	3.6501891891891898	36	G5C6S8	165	201	3.6482162162162166	36
Q8BH44	PF08953	11	74	8.273234375	63	G5C6S8	7	70	8.272843749999998	63
Q8BH44	PF16300	349	391	0.05281395348837208	42	G5C6S8	345	387	0.14923255813953487	42
P46099	PF00096	274	298	0.0	24	G5BYW4	271	295	0.0	24
P46099	PF00096	304	328	0.079	24	G5BYW4	301	325	0.06336	24
P46099	PF00096	334	356	0.0	22	G5BYW4	331	353	0.0	22
P46099	PF16832	21	39	0.06568421052631579	18	G5BYW4	22	39	0.06966666666666667	17
P46099	PF16833	62	83	0.6052272727272725	21	G5BYW4	65	85	0.043809523809523805	20
P0DPE0	PF08241	62	171	5.392572727272726	109	G5AYI1	127	242	0.6946637931034487	115
Q9R0X0	PF08612	8	197	1.136715789473684	189	G5BNI8	1	190	1.1397526315789481	189
P70190	PF01267	14	272	1.9346525096525096	258	G5C2C0	15	273	3.5493513513513517	258
Q6ZQ12	PF13499	212	259	2.7040833333333336	47	G5BJV0	212	259	0.7498958333333335	47
Q60596	PF16589	538	624	7.5988045977011485	86	G5AZN8	535	621	7.642045977011497	86
Q60596	PF00533	316	388	9.743109589041099	72	G5AZN8	312	384	9.743863013698627	72
Q60596	PF01834	0	150	5.515549668874175	150	G5AZN8	1	149	4.741838926174495	148
P28575	PF00651	26	132	17.147327102803732	106	G5AX42	27	133	22.02632710280375	106
P28575	PF01344	288	328	2.8709268292682926	40	G5AX42	289	329	2.637926829268293	40
P28575	PF01344	331	376	21.38682608695652	45	G5AX42	332	377	19.358804347826084	45
P28575	PF01344	378	422	24.25011111111111	44	G5AX42	379	423	23.82044444444445	44
P28575	PF01344	425	471	8.193000000000001	46	G5AX42	426	472	11.344808510638297	46
P28575	PF01344	473	518	3.637978260869565	45	G5AX42	474	519	2.604478260869565	45
P28575	PF01344	521	571	9.817627450980392	50	G5AX42	522	572	19.644470588235293	50
P28575	PF07707	138	239	9.315794117647057	101	G5AX42	139	240	9.71020588235294	101
Q9D279	PF15304	293	642	0.3941942857142856	349	G5C5W9	298	634	0.40103264094955504	336
P70318	PF00076	10	42	17.79378787878788	32	G5BVW9	11	43	17.782030303030304	32
P70318	PF00076	59	95	0.3361081081081081	36	G5BVW9	60	96	0.32075675675675674	36
P70318	PF00076	115	185	2.25143661971831	70	G5BVW9	116	186	2.2081690140845067	70
P70318	PF00076	223	287	0.7509846153846151	64	G5BVW9	224	288	0.7509846153846151	64
P27659	PF00297	9	374	2.8505218579234954	365	G5AYU8	26	391	2.8558551912568313	365
Q8VHI5	PF00092	264	442	8.142374301675982	178	G5BDT0	310	488	7.505407821229047	178
Q8VHI5	PF00092	466	630	11.603151515151515	164	G5BDT0	512	675	11.285243902439019	163
Q8VHI5	PF03815	51	132	0.5251097560975612	81	G5BDT0	65	146	0.3568658536585366	81
Q9CWB7	PF05768	31	103	3.583356164383563	72	G5B0S1	33	105	4.1707397260273975	72
P47878	PF00086	213	285	1.6727397260273968	72	G5BIM5	230	302	1.665013698630137	72
Q9D826	PF01266	8	363	2.1864578651685416	355	G5BVJ3	9	363	1.7484028169014088	354
Q7TPM3	PF00622	349	466	7.330847457627116	117	G5C994	289	406	5.599330508474577	117
Q7TPM3	PF00643	94	134	2.830414634146342	40	G5C994	28	68	2.7967073170731704	40
Q91XD6	PF04157	153	369	3.2938571428571426	216	G5BUY5	122	338	2.9974838709677436	216
Q91XD6	PF11605	32	86	2.1741090909090914	54	G5BUY5	1	55	2.1977818181818187	54
Q7TQC5	PF11969	173	277	1.0761047619047623	104	G5B037	174	278	0.265904761904762	104
Q7TQC5	PF16278	282	339	0.0	57	G5B037	283	340	0.4300344827586206	57
Q7TQC5	PF17913	10	106	2.4695979381443305	96	G5B037	5	101	2.1066288659793817	96
Q3TC93	PF00787	63	135	7.860945205479451	72	G5AZC0	158	230	2.79	72
Q505D7	PF07047	5	127	5.534219512195122	122	G5AUX0	6	127	5.098237704918031	121
P09242	PF00245	50	489	5.101909090909091	439	G5BI10	51	490	4.961272727272728	439
Q6ZPR6	PF00415	142	191	0.08156000000000001	49	G5BYI1	142	191	0.13616	49
Q6ZPR6	PF00415	194	243	0.17848	49	G5BYI1	194	243	0.2251	49
Q6ZPR6	PF00415	246	297	4.925596153846153	51	G5BYI1	246	297	10.91861538461538	51
Q6ZPR6	PF00651	559	642	4.516619047619047	83	G5BYI1	559	641	10.014096385542167	82
Q6ZPR6	PF00651	761	870	11.92655454545454	109	G5BYI1	761	869	11.969504587155964	108
Q6ZPR6	PF12796	32	115	3.4453333333333327	83	G5BYI1	32	115	3.513	83
Q8BQ30	PF13914	425	539	3.1133652173913045	114	G5C3C1	326	438	3.1513008849557527	112
Q9D4C5	PF09816	15	112	4.253622448979591	97	G5BUL2	16	113	4.253938775510204	97
O54790	PF03131	23	114	0.19453260869565214	91	G5BJ84	24	115	0.19453260869565214	91
Q9D906	PF00899	340	641	5.469261589403974	301	G5C223	347	648	3.9585	301
Q9D906	PF16420	8	318	7.322228295819936	310	G5C223	9	323	7.7352571428571375	314
Q9WTL2	PF00071	13	172	13.642056250000005	159	G5ARA3	14	172	12.853213836477996	158
Q99LG2	PF03810	31	98	9.15920588235294	67	G5BYX5	32	99	9.160235294117651	67
Q99LG2	PF13513	407	460	10.403962962962957	53	G5BYX5	403	456	10.394277777777779	53
Q80V63	PF00096	620	642	0.0	22	G5BPE0	615	637	0.0	22
Q80V63	PF00096	648	670	0.0	22	G5BPE0	643	665	0.0	22
Q80V63	PF18445	360	397	22.100500000000004	37	G5BPE0	362	399	22.102000000000004	37
Q3ULW8	PF00644	334	530	5.098065989847714	196	G5AXN7	333	529	6.319954314720817	196
Q3ULW8	PF02877	181	318	4.138601449275363	137	G5AXN7	181	317	3.253116788321168	136
Q3ULW8	PF05406	63	139	7.782467532467531	76	G5AXN7	65	141	7.949740259740261	76
O88544	PF01399	267	361	0.1318105263157895	94	G5AT18	268	362	0.12127368421052633	94
O88544	PF18420	364	405	0.09666666666666668	41	G5AT18	365	406	0.09902439024390246	41
P54869	PF01154	49	222	6.893977011494251	173	G5BV18	50	223	6.801086206896554	173
P54869	PF08540	223	504	0.5343546099290781	281	G5BV18	224	505	0.4421773049645391	281
Q9CQ82	PF06729	24	161	3.481673913043477	137	G5ARD2	25	162	2.6391449275362318	137
Q9D738	PF00023	174	198	37.44628000000001	24	G5C4Z5	175	199	23.04332000000001	24
Q9D738	PF07525	267	306	6.349550000000002	39	G5C4Z5	268	307	5.415175	39
Q9D738	PF13637	65	116	2.628634615384616	51	G5C4Z5	66	117	4.37519230769231	51
Q8BUM3	PF00102	119	345	4.2225726872246705	226	G5B387	120	328	4.675354066985647	208
Q9DCE5	PF00400	32	67	0.6951388888888891	35	G5BN62	56	91	1.5406388888888893	35
Q9DCE5	PF00400	82	108	0.13244444444444442	26	G5BN62	113	139	8.522444444444446	26
Q9DCE5	PF00400	112	123	0.0	11	G5BN62	143	153	0.1831818181818181	10
Q9DCE5	PF00400	236	273	2.4807368421052627	37	G5BN62	242	279	2.082921052631579	37
Q80UJ7	PF13890	613	767	0.11587096774193548	154	G5AMN2	608	762	0.3356967741935484	154
Q9D361	PF05253	55	78	0.0	23	G5BAT5	56	79	0.0	23
Q01405	PF00626	631	717	7.8469770114942525	86	G5C816	588	674	7.851011494252874	86
Q01405	PF04810	57	96	0.13414999999999996	39	G5C816	58	96	0.1391025641025641	38
Q01405	PF04811	125	389	7.679479245283017	264	G5C816	97	346	5.8854440000000015	249
Q01405	PF04815	517	615	2.7061212121212117	98	G5C816	474	572	2.740131313131314	98
Q01405	PF08033	400	503	4.0269326923076925	103	G5C816	357	460	4.023134615384614	103
Q9D8E6	PF00573	22	261	1.512441666666667	239	G5AN81	23	262	2.0916208333333333	239
Q9D8E6	PF14374	274	347	0.0	73	G5AN81	275	348	0.0	73
P31257	PF00046	268	324	10.064122807017544	56	G5BIE5	269	325	10.058087719298246	56
E9Q5G3	PF00225	30	435	3.0451896551724125	405	G5C6T3	141	548	3.902247549019605	407
E9Q5G3	PF16540	796	896	1.0827920792079209	100	G5C6T3	913	1012	0.030220000000000014	99
Q8VC19	PF00155	246	591	5.130904624277457	345	G5AXM9	195	540	3.8501763005780334	345
Q8VC19	PF09029	1	139	1.2777769784172666	138	G5AXM9	2	138	1.2655328467153282	136
P17183	PF00113	142	429	0.6715555555555555	287	G5CAR8	143	430	0.8366840277777776	287
P17183	PF03952	2	133	2.372643939393939	131	G5CAR8	3	134	2.278507575757576	131
Q7TPM5	PF15120	1	162	6.113660493827157	161	G5AT39	2	163	6.2748271604938255	161
Q9CQI4	PF17722	0	200	0.5709054726368159	200	G5B129	1	198	0.11267171717171713	197
P07607	PF00303	59	306	7.5106975806451635	247	G5BTS8	2	225	8.39079820627803	223
Q6IRU5	PF01086	0	225	0.18230530973451334	225	G5BPY9	1	226	0.5445353982300883	225
Q61017	PF00631	7	67	0.01827868852459016	60	G5C4N7	8	67	0.0	59
Q7TSQ8	PF01266	43	400	3.0405949720670384	357	G5B5W6	44	401	2.2933016759776543	357
Q7TSQ8	PF01571	460	735	2.6210181159420283	275	G5B5W6	461	735	3.4662727272727265	274
Q7TSQ8	PF08669	763	851	6.707775280898877	88	G5B5W6	764	852	7.526269662921347	88
Q7TSQ8	PF16350	404	458	0.02747272727272727	54	G5B5W6	405	459	0.0	54
Q8K4L0	PF00270	118	281	1.4103780487804878	163	G5AKW4	120	283	1.1724390243902436	163
Q8K4L0	PF00271	321	431	12.419981981981984	110	G5AKW4	323	433	6.840117117117115	110
Q8K4L0	PF08147	705	765	0.0	60	G5AKW4	709	769	0.0	60
P70255	PF00859	216	423	0.6462836538461537	207	G5BZD2	268	474	0.6388260869565219	206
P70255	PF03165	69	169	12.35155445544554	100	G5BZD2	121	221	12.408643564356428	100
P70255	PF10524	9	46	12.122447368421055	37	G5BZD2	61	98	12.058368421052634	37
Q3UHD9	PF00071	404	560	6.090012738853501	156	G5BEC0	409	565	6.0852356687898075	156
Q3UHD9	PF01412	926	1036	7.684432432432432	110	G5BEC0	931	1041	7.609423423423422	110
Q3UHD9	PF12796	1054	1141	20.417647727272712	87	G5BEC0	1059	1146	19.945999999999987	87
Q80TF6	PF00225	15	383	7.768918699186988	368	G5BM34	1	369	8.12818428184282	368
Q80TF6	PF00498	496	547	5.898846153846153	51	G5BM34	463	514	1.6025961538461535	51
Q9D2J7	PF12796	18	110	4.097344086021505	92	G5B2B5	19	111	2.1176129032258064	92
Q9D2J7	PF12796	217	277	15.863950819672132	60	G5B2B5	218	278	15.86167213114754	60
Q9D2J7	PF13637	526	577	12.128942307692313	51	G5B2B5	527	578	8.549384615384612	51
O55128	PF06487	18	136	6.010210084033613	118	G5B3M1	38	156	6.002731092436974	118
Q8BL74	PF00400	603	637	0.8752285714285715	34	G5BZ04	592	626	0.8409428571428569	34
Q9JMD3	PF01852	36	220	5.666821621621622	184	G5AS66	37	221	5.666886486486487	184
Q5M8N4	PF01370	48	207	7.3186500000000025	159	G5BDS0	25	184	8.295906250000002	159
Q5M8N4	PF08338	244	290	2.237723404255319	46	G5BDS0	221	268	8.812916666666668	47
Q80UY2	PF00569	5	46	0.48654761904761895	41	G5BRQ4	2	43	0.4853571428571428	41
Q80UY2	PF05605	75	136	0.0	61	G5BRQ4	72	133	0.0	61
Q499E4	PF13815	23	143	1.9665123966942144	120	G5BPK4	24	144	2.2638099173553727	120
P35295	PF00071	6	197	7.824255208333329	191	G5AZ46	7	195	7.55425396825397	188
Q61990	PF00013	14	75	9.856338709677416	61	G5BIF5	15	76	9.785935483870963	61
Q61990	PF00013	98	161	2.2175625	63	G5BIF5	99	162	3.6004375	63
Q61990	PF00013	286	348	4.7183650793650775	62	G5BIF5	287	349	8.416158730158731	62
Q8K203	PF00641	317	345	22.157827586206885	28	G5C3P5	319	347	26.381862068965518	28
Q8K203	PF06831	157	224	0.011691176470588236	67	G5C3P5	159	226	0.11463235294117645	67
Q8K203	PF06839	505	549	0.0	44	G5C3P5	506	550	0.03577777777777778	44
Q8K203	PF06839	552	595	0.20452272727272724	43	G5C3P5	553	596	0.20422727272727276	43
Q9QYC3	PF00010	72	123	0.3464423076923077	51	G5BF27	73	124	0.23140384615384615	51
Q6SKR2	PF05175	28	125	6.848734693877548	97	G5B1C0	29	126	8.974989795918368	97
Q61539	PF00104	240	414	8.597708571428564	174	G5B688	241	415	8.156702857142857	174
Q61539	PF00105	101	169	0.2283478260869565	68	G5B688	102	170	0.18342028985507247	68
P62821	PF00071	12	172	4.585683229813665	160	G5C5Z3	6	166	4.997826086956524	160
Q8BGS1	PF00373	126	234	4.168761467889909	108	G5B4R3	127	235	4.171706422018346	108
Q8BGS1	PF08736	336	377	0.0	41	G5B4R3	337	378	0.0	41
Q8BGS1	PF09379	46	108	0.0	62	G5B4R3	47	109	0.0	62
Q8BGS1	PF09380	240	329	9.3706	89	G5B4R3	241	330	9.380555555555553	89
Q9R194	PF00875	22	175	2.5158116883116888	153	G5AS55	24	177	2.5251233766233767	153
Q9R194	PF03441	305	503	6.848241206030147	198	G5AS55	307	505	6.782497487437184	198
Q8CFA7	PF00096	255	279	0.191	24	G5AQE6	259	283	0.0	24
Q8CFA7	PF00096	315	337	0.0	22	G5AQE6	319	341	0.0	22
Q99PW8	PF00225	10	334	1.812695384615384	324	G5C4W9	11	336	2.3868128834355837	325
Q9DCB4	PF01424	165	220	3.5913571428571434	55	G5BIT8	167	222	3.5595178571428567	55
Q9DCB4	PF12752	245	265	0.0	20	G5BIT8	247	266	0.0	19
Q8CF36	PF14982	2	73	1.5834027777777782	71	G5CB74	3	73	1.4833239436619718	70
Q9DBL9	PF00561	88	183	2.2428125000000008	95	G5C204	72	167	4.1159791666666665	95
O55098	PF00069	36	293	3.4255930232558107	257	G5BBX8	34	291	2.8532054263565887	257
O55098	PF12474	585	723	0.0	138	G5BBX8	584	722	0.0	138
O55098	PF12474	753	893	0.011453900709219856	140	G5BBX8	752	892	0.011453900709219856	140
Q8VD37	PF10291	538	803	0.8810263157894739	265	G5BSP4	596	861	0.9623533834586464	265
Q7TQH0	PF06741	261	329	0.0	68	G5BRD4	165	233	0.0	68
Q7TQH0	PF07145	656	670	0.0	14	G5BRD4	553	567	0.0	14
Q7TQH0	PF14438	117	191	7.962253333333333	74	G5BRD4	21	95	6.8878933333333325	74
O89029	PF00092	35	206	7.812058139534884	171	G5BB21	14	185	8.797593023255816	171
O89029	PF00092	387	559	10.460098265895953	172	G5BB21	366	538	10.493630057803463	172
O89029	PF10393	582	605	0.04916666666666667	23	G5BB21	561	583	0.0	22
O89029	PF14670	220	255	0.14372222222222225	35	G5BB21	199	234	0.10255555555555557	35
O89029	PF14670	261	296	0.01930555555555556	35	G5BB21	240	275	3.8224444444444448	35
Q9D2Q2	PF07757	252	333	13.351548780487807	81	G5B307	338	418	13.26838271604938	80
Q61831	PF00069	63	358	3.313418918918918	295	G5C950	64	359	3.465185810810812	295
P24288	PF01063	93	342	6.901092000000002	249	G5BEH5	74	323	6.883024000000002	249
Q8BSM5	PF00169	24	115	7.957521739130435	91	G5C0D4	17	108	8.016000000000002	91
Q8VCZ6	PF00018	485	530	9.873130434782608	45	G5AYW5	484	529	9.96369565217391	45
Q8VCZ6	PF00566	118	324	19.423149758454112	206	G5AYW5	117	323	19.168589371980673	206
Q8VCZ6	PF02759	562	715	3.305909090909091	153	G5AYW5	561	714	3.3762987012987016	153
Q80ZV0	PF09468	94	224	5.864870229007633	130	G5BKP7	78	208	5.647145038167938	130
Q80ZV0	PF17745	28	91	3.8218437499999993	63	G5BKP7	12	75	8.415093749999999	63
Q8CE08	PF00328	32	329	2.9967953020134237	297	G5BKQ9	33	330	2.7006375838926133	297
Q8BH58	PF04176	47	179	1.4777067669172932	132	G5AQ57	47	178	0.0	131
P53762	PF00010	90	142	0.5927547169811321	52	G5AJX9	83	135	0.5930566037735849	52
P53762	PF00989	165	268	7.3909326923076915	103	G5AJX9	158	261	7.391480769230768	103
P53762	PF14598	361	463	5.46390291262136	102	G5AJX9	356	458	5.465291262135921	102
O35218	PF07521	528	590	0.8292063492063493	62	G5AZL8	529	591	0.8292063492063493	62
O35218	PF10996	242	366	6.467344000000001	124	G5AZL8	243	367	6.466792	124
O35218	PF13299	607	778	1.3792151162790702	171	G5AZL8	608	779	1.3792151162790702	171
O35218	PF16661	21	197	1.259779661016949	176	G5AZL8	22	198	1.1663841807909603	176
Q9QZT4	PF00068	21	129	3.4462752293577976	108	G5C4W2	40	148	3.9614220183486233	108
Q60772	PF12796	73	155	0.2870963855421688	82	G5C4G1	74	156	0.7198072289156626	82
Q60772	PF13637	9	42	0.058382352941176476	33	G5C4G1	10	43	0.05867647058823529	33
O89017	PF01650	30	286	8.833175097276257	256	G5B2X4	32	288	8.745357976653702	256
A2BDX3	PF00581	337	450	2.3886842105263164	113	G5AYZ6	338	453	7.101353448275861	115
A2BDX3	PF00899	62	296	3.2136553191489368	234	G5AYZ6	63	297	5.844982978723402	234
Q64127	PF00439	908	989	7.929036585365855	81	G5B547	783	864	7.921695121951226	81
Q64127	PF00628	829	871	6.060302325581397	42	G5B547	704	746	6.050837209302325	42
Q64127	PF00643	219	256	0.0	37	G5B547	200	237	0.0	37
P18406	PF00007	289	368	0.959525	79	G5C913	292	370	0.03050632911392405	78
P18406	PF00093	99	162	0.0	63	G5C913	100	163	0.0	63
P18406	PF00219	25	77	0.09801886792452832	52	G5C913	26	78	0.09773584905660376	52
P18406	PF19035	226	269	0.0	43	G5C913	229	272	0.0	43
Q9D0N7	PF00400	10	44	0.0	34	G5B2U2	11	45	0.0	34
Q9D0N7	PF00400	63	93	16.665580645161292	30	G5B2U2	64	94	16.676354838709678	30
Q9D0N7	PF00400	119	156	4.70128947368421	37	G5B2U2	120	157	0.5655263157894738	37
Q9D0N7	PF00400	160	198	1.77325641025641	38	G5B2U2	161	199	1.8473846153846156	38
Q9D0N7	PF15512	387	558	0.0	171	G5B2U2	388	559	0.5250116279069768	171
Q91XL9	PF12796	9	108	6.06095	99	G5BLQ4	10	109	5.7082000000000015	99
Q91XL9	PF01237	547	939	3.5897938931297713	392	G5BLQ4	548	940	3.4191297709923663	392
Q91XL9	PF13857	163	215	0.0	52	G5BLQ4	164	216	0.0	52
P29788	PF00045	159	201	0.3201162790697675	42	G5BVN8	168	210	0.6859069767441863	42
P29788	PF00045	204	249	0.0	45	G5BVN8	213	258	0.0	45
P29788	PF00045	252	302	0.2937843137254902	50	G5BVN8	261	311	0.2981764705882353	50
P29788	PF00045	428	472	7.260288888888887	44	G5BVN8	434	477	8.951227272727273	43
P29788	PF01033	21	59	0.02551282051282051	38	G5BVN8	22	60	0.0	38
Q8CDN6	PF00085	11	103	3.7130752688172035	92	G5APR5	12	104	3.7137204301075273	92
Q8CDN6	PF06201	125	267	10.880895104895103	142	G5APR5	126	268	12.442944055944054	142
Q91WE1	PF00787	43	122	2.6613	79	G5B6M7	44	123	2.2221125	79
Q91WE1	PF04212	268	332	0.4091384615384616	64	G5B6M7	269	334	0.21939393939393945	65
Q8BIE6	PF00373	92	205	5.607236842105262	113	G5C5E5	108	221	5.069552631578946	113
Q8BIE6	PF09379	8	68	3.555475409836065	60	G5C5E5	24	84	3.552311475409835	60
Q8BIE6	PF09380	209	309	1.4748514851485153	100	G5C5E5	225	329	9.2128	104
Q8BIE6	PF11819	341	475	0.02307407407407408	134	G5C5E5	361	495	0.023111111111111117	134
Q8CGR5	PF00089	23	242	0.9736863636363634	219	G5BR93	25	243	1.3880273972602748	218
Q8CCJ4	PF09422	290	589	0.4705666666666666	299	G5AMY3	154	440	0.5064843205574912	286
Q9WVM6	PF00431	347	456	6.805272727272728	109	G5BEU3	357	466	6.80800909090909	109
Q9WVM6	PF00431	460	569	0.6065272727272728	109	G5BEU3	470	579	0.7772454545454547	109
Q9WVM6	PF00431	616	725	1.3537454545454557	109	G5BEU3	626	735	1.344145454545455	109
Q9WVM6	PF00431	772	879	0.7498425925925927	107	G5BEU3	782	889	0.2546111111111112	107
Q9WVM6	PF00431	885	998	1.131701754385965	113	G5BEU3	895	1008	3.6352280701754394	113
Q9WVM6	PF01400	154	345	4.867354166666666	191	G5BEU3	164	355	4.832947916666666	191
Q9WVM6	PF07645	728	767	0.027600000000000003	39	G5BEU3	738	777	0.043675	39
Q9WVM6	PF14670	581	612	0.0	31	G5BEU3	591	622	0.0	31
E9PYQ0	PF02493	85	107	1.3791304347826088	22	G5BF33	78	100	1.494304347826087	22
E9PYQ0	PF02493	108	128	1.5714285714285714	20	G5BF33	101	121	1.567047619047619	20
E9PYQ0	PF02493	131	153	0.0	22	G5BF33	124	145	4.810499999999998	21
E9PYQ0	PF02493	154	171	0.0	17	G5BF33	147	164	0.17972222222222226	17
E9PYQ0	PF02493	178	195	0.09694444444444444	17	G5BF33	171	188	0.1783888888888889	17
E9PYQ0	PF02493	203	224	2.676590909090909	21	G5BF33	196	217	0.0	21
E9PYQ0	PF02493	226	243	0.0	17	G5BF33	219	236	0.0	17
E9PYQ0	PF02493	250	267	0.0	17	G5BF33	243	260	0.0	17
E9PYQ0	PF02493	283	304	0.8130909090909091	21	G5BF33	276	297	0.3636363636363637	21
E9PYQ0	PF02493	306	327	0.0485	21	G5BF33	299	320	0.0	21
Q6R2P8	PF06831	192	262	0.7871971830985917	70	G5AMF5	199	269	0.7942394366197186	70
Q8C3P7	PF05063	388	549	7.444938271604934	161	G5BFU9	389	550	6.914092592592587	161
Q9JJA7	PF00134	75	188	2.921166666666668	113	G5ATP9	69	182	2.9400701754385974	113
Q9JJA7	PF02984	199	254	17.521428571428572	55	G5ATP9	193	247	16.039618181818184	54
Q8C5S7	PF04824	536	589	14.881203703703699	53	G5B291	565	618	15.17459259259259	53
Q8C5S7	PF04825	0	111	12.069750000000004	111	G5B291	1	112	11.677901785714285	111
Q8JZX9	PF00786	28	84	0.058508771929824566	56	G5B6L0	29	85	0.05877192982456141	56
Q8JZX9	PF14957	102	143	0.0	41	G5B6L0	103	143	0.0	40
Q8JZX9	PF14957	166	204	0.050897435897435915	38	G5B6L0	163	201	0.05089743589743589	38
Q9QYC0	PF00596	147	328	3.51303296703297	181	G5BCH1	148	329	3.0196868131868118	181
Q9D2H6	PF00096	523	547	0.0	24	G5BY21	277	301	0.0	24
Q9D2H6	PF00096	553	577	20.57276	24	G5BY21	307	331	18.071320000000004	24
Q9D2H6	PF00096	583	605	0.0	22	G5BY21	337	359	0.0	22
Q5BKS4	PF00929	37	223	5.937770053475937	186	G5BV99	33	219	4.351224598930481	186
Q5BKS4	PF06839	591	638	0.0	47	G5BV99	588	635	0.0	47
P70327	PF00907	93	272	4.209316666666667	179	G5BRB9	94	273	4.202966666666666	179
Q8CHW1	PF05485	4	80	2.9594025974025966	76	G5BT52	5	81	0.5584415584415584	76
Q812B2	PF00007	34	127	0.5798510638297872	93	G5BCZ0	35	128	0.785936170212766	93
Q5DU00	PF03607	34	78	0.3740444444444445	44	G5BJY0	35	78	0.36604545454545456	43
Q5DU00	PF03607	156	214	7.08822033898305	58	G5BJY0	148	206	7.063440677966101	58
Q9R008	PF00288	129	211	7.249734939759035	82	G5BDR4	130	212	6.6165180722891614	82
Q9R008	PF08544	293	353	0.07149180327868854	60	G5BDR4	294	354	0.5251803278688525	60
Q9R008	PF10509	5	42	2.8794473684210526	37	G5BDR4	6	43	14.310789473684206	37
Q8R0P8	PF00561	168	270	15.774087378640775	102	G5B7V3	123	225	14.854728155339796	102
Q3SXD3	PF13023	22	169	1.3330337837837842	147	G5BJ20	1	148	0.7567027027027029	147
Q9QZ05	PF12745	1394	1641	8.214721774193547	247	G5BLY0	1500	1720	9.03724886877828	220
Q9QZ05	PF00069	328	537	2.190557142857142	209	G5BLY0	432	641	1.8023571428571432	209
Q9QZ05	PF00069	588	656	1.662072463768116	68	G5BLY0	692	760	1.6441884057971017	68
Q9QZ05	PF00069	792	997	9.212844660194175	205	G5BLY0	899	1103	11.238121951219506	204
Q9QZ05	PF05773	46	132	0.43393103448275866	86	G5BLY0	149	235	0.6344597701149425	86
Q9QZ05	PF13393	1065	1379	7.093330158730159	314	G5BLY0	1171	1485	9.208638095238095	314
Q61321	PF16878	114	178	1.2824923076923078	64	G5C5H9	203	266	1.2700000000000002	63
Q9Z205	PF12796	169	246	3.3385769230769236	77	G5C5C3	160	237	4.723269230769229	77
Q9Z205	PF13606	132	160	3.197965517241379	28	G5C5C3	123	151	3.535827586206897	28
Q8CCH7	PF12874	1119	1137	0.07473684210526316	18	G5AZ82	1152	1170	0.07421052631578946	18
Q9JJX8	PF00069	22	277	5.33626953125	255	G5B314	6	261	5.778496093750001	255
Q8C196	PF00117	221	394	3.1951609195402297	173	G5BN41	223	396	3.3976781609195386	173
Q8C196	PF00988	45	182	3.092702898550725	137	G5BN41	47	184	3.100449275362319	137
Q8C196	PF02142	1374	1464	1.6512417582417582	90	G5BN41	1358	1448	1.633351648351648	90
Q8C196	PF02786	545	748	0.8406372549019608	203	G5BN41	547	750	0.8384705882352943	203
Q8C196	PF02786	1087	1289	2.695315270935956	202	G5BN41	1089	1291	2.673926108374385	202
Q8C196	PF02787	840	919	0.3588	79	G5BN41	842	921	0.4131625	79
Q9QYP6	PF12845	228	277	0.0955	49	G5B981	217	266	0.0958	49
Q9D2V5	PF05282	17	362	9.201826589595377	345	G5B839	18	363	8.547699421965312	345
Q91VC7	PF05361	58	121	0.011390625	63	G5AMC3	19	82	0.0	63
Q80W85	PF03066	18	115	3.867683673469387	97	G5B9P2	15	116	6.265578431372544	101
Q9D0L4	PF03109	135	251	8.459256410256414	116	G5AW39	136	252	8.529213675213677	116
Q9D4A5	PF15762	0	159	0.0273875	159	G5C670	1	177	0.04891525423728813	176
Q9JI19	PF05427	3	355	2.2803399433427787	352	G5B6I6	4	363	2.3218361111111103	359
Q9CQQ8	PF01423	13	85	5.020287671232877	72	G5BBC9	14	86	5.0188356164383565	72
O35684	PF00079	27	396	6.769478378378374	369	G5AMJ5	28	397	6.840813513513514	369
P70303	PF00117	309	542	3.2834102564102565	233	G5B0F5	319	552	3.6300128205128197	233
P70303	PF06418	1	271	1.5457380073800753	270	G5B0F5	2	281	1.4555607142857154	279
Q91ZA3	PF00289	58	166	0.16392660550458718	108	G5B1U5	63	171	0.14470642201834866	108
Q91ZA3	PF00364	657	722	8.522621212121212	65	G5B1U5	662	727	8.50219696969697	65
Q91ZA3	PF02785	392	500	0.4679633027522936	108	G5B1U5	397	505	1.5418715596330277	108
Q91ZA3	PF02786	171	379	2.2312344497607657	208	G5B1U5	176	384	0.6427320574162679	208
Q91ZA3	PF18140	520	648	7.84827131782946	128	G5B1U5	525	653	6.648511627906978	128
Q9JJS0	PF00431	806	915	2.4476363636363625	109	G5BUX1	794	903	2.447827272727271	109
Q9JJS0	PF07645	361	391	1.1944193548387096	30	G5BUX1	320	350	0.8846451612903226	30
Q9JJS0	PF07699	641	691	0.0	50	G5BUX1	629	679	0.0	50
Q9JJS0	PF07699	698	745	0.08387499999999999	47	G5BUX1	686	733	0.08416666666666668	47
Q9JJS0	PF07699	754	801	0.0	47	G5BUX1	742	789	0.0	47
Q9JJS0	PF12662	106	128	0.0	22	G5BUX1	65	87	0.0	22
Q9JJS0	PF12947	46	81	0.0	35	G5BUX1	5	40	0.0	35
Q9JJS0	PF14670	129	164	0.2290833333333333	35	G5BUX1	88	123	0.2644166666666667	35
Q9JJS0	PF14670	214	249	0.01827777777777777	35	G5BUX1	173	208	0.0	35
Q9JJS0	PF14670	283	318	0.1056388888888889	35	G5BUX1	242	277	0.5205833333333332	35
Q9JJS0	PF14670	324	359	0.021944444444444447	35	G5BUX1	283	318	0.021944444444444447	35
Q9JJS0	PF14670	404	439	0.14599999999999996	35	G5BUX1	363	398	0.15083333333333335	35
Q3URQ0	PF12333	132	234	3.2078058252427177	102	G5AZ28	133	235	3.237456310679612	102
Q9D2R0	PF00501	108	542	8.747558620689658	434	G5AWU9	109	543	9.793227586206909	434
Q9D2R0	PF16177	46	103	12.124362068965516	57	G5AWU9	47	104	3.205431034482759	57
Q2YDW2	PF10644	5	116	1.033401785714286	111	G5ARB3	6	117	1.5289464285714292	111
Q2YDW2	PF14881	144	331	0.8825053191489364	187	G5ARB3	159	346	1.910308510638297	187
Q8BJU0	PF00515	126	158	0.981818181818182	32	G5BZC6	126	158	0.5723636363636363	32
Q8BJU0	PF00515	160	192	1.1427272727272728	32	G5BZC6	160	192	1.1287878787878791	32
Q8BJU0	PF13181	98	124	0.21729629629629632	26	G5BZC6	98	124	0.4652962962962963	26
Q8BJU0	PF16546	2	62	8.85427868852459	60	G5BZC6	3	63	11.832606557377048	60
Q9Z2S7	PF01166	58	104	2.7293404255319147	46	G5ASY1	49	94	2.396391304347825	45
Q64327	PF06910	54	168	0.016278260869565214	114	G5BNL0	55	168	0.016421052631578944	113
Q6ZWM4	PF01423	21	70	16.436680000000006	49	G5B3Q3	2	51	19.48244	49
Q61458	PF00134	64	157	9.443765957446807	93	G5AT77	65	158	9.478042553191488	93
Q61458	PF16899	161	259	5.415434343434344	98	G5AT77	162	260	8.383050505050505	98
P30416	PF00254	43	99	9.120052631578947	56	G5AS19	77	132	9.507999999999996	55
P30416	PF00254	162	248	1.9442643678160918	86	G5AS19	163	249	1.9310459770114947	86
P30416	PF00515	320	351	0.2279375	31	G5AS19	321	352	0.2279375	31
P30416	PF07719	354	385	0.0	31	G5AS19	355	386	0.0	31
O88665	PF00439	149	222	0.16243243243243244	73	G5C248	211	284	0.16168918918918918	73
O88665	PF12024	300	481	0.6943736263736263	181	G5C248	362	507	4.376349315068491	145
D2J0Y4	PF15309	513	641	0.0	128	G5BE48	594	721	0.0	127
D2J0Y4	PF17730	4	508	0.7137425742574256	504	G5BE48	45	587	1.7847937384898722	542
Q11011	PF01433	280	497	3.711706422018351	217	G5BY30	186	403	3.746481651376144	217
Q11011	PF11838	578	891	4.682783439490442	313	G5BY30	484	797	4.764257961783437	313
Q11011	PF17900	95	245	2.971211920529801	150	G5BY30	1	151	3.630026490066226	150
Q9JJT9	PF10258	220	302	2.986421686746988	82	G5BHU4	231	313	2.9749638554216875	82
Q8BST6	PF04710	15	418	1.8189579207920772	403	G5BIH7	171	575	0.693678217821782	404
Q8R040	PF04032	12	95	0.5274404761904761	83	G5C3B2	13	96	0.6450357142857145	83
Q9CQ37	PF00179	5	145	4.651262411347519	140	G5B384	6	146	6.283900709219857	140
P61460	PF00610	1187	1247	14.441081967213115	60	G5BBV5	1190	1250	15.149180327868853	60
P61460	PF12257	99	380	8.710407801418441	281	G5BBV5	100	381	8.71072695035461	281
Q3V1U8	PF04727	118	293	6.300573863636368	175	G5B4J1	92	267	5.879352272727273	175
E9Q4S1	PF00233	593	840	3.2844516129032253	247	G5ATK0	490	737	3.2736249999999982	247
E9Q4S1	PF13426	259	355	0.6102164948453609	96	G5ATK0	156	252	0.7200412371134021	96
Q8C5U9	PF00240	23	92	8.964899999999998	69	G5BS50	24	93	8.772814285714286	69
Q05117	PF00149	27	244	7.9883623853211025	217	G5AJT5	28	245	10.768779816513762	217
P05208	PF00089	30	263	3.4877393162393147	233	G5BRS7	29	261	6.257480686695278	232
Q60584	PF00400	141	173	12.621939393939394	32	G5AXR4	142	174	17.37639393939394	32
Q60584	PF00400	218	252	2.9827714285714286	34	G5AXR4	219	253	2.619657142857143	34
Q60584	PF00400	257	303	1.908297872340425	46	G5AXR4	258	304	1.8891489361702123	46
Q60584	PF12937	59	101	12.144976744186046	42	G5AXR4	60	102	12.134046511627917	42
Q6PCM2	PF13519	3	130	10.342234375	127	G5C221	4	131	9.567234374999996	127
Q6PCM2	PF15300	802	863	11.274774193548383	61	G5C221	807	868	13.782903225806454	61
Q04859	PF00069	3	283	2.307352313167261	280	G5BN60	4	284	2.4109288256227748	280
P50405	PF02199	30	58	0.0	28	G5BU87	31	59	0.08358620689655173	28
P50405	PF03489	110	141	0.0	31	G5BU87	111	142	0.0579375	31
P50405	PF03489	328	361	0.15797058823529414	33	G5BU87	332	365	0.06308823529411765	33
P50405	PF05184	65	102	0.19055263157894736	37	G5BU87	66	103	0.4352631578947368	37
Q3UZZ6	PF00685	37	286	6.632872000000009	249	G5AYC0	38	287	5.446911999999995	249
Q3KNJ2	PF09302	11	174	1.8822682926829264	163	G5AKK9	12	175	2.083128048780486	163
Q9WUD1	PF04564	227	299	0.0	72	G5BXV9	227	299	0.0	72
Q9WUD1	PF12895	41	119	6.976721518987337	78	G5BXV9	41	119	6.977949367088603	78
Q9WUD1	PF18391	142	225	0.0	83	G5BXV9	142	225	0.0	83
Q5DU31	PF00169	15	108	9.054212765957447	93	G5BQ61	33	126	8.992085106382977	93
P35385	PF00011	73	157	3.824270588235294	84	G5BRU0	79	163	0.4815882352941178	84
Q924M7	PF01238	5	379	7.344346666666668	374	G5AL67	6	379	8.290764705882353	373
Q9QWG7	PF00685	37	287	3.0914661354581656	250	G5AYB8	37	287	3.253322709163347	250
Q8BGW4	PF00400	191	225	22.224885714285726	34	G5BH64	187	221	22.284600000000005	34
Q99MP8	PF02148	315	374	9.56735	59	G5AKU4	317	376	9.568216666666666	59
Q99MP8	PF07576	153	248	5.9202708333333325	95	G5AKU4	155	250	5.851781249999998	95
Q99MP8	PF13639	261	302	1.5385238095238098	41	G5AKU4	263	304	1.540809523809524	41
Q61084	PF00069	363	620	3.813418604651164	257	G5BDJ6	446	739	2.6908265306122443	293
Q61084	PF00564	44	119	4.087118421052632	75	G5BDJ6	153	225	2.9952602739726033	72
O54714	PF02891	322	370	0.2657142857142857	48	G5BBM5	313	361	0.2655102040816327	48
O54714	PF14324	126	277	3.75	151	G5BBM5	118	268	3.8245099337748334	150
Q3T9Z9	PF07910	335	549	9.297809302325586	214	G5AMZ8	329	543	9.862883720930228	214
Q99PG4	PF00615	85	199	0.34921739130434765	114	G5C0G1	74	187	0.552956140350877	113
Q921U8	PF00307	806	911	5.4018584905660365	105	G5BBU1	879	1007	4.4403100775193804	128
Q921U8	PF12510	0	40	0.0	40	G5BBU1	43	83	0.0	40
Q921U8	PF12510	73	121	0.4271428571428572	48	G5BBU1	116	164	0.443469387755102	48
Q921U8	PF12510	570	616	0.0	46	G5BBU1	650	696	0.0	46
P97411	PF04629	259	437	0.7516703910614525	178	G5BRZ1	69	251	0.7795136612021857	182
P97411	PF04629	440	477	9.079999999999998	37	G5BRZ1	284	321	9.195135135135137	37
P97411	PF06456	192	247	0.5020535714285715	55	G5BRZ1	2	57	0.492625	55
Q8K305	PF08641	82	145	0.21125	63	G5C343	83	145	0.19763492063492055	62
Q9Z2H2	PF00610	42	112	2.7955211267605633	70	G5BJM1	8	78	2.7815070422535206	70
Q9Z2H2	PF00615	335	449	1.8783739130434782	114	G5BJM1	301	450	2.8175733333333333	149
Q9Z2H2	PF00631	255	316	0.399258064516129	61	G5BJM1	221	282	0.23990322580645154	61
Q9Z2H2	PF18148	115	216	3.09935294117647	101	G5BJM1	81	182	3.089303921568627	101
P39447	PF00595	23	105	1.8340361445783133	82	G5B6I5	12	94	1.8369156626506007	82
P39447	PF00595	187	260	0.2196621621621622	73	G5B6I5	176	249	0.2200135135135136	73
P39447	PF00595	427	497	14.869845070422535	70	G5B6I5	416	486	15.22461971830986	70
P39447	PF00625	691	791	5.673603960396043	100	G5B6I5	680	780	5.675039603960394	100
P39447	PF00791	1632	1719	0.3445454545454545	87	G5B6I5	1614	1701	0.3205795454545455	87
P39447	PF07653	519	581	0.8213809523809527	62	G5B6I5	508	570	0.8229206349206353	62
Q80Y75	PF00226	3	64	6.871161290322582	61	G5AS98	4	65	0.5407903225806451	61
Q80Y75	PF01556	139	298	7.373825000000001	159	G5AS98	140	299	6.855331250000001	159
Q922K9	PF00017	122	162	6.678463414634148	40	G5C1A2	59	98	3.0725499999999992	39
Q922K9	PF00018	84	97	0.35428571428571426	13	G5C1A2	3	16	2.4504285714285707	13
Q922K9	PF07714	240	492	5.987395256917	252	G5C1A2	164	416	5.783545454545451	252
Q924S7	PF00568	12	117	1.9562169811320755	105	G5C5Z5	23	128	1.9461415094339625	105
Q924S7	PF05210	297	400	7.389971153846155	103	G5C5Z5	311	414	7.386365384615384	103
Q62276	PF06179	19	123	1.951933333333333	104	G5B8G9	49	153	1.947695238095238	104
O88447	PF13176	383	414	0.224875	31	G5AWH4	407	438	0.2234375	31
O88447	PF13374	463	496	0.05973529411764706	33	G5AWH4	487	520	0.03958823529411765	33
O88447	PF13424	210	284	12.639719999999995	74	G5AWH4	231	309	17.114949367088606	78
O88447	PF13424	293	367	2.9457999999999984	74	G5AWH4	318	392	2.809773333333333	74
A2AN08	PF02207	1660	1718	1.157033898305085	58	G5BZM0	1662	1720	1.0849152542372882	58
A2AN08	PF13764	4363	5159	4.5666813048933514	796	G5BZM0	4377	5173	5.085698870765367	796
Q9D9S1	PF05250	4	211	0.3782451923076922	207	G5AYS0	5	213	0.10258373205741622	208
Q60700	PF07714	163	395	4.502862660944205	232	G5BIF4	164	396	4.506103004291845	232
P09632	PF00046	146	200	0.017545454545454548	54	G5C4M6	112	165	0.017830188679245282	53
Q99LD4	PF01399	303	403	2.157881188118813	100	G5BJ95	354	453	2.46885	99
Q99LD4	PF10602	106	287	4.838807692307693	181	G5BJ95	157	338	4.814142857142857	181
Q9JJ11	PF05010	428	624	0.2237766497461928	196	G5BCI8	569	762	0.0054123711340206175	193
Q05921	PF00069	374	512	10.344352517985607	138	G5BE40	377	515	8.827165467625898	138
Q05921	PF06479	589	634	0.0	45	G5BE40	592	636	0.0	44
Q05921	PF12796	27	87	2.885213114754098	60	G5BE40	28	88	0.04967213114754098	60
Q05921	PF12796	218	298	15.80271604938272	80	G5BE40	219	298	22.7045625	79
Q05921	PF13637	100	143	2.818068181818182	43	G5BE40	101	144	1.0189545454545454	43
Q05921	PF13857	163	205	0.763767441860465	42	G5BE40	164	206	0.8781395348837209	42
Q91ZU0	PF07525	274	312	0.0	38	G5ARY9	275	313	0.0	38
Q91ZU0	PF12796	19	103	0.5507176470588235	84	G5ARY9	20	104	0.5426823529411765	84
Q91ZU0	PF12796	113	179	5.017955223880595	66	G5ARY9	114	180	5.019671641791042	66
Q91ZU0	PF12796	185	267	1.188602409638554	82	G5ARY9	186	268	1.1885662650602409	82
Q9CQI9	PF11315	28	175	1.3143310810810809	147	G5AT88	29	176	1.316243243243243	147
Q8BZ25	PF00023	535	564	0.025666666666666667	29	G5BEX4	471	500	0.2549666666666667	29
Q8BZ25	PF07714	74	292	6.838100456621004	218	G5BEX4	5	223	4.9357853881278535	218
Q8BZ25	PF12796	348	432	2.7875529411764703	84	G5BEX4	280	368	1.8854044943820223	88
Q8BZ25	PF12796	439	530	1.2355760869565218	91	G5BEX4	375	466	1.2339021739130434	91
Q8BZ25	PF12796	582	661	3.3276625	79	G5BEX4	518	597	5.85435	79
Q8BZ25	PF12796	670	741	0.4661388888888889	71	G5BEX4	606	677	8.979652777777773	71
Q921Y2	PF00163	3	63	0.0	60	G5AL78	4	64	0.0	60
Q921Y2	PF01479	108	154	10.512680851063829	46	G5AL78	109	155	10.519382978723405	46
Q9QYB1	PF13410	134	220	0.0	86	G5BHW8	161	247	0.0	86
P31695	PF00008	28	56	0.0	28	G5C3I8	401	428	0.0	27
P31695	PF00008	64	109	0.0	45	G5C3I8	26	71	0.07093478260869568	45
P31695	PF00008	119	148	0.0	29	G5C3I8	81	110	0.0	29
P31695	PF00008	156	185	0.12116666666666664	29	G5C3I8	118	147	0.08650000000000001	29
P31695	PF00008	234	267	0.07435294117647058	33	G5C3I8	196	228	0.2469090909090909	32
P31695	PF00008	276	300	0.0	24	G5C3I8	238	262	0.063	24
P31695	PF00008	475	504	1.0029999999999997	29	G5C3I8	437	466	1.0001666666666666	29
P31695	PF00008	513	543	0.0	30	G5C3I8	475	504	7.4639	29
P31695	PF00008	551	581	0.0	30	G5C3I8	513	543	0.0	30
P31695	PF00008	589	617	2.2088965517241377	28	G5C3I8	551	579	0.026034482758620688	28
P31695	PF00008	767	796	6.684899999999999	29	G5C3I8	729	757	0.027586206896551727	28
P31695	PF00008	806	835	0.0	29	G5C3I8	768	796	0.0	28
P31695	PF00008	844	873	0.0248	29	G5C3I8	806	834	0.057724137931034473	28
P31695	PF00008	896	920	0.0	24	G5C3I8	859	883	0.0	24
P31695	PF00008	929	958	0.0	29	G5C3I8	892	921	0.0	29
P31695	PF00008	967	997	0.032903225806451615	30	G5C3I8	930	960	0.032903225806451615	30
P31695	PF00008	1045	1078	0.0	33	G5C3I8	513	542	0.0	29
P31695	PF00023	1728	1758	0.25370967741935485	30	G5C3I8	1578	1608	0.2532258064516129	30
P31695	PF00066	1163	1199	0.0	36	G5C3I8	1055	1091	0.0	36
P31695	PF00066	1206	1241	11.388222222222224	35	G5C3I8	1098	1133	11.387527777777775	35
P31695	PF00066	1246	1279	0.0	33	G5C3I8	1138	1171	0.0	33
P31695	PF06816	1292	1338	14.370659574468085	46	G5C3I8	1184	1230	12.552297872340429	46
P31695	PF07645	190	223	0.0	33	G5C3I8	152	185	0.0	33
P31695	PF07645	310	346	0.3121621621621622	36	G5C3I8	272	308	0.11164864864864864	36
P31695	PF07645	428	464	0.0	36	G5C3I8	390	426	0.0	36
P31695	PF07684	1374	1415	21.07904761904762	41	G5C3I8	1265	1305	13.464560975609748	40
P31695	PF12661	360	380	0.0	20	G5C3I8	322	342	0.03690476190476191	20
P31695	PF12661	696	717	0.0	21	G5C3I8	658	679	0.0	21
P31695	PF12661	734	753	0.0	19	G5C3I8	696	715	0.0	19
P31695	PF12796	1632	1725	0.5563829787234041	93	G5C3I8	1482	1575	0.3929468085106382	93
Q9CQI7	PF00076	8	78	10.353746478873239	70	G5AMI2	9	79	10.344070422535207	70
Q9CQI7	PF00076	152	211	5.581183333333333	59	G5AMI2	152	211	4.0295000000000005	59
P28663	PF14938	8	287	1.570725	279	G5CBD1	9	288	1.570882142857143	279
P58660	PF00619	27	113	0.4604252873563218	86	G5AYX1	28	114	0.19126436781609196	86
Q6PGG6	PF01926	247	308	0.9982580645161291	61	G5BF11	296	357	1.094758064516129	61
Q6P6J0	PF00383	47	119	8.532178082191779	72	G5BL54	1	72	7.997583333333335	71
Q32M00	PF07716	26	74	0.537204081632653	48	G5BYF8	23	71	0.5579183673469387	48
Q91W18	PF00627	287	322	1.1603611111111112	35	G5BCM9	195	230	1.416	35
Q91W18	PF06003	644	705	1.5754354838709668	61	G5BCM9	552	612	4.2644098360655756	60
Q91W18	PF08585	118	164	3.5846808510638306	46	G5BCM9	26	72	3.3257872340425534	46
Q9D338	PF01245	107	192	4.1933953488372095	85	G5AKE1	108	193	6.057255813953493	85
Q64387	PF01160	20	64	0.6783555555555556	44	G5B4Z8	21	65	0.0	44
Q3U3C9	PF12540	71	196	0.058261904761904765	125	G5BJF7	172	298	0.05766929133858267	126
Q3U3C9	PF12540	732	871	2.88485	139	G5BJF7	825	964	2.84415	139
O08638	PF00063	86	770	5.507874452554743	684	G5AK10	87	771	5.397510948905111	684
O08638	PF01576	847	1927	0.048775208140610565	1080	G5AK10	848	1928	0.03565864939870491	1080
O08638	PF02736	32	71	0.15575	39	G5AK10	33	72	0.155875	39
Q9JLC6	PF07716	229	282	0.056666666666666664	53	G5BVD1	180	233	0.056666666666666664	53
Q8K207	PF15389	63	104	0.0	41	G5BGP8	123	163	0.0	40
Q8BS39	PF14989	16	164	0.39932214765100665	148	G5BLZ2	17	165	0.11436241610738256	148
Q8C636	PF15015	5	568	1.7206365248226947	563	G5BT68	6	571	1.660067137809187	565
P55097	PF00112	115	326	2.7783679245283013	211	G5AJX8	116	327	1.8776839622641517	211
P55097	PF08246	25	84	0.0	59	G5AJX8	26	85	0.0	59
Q66JZ4	PF14687	23	133	12.94255855855856	110	G5C206	24	133	15.327190909090907	109
Q66JZ4	PF14688	188	492	2.187203278688526	304	G5C206	188	490	3.6321716171617178	302
Q8BKS9	PF08144	432	544	5.464106194690263	112	G5C7C6	399	510	6.083071428571432	111
Q80TR4	PF00008	928	959	0.0	31	G5C0B3	879	910	0.0	31
Q80TR4	PF00008	973	1000	0.0	27	G5C0B3	924	951	0.0	27
Q80TR4	PF00008	1046	1078	0.0	32	G5C0B3	997	1029	0.0	32
Q80TR4	PF00008	1086	1114	0.16958620689655174	28	G5C0B3	1037	1065	0.0	28
Q80TR4	PF01462	32	59	3.571428571428572e-05	27	G5C0B3	231	258	0.0	27
Q80TR4	PF01462	281	307	0.0	26	G5C0B3	232	258	0.0	26
Q80TR4	PF01462	511	538	0.0	27	G5C0B3	462	489	0.0	27
Q80TR4	PF01462	732	759	0.0	27	G5C0B3	683	710	0.0	27
Q80TR4	PF01463	238	263	0.3363461538461538	25	G5C0B3	189	214	0.14796153846153845	25
Q80TR4	PF01463	463	487	0.0	24	G5C0B3	414	438	0.0	24
Q80TR4	PF01463	694	719	0.0	25	G5C0B3	645	670	0.0	25
Q80TR4	PF01463	890	913	0.0	23	G5C0B3	841	864	0.0	23
Q80TR4	PF02210	1191	1318	0.2571249999999999	127	G5C0B3	1145	1272	0.2558593749999999	127
Q80TR4	PF12661	1013	1031	0.0	18	G5C0B3	964	982	0.0	18
Q80TR4	PF12661	1132	1153	0.0	21	G5C0B3	1086	1107	0.0	21
Q80TR4	PF12661	1343	1364	0.0	21	G5C0B3	1297	1318	0.0	21
Q80TR4	PF13855	65	119	0.2707272727272728	54	G5C0B3	568	621	1.3518518518518519	53
Q80TR4	PF13855	158	211	0.024814814814814817	53	G5C0B3	130	182	0.025283018867924528	52
Q80TR4	PF13855	310	368	1.399457627118644	58	G5C0B3	261	319	1.3995593220338984	58
Q80TR4	PF13855	381	439	9.88150847457627	58	G5C0B3	332	390	8.559016949152543	58
Q80TR4	PF13855	590	648	1.0464406779661015	58	G5C0B3	541	599	1.0465254237288135	58
Q80TR4	PF13855	785	842	7.318741379310343	57	G5C0B3	736	793	7.155844827586208	57
Q9QXK9	PF00017	115	190	9.189868421052632	75	G5BLQ1	115	160	0.2840434782608696	45
Q8R3D1	PF00566	208	366	19.052257861635226	158	G5ASD9	259	417	19.05077358490564	158
Q14AX6	PF00069	724	1015	3.7046130136986326	291	G5BRW7	727	1018	3.6478767123287703	291
P70182	PF01504	151	431	3.983085409252667	280	G5AJZ7	135	415	3.9845480427046263	280
Q99PJ0	PF07679	37	131	1.7913052631578943	94	G5C0D5	38	132	1.979968421052632	94
Q99PJ0	PF13927	135	204	1.716242857142857	69	G5C0D5	136	205	1.7159285714285712	69
Q99PJ0	PF13927	221	298	2.8574743589743594	77	G5C0D5	222	299	7.050038461538465	77
Q9CXV1	PF05328	55	157	20.69957281553398	102	G5CAZ4	17	120	20.485788461538466	103
Q8BHJ9	PF11708	161	433	0.053717948717948716	272	G5BEM4	162	434	0.06396703296703296	272
Q9CPW4	PF04699	9	150	0.9352042253521128	141	G5B445	10	145	0.7302666666666666	135
Q8K352	PF07647	252	312	0.4771967213114754	60	G5AU67	304	364	0.4999836065573772	60
Q8K352	PF07653	176	228	10.49520754716981	52	G5AU67	228	280	11.366509433962266	52
Q8K352	PF12485	20	173	0.36656493506493504	153	G5AU67	72	225	0.4549480519480518	153
Q91WE4	PF14975	1	64	8.8361875	63	G5AX29	2	69	8.136264705882354	67
Q91V92	PF00285	956	1070	8.099913043478262	114	G5B0L4	1012	1123	7.738785714285713	111
Q91V92	PF00549	649	773	7.7917200000000015	124	G5B0L4	633	757	7.7596479999999985	124
Q91V92	PF02629	485	589	7.459142857142859	104	G5B0L4	469	573	5.967047619047619	104
Q91V92	PF16114	270	419	6.419713333333332	149	G5B0L4	248	397	6.3884066666666675	149
P49615	PF00069	3	285	4.0876466431095375	282	G5AMT0	4	293	3.982444827586208	289
Q7TSQ1	PF00059	404	521	6.869838983050849	117	G5B5W5	323	440	6.919542372881351	117
Q7TSQ1	PF00188	138	269	4.084856060606062	131	G5B5W5	58	188	5.634396946564887	130
Q921F4	PF00076	128	176	8.291285714285715	48	G5CA72	17	65	8.280816326530612	48
Q921F4	PF11835	213	291	6.794164556962023	78	G5CA72	102	180	7.457063291139232	78
Q921F4	PF13893	356	481	5.325571428571427	125	G5CA72	245	370	5.267103174603173	125
Q08091	PF00307	28	131	1.3046538461538462	103	G5AJT7	29	132	1.306048076923077	103
Q08091	PF00402	163	187	0.0	24	G5AJT7	164	188	0.0	24
Q08091	PF00402	203	227	0.01368	24	G5AJT7	204	228	0.00912	24
Q08091	PF00402	243	265	0.0	22	G5AJT7	244	266	0.011304347826086957	22
Q62415	PF00018	1022	1069	6.539812499999999	47	G5AWH7	1024	1071	5.896124999999999	47
Q62415	PF12796	890	976	6.248471264367817	86	G5AWH7	892	978	6.430528735632184	86
Q9QXV3	PF12998	45	112	0.17548529411764704	67	G5AZ43	155	222	0.17089705882352946	67
Q61510	PF00622	515	625	12.25445945945946	110	G5C5J0	507	619	11.20926548672566	112
Q61510	PF13765	463	508	6.529260869565215	45	G5C5J0	455	500	0.6412173913043476	45
Q61510	PF15227	12	52	0.02280487804878049	40	G5C5J0	13	53	0.07663414634146341	40
P16460	PF00764	7	401	4.908460759493667	394	G5AMV5	58	477	5.476590476190472	419
P47708	PF00168	394	497	0.010096153846153848	103	G5AKV8	381	484	0.017471153846153845	103
P47708	PF00168	553	656	4.4540673076923065	103	G5AKV8	540	643	3.7824038461538447	103
P47708	PF02318	44	156	0.078070796460177	112	G5AKV8	45	157	0.1230442477876106	112
Q99N11	PF00782	13	139	8.978464566929134	126	G5BSE6	1	127	8.911905511811025	126
Q99K23	PF07910	271	452	2.0481483516483516	181	G5B2W5	294	475	4.967307692307694	181
P16858	PF00044	8	101	5.797510638297874	93	G5CAP7	1	102	6.245647058823528	101
P16858	PF02800	154	311	1.0892848101265822	157	G5CAP7	155	312	1.1036329113924053	157
O54931	PF15304	726	884	0.013867924528301887	158	G5C097	808	953	0.015273972602739725	145
Q99LG4	PF16669	318	430	21.03638053097345	112	G5B5Q3	318	430	21.12431858407081	112
Q69ZI1	PF00018	139	184	0.056826086956521735	45	G5BC19	14	59	0.08326086956521739	45
Q69ZI1	PF14604	202	254	9.014377358490568	52	G5BC19	77	129	9.013622641509436	52
Q69ZI1	PF14604	458	508	12.044549019607846	50	G5BC19	327	377	10.486921568627453	50
Q69ZI1	PF14604	839	889	0.3951960784313725	50	G5BC19	710	760	0.3922745098039216	50
Q9QZM8	PF04300	108	280	0.3754971098265897	172	G5AM97	160	332	0.4518034682080924	172
Q9QZM8	PF12937	19	58	7.333875000000001	39	G5AM97	83	122	7.143325000000003	39
P36552	PF01218	139	441	2.6877491749174918	302	G5C9P9	138	440	2.253818481848185	302
P59054	PF16019	83	303	2.233425339366516	220	G5C5N4	84	304	2.3123846153846155	220
O88466	PF00400	1529	1561	10.458848484848485	32	G5BM29	1262	1294	6.723969696969697	32
O88466	PF00400	1565	1606	1.6745238095238095	41	G5BM29	1376	1417	2.4394761904761912	41
Q8BUM9	PF00443	100	706	4.321186161449755	606	G5B5H1	103	722	4.289045161290319	619
B2KGE5	PF14982	59	122	0.7552500000000001	63	G5B5L7	87	150	0.757703125	63
Q8C8R3	PF00023	128	154	3.0093333333333336	26	G5BMD6	102	128	3.0054444444444446	26
Q8C8R3	PF00023	330	357	0.0	27	G5BMD6	304	331	0.0	27
Q8C8R3	PF00531	3522	3603	1.311780487804877	81	G5BMD6	3527	3608	0.919658536585366	81
Q8C8R3	PF00791	969	1066	4.3510714285714265	97	G5BMD6	943	1073	2.5655725190839687	130
Q8C8R3	PF00791	1128	1204	0.8787142857142861	76	G5BMD6	1135	1211	0.05128571428571428	76
Q8C8R3	PF12796	36	125	3.278511111111112	89	G5BMD6	10	99	3.038566666666666	89
Q8C8R3	PF12796	262	322	0.0	60	G5BMD6	236	296	0.0	60
Q8C8R3	PF12796	391	460	9.446842857142855	69	G5BMD6	365	434	9.446057142857144	69
Q8C8R3	PF12796	467	553	2.332344827586206	86	G5BMD6	441	527	2.3297931034482757	86
Q8C8R3	PF12796	561	624	8.068750000000001	63	G5BMD6	535	598	8.067656250000002	63
Q8C8R3	PF12796	626	689	5.8477187499999985	63	G5BMD6	600	663	4.869828125	63
Q8C8R3	PF13637	192	252	4.140688524590164	60	G5BMD6	166	226	4.152311475409836	60
Q8C8R3	PF13637	728	780	8.770169811320756	52	G5BMD6	702	754	8.659716981132076	52
Q8C8R3	PF17809	1290	1419	7.866861538461539	129	G5BMD6	1297	1426	7.862284615384616	129
Q9DC63	PF04379	294	382	6.263393258426968	88	G5BKJ3	285	373	7.304359550561799	88
Q9DC63	PF09346	120	249	2.9228461538461534	129	G5BKJ3	111	240	3.1530076923076935	129
Q9DC63	PF12937	13	57	16.20402222222222	44	G5BKJ3	4	48	15.481133333333334	44
Q811U4	PF00350	77	236	5.4916187500000015	159	G5C1G1	78	237	5.7248125000000005	159
Q811U4	PF04799	575	733	18.21538364779873	158	G5C1G1	576	734	16.390246835443048	158
P52963	PF00373	104	210	0.7293457943925233	106	G5BCY1	97	203	0.7148130841121496	106
P52963	PF08736	310	354	0.0	44	G5BCY1	303	347	0.0	44
P52963	PF09379	31	80	0.16960000000000006	49	G5BCY1	24	73	0.18332	49
P52963	PF09380	215	296	1.380158536585366	81	G5BCY1	208	289	5.476804878048779	81
Q9QXN5	PF05153	37	284	2.4445322580645152	247	G5B2G7	24	271	4.501526315789472	247
Q8BX65	PF15316	73	246	4.462586206896552	173	G5ARD5	25	198	5.219531791907515	173
Q80XB4	PF00412	5	56	0.07657692307692307	51	G5BKD6	6	57	0.07680769230769229	51
Q80XB4	PF00880	312	338	0.0	26	G5BKD6	316	342	0.0	26
Q80XB4	PF00880	490	516	0.0	26	G5BKD6	494	520	0.0	26
Q80XB4	PF00880	524	551	0.0	27	G5BKD6	528	555	0.0	27
Q80XB4	PF00880	560	587	0.43835714285714295	27	G5BKD6	564	599	0.32291666666666674	35
Q80XB4	PF00880	598	621	0.0	23	G5BKD6	610	633	0.0	23
Q80XB4	PF00880	765	790	0.0	25	G5BKD6	777	802	0.4282692307692307	25
Q80XB4	PF00880	801	825	8.889080000000002	24	G5BKD6	813	837	5.8479600000000005	24
Q80XB4	PF00880	841	863	0.0	22	G5BKD6	853	875	0.0	22
Q80XB4	PF00880	1042	1069	0.0	27	G5BKD6	1054	1081	0.0	27
Q80XB4	PF00880	1214	1238	0.0	24	G5BKD6	1226	1250	0.0	24
Q80XB4	PF00880	1251	1273	0.0	22	G5BKD6	1263	1284	0.0	21
Q80XB4	PF00880	1492	1518	0.0	26	G5BKD6	1504	1530	0.0	26
Q80XB4	PF00880	1631	1655	0.0	24	G5BKD6	1643	1667	0.0	24
P70389	PF01462	39	72	0.13273529411764706	33	G5BY64	77	109	0.03718181818181818	32
P70389	PF13855	122	181	0.2275833333333333	59	G5BY64	159	218	1.1356000000000002	59
P70389	PF13855	218	276	1.1937627118644067	58	G5BY64	255	313	3.9487457627118636	58
P70389	PF13855	291	349	0.00030508474576271185	58	G5BY64	328	386	0.0	58
P70389	PF13855	386	445	0.014583333333333334	59	G5BY64	423	482	0.01475	59
Q9CYI4	PF03194	5	242	0.16233193277310926	237	G5BXX9	6	243	0.16255882352941173	237
Q60948	PF00010	54	105	0.013269230769230771	51	G5BCH8	26	77	0.012884615384615385	51
Q9CY45	PF10237	45	206	1.774512345679013	161	G5BKV4	45	206	3.680432098765433	161
P61211	PF00025	17	175	9.747949685534588	158	G5BBI9	1	159	9.309949685534589	158
P28301	PF01186	206	407	0.1588118811881188	201	G5AK90	25	226	0.15974752475247514	201
P63139	PF00808	57	121	5.316261538461539	64	G5AR44	118	182	5.513846153846153	64
Q3UFY0	PF06102	74	236	0.013466257668711656	162	G5BNL2	88	250	0.012423312883435586	162
Q9Z1F9	PF00899	9	438	5.098597674418609	429	G5BXL5	10	441	5.145962962962961	431
Q9Z1F9	PF14732	449	534	10.681244186046513	85	G5BXL5	452	537	8.154197674418606	85
Q9Z1F9	PF16195	546	632	0.0	86	G5BXL5	549	635	0.0	86
Q8VBV7	PF10075	33	164	10.312659090909092	131	G5AY49	34	165	10.310280303030305	131
Q8BIV3	PF02985	916	942	0.4935925925925925	26	G5B6S0	917	943	0.4943703703703704	26
Q8BIV3	PF13646	370	473	12.962192307692305	103	G5B6S0	371	474	12.826557692307693	103
Q8BIV3	PF18808	278	364	4.825597701149425	86	G5B6S0	279	365	4.828666666666666	86
Q8BIV3	PF18816	1012	1058	10.086999999999998	46	G5B6S0	1013	1059	3.984723404255319	46
Q8BIV3	PF18829	772	879	7.495287037037038	107	G5B6S0	773	880	7.663787037037037	107
Q7TSG5	PF07653	70	120	0.0	50	G5C6F9	184	233	0.0	49
Q923G2	PF03870	6	125	4.18715	119	G5BTC0	7	124	4.73698305084746	117
Q8CHP0	PF00642	770	788	0.0	18	G5AWF7	763	781	0.0	18
P70698	PF00117	310	541	5.022021551724138	231	G5AQJ8	311	542	5.054129310344829	231
P70698	PF06418	1	271	1.8125055350553496	270	G5AQJ8	2	272	1.5525166051660508	270
Q3UM45	PF12799	120	160	0.13987804878048782	40	G5C3R5	120	160	0.6681951219512194	40
Q3UM45	PF12799	208	249	4.294357142857144	41	G5C3R5	208	249	1.2151666666666667	41
Q3UM45	PF14580	258	358	0.0	100	G5C3R5	258	358	0.008455445544554456	100
Q3TZA2	PF00069	3	285	4.690024734982332	282	G5CA64	4	286	2.914872791519433	282
P62322	PF01423	16	83	3.4140588235294134	67	G5AZG5	8	75	3.4321470588235297	67
O70571	PF02518	244	364	5.880132231404959	120	G5AJS6	245	365	8.266512396694214	120
O70571	PF10436	33	194	2.4366111111111106	161	G5AJS6	34	195	1.5583395061728398	161
Q8VCB2	PF11232	396	545	4.154080000000001	149	G5B8Q9	419	568	4.151720000000003	149
Q8VCB2	PF11235	227	382	0.14935897435897433	155	G5B8Q9	250	405	0.13007051282051285	155
Q8VCB2	PF11244	662	744	0.0	82	G5B8Q9	685	768	0.0	83
Q8VCB2	PF11265	14	225	6.209660377358494	211	G5B8Q9	37	248	6.209117924528298	211
Q9Z1D1	PF00076	240	302	3.117650793650793	62	G5B343	248	310	3.1225714285714288	62
Q9Z1D1	PF12353	58	174	0.7608290598290598	116	G5B343	59	182	0.7153709677419355	123
E9Q6P5	PF07719	731	762	0.037125	31	G5AZZ4	692	723	0.02765625	31
E9Q6P5	PF12895	495	572	15.04541025641026	77	G5AZZ4	456	533	15.028525641025643	77
E9Q6P5	PF13181	397	429	15.672484848484846	32	G5AZZ4	358	390	15.620090909090912	32
E9Q6P5	PF13432	769	824	3.422803571428572	55	G5AZZ4	730	785	2.6406607142857137	55
Q921Y0	PF03637	32	203	4.143575581395348	171	G5AXG5	33	204	4.143575581395348	171
Q8BI06	PF10162	52	164	3.9237787610619472	112	G5BEY8	55	167	5.114929203539823	112
Q8BI06	PF13330	324	402	0.0	78	G5BEY8	303	381	0.0	78
Q8BI06	PF15711	186	276	9.421186813186813	90	G5BEY8	189	255	10.144626865671643	66
Q8BI06	PF15711	1244	1329	8.845534883720926	85	G5BEY8	1252	1337	16.330965116279067	85
P59048	PF01920	28	105	3.901230769230769	77	G5BR04	29	106	7.3483333333333345	77
P41230	PF01388	81	164	6.546714285714287	83	G5BAY8	1017	1100	6.566095238095237	83
P41230	PF02373	500	616	12.293427350427361	116	G5BAY8	1383	1499	11.507547008547	116
P41230	PF02375	14	47	0.4275	33	G5BAY8	950	983	0.4297058823529412	33
P41230	PF02928	706	758	1.6812264150943397	52	G5BAY8	1589	1641	1.6887735849056609	52
P41230	PF08429	771	1099	0.5108267477203647	328	G5BAY8	1654	1979	0.5188006134969326	325
O55222	PF07714	193	444	2.607424603174604	251	G5BBQ5	194	445	2.606785714285715	251
O55222	PF12796	5	62	0.2757758620689654	57	G5BBQ5	6	63	0.2757758620689654	57
O55222	PF13857	66	106	1.0418292682926829	40	G5BBQ5	67	107	1.4698536585365851	40
Q60925	PF07716	253	306	0.0380925925925926	53	G5B892	207	260	0.0958148148148148	53
Q3V2K1	PF15874	33	100	0.2741911764705883	67	G5BW32	5	72	2.8657205882352947	67
P41317	PF00059	140	241	3.643686274509805	101	G5CAB8	143	244	0.19941176470588232	101
P41317	PF01391	37	92	0.0	55	G5CAB8	40	94	0.0	54
Q6NXI6	PF04818	111	137	2.234296296296296	26	G5BH38	16	42	1.1695555555555557	26
Q6NXI6	PF16566	249	338	0.03883333333333333	89	G5BH38	196	285	0.03906666666666666	89
Q9WVB2	PF00400	473	507	11.449771428571427	34	G5AKR0	437	471	11.349914285714286	34
Q9WVB2	PF00400	574	598	3.9065999999999987	24	G5AKR0	538	562	3.25484	24
Q9WVB2	PF00400	605	640	0.0	35	G5AKR0	569	604	0.0	35
Q9WVB2	PF03920	40	61	0.0	21	G5AKR0	27	48	9.422227272727273	21
Q9WVB2	PF03920	85	151	0.34391044776119395	66	G5AKR0	49	114	1.1210757575757573	65
Q8R3N1	PF04147	25	848	4.830675970873783	823	G5BCG9	19	837	4.373390720390721	818
Q8VED8	PF05308	40	298	1.5690463320463317	258	G5C1A6	24	283	0.6554307692307693	259
Q8CJG0	PF02170	246	365	0.25307500000000005	119	G5C8Y7	241	360	0.18624166666666667	119
Q8CJG0	PF02171	518	817	5.983813333333335	299	G5C8Y7	513	812	5.683976666666671	299
Q8CJG0	PF08699	176	226	6.695509803921566	50	G5C8Y7	171	221	6.693745098039213	50
Q8CJG0	PF16486	36	166	0.4391832061068702	130	G5C8Y7	31	161	0.4389694656488549	130
Q8CJG0	PF16487	429	510	8.294280487804878	81	G5C8Y7	424	505	8.310243902439026	81
Q8CJG0	PF16488	374	420	4.490617021276597	46	G5C8Y7	369	415	4.489446808510638	46
Q8CGC4	PF09532	246	328	0.0	82	G5BDX3	325	406	0.0	81
Q8CGC4	PF12701	42	80	0.4591794871794872	38	G5BDX3	135	173	0.4674358974358974	38
P10107	PF00191	46	109	4.99515625	63	G5AS29	47	110	1.1725000000000003	63
P10107	PF00191	117	182	0.16277272727272726	65	G5AS29	118	183	0.4956515151515152	65
P10107	PF00191	201	265	10.212138461538462	64	G5AS29	202	266	5.132415384615382	64
P10107	PF00191	276	341	6.946999999999999	65	G5AS29	277	342	7.157181818181818	65
Q8BMD5	PF00383	82	151	0.9911428571428572	69	G5B9Y7	83	152	0.9896857142857142	69
Q8BMD5	PF00383	320	443	5.118225806451614	123	G5B9Y7	321	444	4.7255403225806445	123
Q91WK1	PF00622	86	192	2.5433738317757006	106	G5BB71	87	193	3.004467289719627	106
Q9CQW3	PF00008	92	120	0.0	28	G5AVW0	193	221	0.0	28
Q9CQW3	PF00089	241	342	0.6419117647058824	101	G5AVW0	325	426	0.4221274509803922	101
Q9CQW3	PF00594	45	78	0.012823529411764706	33	G5AVW0	162	194	0.0	32
Q9CQW3	PF14670	134	164	0.0	30	G5AVW0	235	265	0.0	30
Q8CFE4	PF00069	41	326	5.138325174825175	285	G5BBI2	42	327	4.6461468531468535	285
Q9D0F9	PF00408	464	524	0.0	60	G5BSN2	606	666	0.0	60
Q9D0F9	PF02878	82	156	2.3971066666666663	74	G5BSN2	224	298	2.3870400000000003	74
Q9D0F9	PF02879	194	299	0.2075283018867924	105	G5BSN2	336	441	0.15353773584905658	105
Q9D0F9	PF02880	305	419	15.697286956521742	114	G5BSN2	447	560	15.890763157894735	113
Q9Z2A5	PF04376	22	90	0.0	68	G5B5S2	23	90	0.008294117647058823	67
Q9Z2A5	PF04377	291	426	15.694948529411773	135	G5B5S2	292	427	16.038867647058822	135
Q8K4J0	PF07522	239	332	2.1350851063829785	93	G5C5E1	239	331	1.4081182795698926	92
Q8CHE4	PF00169	506	589	10.019095238095236	83	G5BH13	26	109	9.522047619047619	83
Q8CHE4	PF00481	1132	1370	5.547761506276151	238	G5BH13	639	877	5.7145146443514605	238
Q8CHE4	PF13516	786	802	0.0	16	G5BH13	293	309	0.009705882352941177	16
Q8CHE4	PF13855	669	726	0.4045344827586208	57	G5BH13	189	233	0.7166888888888892	44
Q8CHE4	PF13855	969	1027	0.0	58	G5BH13	476	534	0.0	58
Q7TN12	PF11819	86	215	0.0468076923076923	129	G5B3A9	87	216	0.03457692307692308	129
O88942	PF00554	428	588	1.3380310559006208	160	G5AP09	433	593	1.3117888198757763	160
O88942	PF16179	635	696	3.8295806451612906	61	G5AP09	698	759	5.141	61
Q07279	PF03131	238	328	0.12208791208791205	90	G5BID6	239	329	0.11818681318681318	90
Q921Z5	PF05527	15	194	3.621944444444445	179	G5AX61	16	195	5.679605555555555	179
Q5SV80	PF00063	37	672	4.88965880503145	635	G5ARB9	427	1050	5.376975961538467	623
Q5SV80	PF00612	783	803	6.062571428571428	20	G5ARB9	1154	1174	5.700809523809522	20
Q8C753	PF14652	951	1097	0.9660816326530612	146	G5AJV3	1116	1262	2.012761904761905	146
Q8C753	PF14652	1204	1522	5.043915360501573	318	G5AJV3	1368	1649	4.087152482269503	281
P27600	PF00503	83	367	7.230757894736844	284	G5BPW5	1	285	7.175094736842103	284
Q3SYP2	PF00089	29	261	6.5219227467811125	232	G5BRS6	30	262	2.8896309012875534	232
Q61176	PF00491	18	299	7.3256099290780154	281	G5C776	15	296	7.116421985815606	281
Q6NS52	PF00130	243	293	1.0550784313725492	50	G5BC98	237	287	1.0571176470588235	50
Q6NS52	PF00130	308	358	0.2893921568627452	50	G5BC98	302	352	2.2229215686274517	50
Q6NS52	PF00609	580	706	0.7111732283464561	126	G5BC98	575	700	0.8905634920634923	125
Q6NS52	PF00781	435	550	4.711672413793099	115	G5BC98	430	545	4.748991379310342	115
Q6NS52	PF13499	149	216	0.16727941176470584	67	G5BC98	143	210	0.16752941176470587	67
Q6NS52	PF14513	5	147	5.51513986013986	142	G5BC98	6	141	6.564779411764707	135
Q8K3J5	PF00651	23	125	3.84104854368932	102	G5BCR8	24	126	3.8546990291262113	102
Q8K3J5	PF12874	287	307	0.0	20	G5BCR8	289	309	0.0	20
Q8K3J5	PF12874	391	410	0.0621	19	G5BCR8	393	412	0.0624	19
Q6IE82	PF10513	17	176	0.4168250000000001	159	G5AZF5	18	177	0.3939625	159
Q6IE82	PF13831	214	246	0.08000000000000003	32	G5AZF5	215	247	0.15954545454545455	32
Q6IE82	PF13832	253	364	1.7984375	111	G5AZF5	254	365	2.9990714285714284	111
Q6NVF4	PF13538	854	900	21.103021276595744	46	G5AWA3	884	930	20.220404255319146	46
Q6NVF4	PF13604	434	652	4.316694063926942	218	G5AWA3	458	677	6.271468181818188	219
Q9JJ66	PF00400	300	335	0.026527777777777782	35	G5AQG1	302	337	0.026388888888888892	35
Q9JJ66	PF00400	346	385	0.118225	39	G5AQG1	348	387	0.149025	39
Q9JJ66	PF00400	435	469	0.17031428571428572	34	G5AQG1	437	471	0.2504	34
Q9JJ66	PF12894	222	277	5.913589285714289	55	G5AQG1	224	279	6.096625	55
E9Q6Z5	PF15334	25	334	1.7233290322580648	309	G5BHV8	55	361	0.3293713355048861	306
Q8R2Q4	PF00009	68	350	0.982151943462898	282	G5B667	66	348	1.0857773851590116	282
Q8R2Q4	PF00679	681	765	1.9754705882352932	84	G5B667	680	764	2.869600000000001	84
Q8R2Q4	PF03764	559	677	0.2842605042016807	118	G5B667	558	676	0.07229411764705884	118
Q8R2Q4	PF14492	483	556	3.2838783783783785	73	G5B667	482	555	3.2596351351351345	73
Q80W71	PF00169	11	52	22.299047619047624	41	G5BRM2	13	53	4.166902439024391	40
Q80W71	PF08718	329	469	5.250560283687944	140	G5BRM2	280	420	5.689758865248227	140
P11087	PF00093	30	85	3.4576428571428566	55	G5C4J0	38	93	0.033482142857142856	55
P11087	PF01391	101	144	0.0	43	G5C4J0	515	557	0.0	42
P11087	PF01391	167	225	0.0	58	G5C4J0	176	234	0.0	58
P11087	PF01391	224	283	0.0	59	G5C4J0	233	292	0.0	59
P11087	PF01391	284	333	0.0	49	G5C4J0	509	557	0.0	48
P11087	PF01391	767	824	0.0	57	G5C4J0	776	832	0.0	56
P11087	PF01391	827	886	0.0	59	G5C4J0	836	895	0.0	59
P11087	PF01391	1007	1065	0.0	58	G5C4J0	1016	1074	0.0	58
P11087	PF01391	1067	1125	0.0	58	G5C4J0	1076	1134	0.0	58
P11087	PF01391	1121	1179	0.0	58	G5C4J0	704	761	0.0	57
P11087	PF01410	1216	1451	2.9924703389830496	235	G5C4J0	1224	1447	4.184165178571428	223
P40694	PF01424	728	781	0.0	53	G5BSR5	726	779	0.14631481481481484	53
P40694	PF13086	190	408	2.3047351598173527	218	G5BSR5	192	410	2.2754018264840177	218
P40694	PF13087	416	612	4.6863096446700485	196	G5BSR5	418	614	4.123751269035534	196
Q8R0Y6	PF00171	429	897	2.1716460554370998	468	G5B0V1	432	900	2.188232409381662	468
Q8R0Y6	PF00551	0	179	4.833149999999998	179	G5B0V1	3	182	4.958861111111111	179
Q8R0Y6	PF02911	204	308	1.7084476190476192	104	G5B0V1	207	311	1.711961904761905	104
P06880	PF00103	14	213	4.604565	199	G5BDI6	15	214	3.6936649999999975	199
Q8BSP2	PF06278	10	122	4.1425132743362845	112	G5B2G5	11	123	4.12187610619469	112
Q8BSP2	PF16858	307	596	0.3823172413793103	289	G5B2G5	313	598	1.587758741258741	285
Q8BSP2	PF16869	147	230	0.024880952380952382	83	G5B2G5	148	220	0.09636986301369864	72
O08739	PF00962	308	715	5.9444632352941165	407	G5BFH2	367	774	5.9416176470588224	407
Q2KHI9	PF00493	303	443	7.2089078014184365	140	G5C1T9	304	443	7.499142857142866	139
Q2KHI9	PF17207	116	244	6.345062015503876	128	G5C1T9	117	244	1.630570312499999	127
Q2KHI9	PF17855	521	603	1.5968795180722892	82	G5C1T9	581	663	4.591987951807228	82
Q8CHI8	PF00176	1102	1372	4.878752767527674	270	G5AWT1	1101	1371	4.29408856088561	270
Q8CHI8	PF00271	1814	1927	19.241596491228066	113	G5AWT1	1899	2012	19.11913157894736	113
Q8CHI8	PF07529	801	868	0.0	67	G5AWT1	800	867	0.0	67
Q8CHI8	PF15790	0	505	0.3690671936758897	505	G5AWT1	1	505	0.3768673267326733	504
P47934	PF00755	34	614	4.8581893287435385	580	G5ASC5	35	615	3.8263648881239267	580
Q920E5	PF00348	43	306	7.006920454545456	263	G5ARB7	105	367	9.325946768060833	262
Q8K194	PF08648	97	125	0.6012758620689654	28	G5C6W0	98	125	0.4524074074074074	27
O08689	PF00019	280	374	2.9321789473684223	94	G5BLW3	280	372	2.9929354838709674	92
O08689	PF00688	42	238	4.606598984771573	196	G5BLW3	42	238	4.622238578680203	196
O88491	PF00855	1653	1741	2.6953595505617978	88	G5BQ01	1756	1844	2.6862471910112355	88
O88491	PF00856	1850	1956	6.743943925233648	106	G5BQ01	1953	2059	6.742112149532714	106
O88491	PF17907	1798	1836	0.0	38	G5BQ01	1901	1939	0.0	38
O88491	PF17982	2058	2107	2.1993400000000003	49	G5BQ01	2161	2210	2.1981400000000004	49
Q3TEI4	PF17663	0	1022	0.2025552297165202	1022	G5AL73	1	976	0.2057210256410256	975
Q8BG34	PF00789	191	265	1.1987466666666666	74	G5C4W3	197	271	4.514293333333334	74
P97378	PF00041	249	320	0.018000000000000002	71	G5BSQ2	233	304	3.4736388888888894	71
P97378	PF00041	500	518	0.07121052631578949	18	G5BSQ2	417	434	11.192611111111109	17
P97378	PF00041	535	622	16.084136363636365	87	G5BSQ2	452	539	13.224124999999995	87
P97378	PF06328	27	116	11.525988888888893	89	G5BSQ2	28	106	3.4851518987341765	78
Q00286	PF00046	214	270	1.8047894736842105	56	G5C5J2	241	297	1.7773333333333334	56
Q00286	PF00157	128	197	0.10664285714285714	69	G5C5J2	155	224	0.10571428571428568	69
Q8BNJ2	PF00090	525	569	0.0	44	G5BWI1	530	574	0.0	44
Q8BNJ2	PF01421	213	423	4.23336018957346	210	G5BWI1	218	428	4.660530805687207	210
Q8BNJ2	PF01562	73	164	1.554815217391304	91	G5BWI1	78	168	1.5739450549450549	90
Q8BNJ2	PF05986	682	798	4.002000000000002	116	G5BWI1	687	803	4.45891452991453	116
Q8BNJ2	PF17771	434	502	0.31869565217391305	68	G5BWI1	439	507	0.3192608695652173	68
P54729	PF00627	373	407	0.3160285714285714	34	G5AMU1	374	407	0.0	33
P54729	PF00627	432	465	0.0	33	G5AMU1	433	466	0.0	33
P54729	PF00627	489	524	2.6856388888888887	35	G5AMU1	490	525	2.1853333333333342	35
P54729	PF18037	69	163	0.19365263157894733	94	G5AMU1	70	163	0.1973404255319148	93
Q8VDQ8	PF02146	83	267	3.9520486486486477	184	G5AMA2	84	268	3.8614216216216235	184
Q8VEL9	PF00071	116	261	8.859205479452053	145	G5ASJ4	118	262	9.22386896551724	144
Q6PGF2	PF02493	15	37	1.3926521739130435	22	G5C0B8	16	38	0.6623913043478261	22
Q6PGF2	PF02493	38	60	8.07678260869565	22	G5C0B8	39	61	8.076521739130435	22
Q6PGF2	PF02493	61	81	8.595619047619047	20	G5C0B8	62	82	8.513190476190477	20
Q6PGF2	PF02493	84	105	0.1425	21	G5C0B8	85	106	0.14227272727272727	21
Q9CXF0	PF00266	118	378	8.878375478927197	260	G5AZ95	119	378	10.529565384615383	259
Q5SVQ0	PF01530	185	213	0.0	28	G5C4P8	184	212	0.0	28
Q5SVQ0	PF01853	394	571	4.991337078651687	177	G5C4P8	393	570	4.99200561797753	177
Q5SVQ0	PF17772	338	389	0.0	51	G5C4P8	337	388	0.0	51
Q8CFI0	PF00397	222	251	0.01983333333333333	29	G5AYX9	232	261	0.01966666666666667	29
Q8CFI0	PF00397	415	444	0.01983333333333333	29	G5AYX9	404	433	0.026	29
Q8CFI0	PF00397	527	556	0.0	29	G5AYX9	516	545	0.0	29
Q8CFI0	PF00397	578	607	0.0	29	G5AYX9	567	596	0.0	29
Q8CFI0	PF00168	50	146	1.848752577319588	96	G5AYX9	60	156	4.856948453608246	96
Q8CFI0	PF00632	698	1000	7.114033003300331	302	G5AYX9	687	989	6.781181518151816	302
Q9JKX4	PF08164	429	482	0.03205555555555556	53	G5ARC3	458	510	0.033192307692307695	52
Q9JKX4	PF13339	186	338	0.09696078431372544	152	G5ARC3	216	367	0.5037171052631578	151
Q8BKJ9	PF02146	141	274	0.6125597014925369	133	G5BJ83	141	274	0.6128432835820891	133
Q640P7	PF07986	330	443	4.166561403508773	113	G5BT91	276	389	4.815236842105262	113
Q8CE33	PF00651	140	199	0.21740000000000007	59	G5B0L5	1	60	0.2179666666666666	59
Q8CE33	PF01344	445	486	0.049	41	G5B0L5	297	338	0.04933333333333333	41
Q8CE33	PF07707	205	306	6.954450980392157	101	G5B0L5	66	167	9.365941176470589	101
Q505F1	PF00104	367	559	8.854818652849739	192	G5C0T8	384	576	8.853652849740934	192
Q505F1	PF00105	99	166	0.3869117647058825	67	G5C0T8	114	181	0.3107205882352941	67
Q9JIG7	PF05667	0	596	1.792467336683418	596	G5BJK2	1	597	1.8021842546063656	596
O88978	PF14580	59	165	5.9635981308411194	106	G5C6Q2	182	288	4.5817943925233635	106
Q61749	PF01008	219	508	4.507172413793105	289	G5BZ06	240	529	4.5904724137930994	289
Q7M761	PF00089	51	293	3.7368847736625486	242	G5B7C8	22	264	1.5880493827160491	242
Q7M761	PF00431	333	417	8.048752941176469	84	G5B7C8	304	388	9.14395294117647	84
Q7M761	PF00431	438	537	5.6515200000000005	99	G5B7C8	409	508	2.3091800000000005	99
Q9JM99	PF00045	843	885	0.0	42	G5C6C3	1165	1207	0.0	42
Q9JM99	PF01033	28	65	0.0	37	G5C6C3	16	52	0.0	36
Q9JM99	PF01033	68	105	0.0	37	G5C6C3	16	53	0.0	37
Q9JM99	PF02389	408	489	0.0	81	G5C6C3	512	590	0.0	78
Q9JM99	PF02389	474	567	0.0	93	G5C6C3	498	589	0.0	91
Q9JM99	PF02389	538	618	0.0	80	G5C6C3	514	591	0.0	77
Q64317	PF00046	128	184	0.0	56	G5ANG1	129	185	0.0	56
Q9JMH3	PF13088	32	341	5.8049645161290275	309	G5BXG6	33	342	5.599896774193551	309
Q3V3K7	PF02485	114	372	4.740660231660233	258	G5CBD7	111	309	9.218738693467335	198
Q497M3	PF18778	41	204	4.085682926829267	163	G5B444	42	209	5.571357142857144	167
Q6P6J4	PF13532	51	231	3.64442541436464	180	G5AWY9	74	254	3.9145469613259687	180
Q8K3I8	PF14862	6	50	17.720577777777788	44	G5C6L3	52	94	17.493162790697674	42
Q0ZLH2	PF04598	0	234	4.909748936170214	234	G5B0U4	1	235	4.825374468085104	234
Q3UUV5	PF00018	302	341	2.87435	39	G5BY14	221	260	13.555474999999996	39
Q3UUV5	PF00169	107	207	6.614633663366338	100	G5BY14	15	115	7.227039603960392	100
P97386	PF00645	96	181	0.0	85	G5B758	97	182	0.0	85
P97386	PF01068	487	681	2.8997230769230757	194	G5B758	484	678	2.911466666666668	194
P97386	PF04675	265	437	2.5806994219653165	172	G5B758	265	434	2.7688294117647074	169
P97386	PF04679	709	818	2.251845454545453	109	G5B758	706	815	2.2457	109
P97386	PF16759	939	1009	14.9822676056338	70	G5B758	938	1008	15.751718309859159	70
Q8CCG4	PF14047	221	286	7.978621212121213	65	G5AUN7	168	232	1.1169846153846152	64
Q9D7B1	PF00035	369	431	11.550190476190474	62	G5C686	370	432	13.351809523809527	62
Q9D7B1	PF01207	14	284	0.9294723247232468	270	G5C686	15	285	2.4054797047970475	270
Q91ZF0	PF00226	9	77	7.433884057971016	68	G5C8J9	11	79	4.22863768115942	68
Q91ZF0	PF05207	94	144	0.7401568627450978	50	G5C8J9	96	146	0.0	50
Q8CEI1	PF01722	59	107	0.0	48	G5AXG6	51	99	0.0	48
Q91V88	PF00629	421	560	0.6971214285714286	139	G5AT24	420	558	0.8028776978417267	138
Q91V88	PF07645	88	119	0.0	31	G5AT24	211	243	0.0	32
Q91V88	PF07645	168	201	0.02661764705882353	33	G5AT24	166	199	0.5564705882352942	33
Q91V88	PF07645	213	252	0.0	39	G5AT24	211	250	0.0422	39
Q9DCX1	PF06581	18	275	4.499856589147287	257	G5BNN2	60	318	4.707329457364343	258
Q9QXT5	PF07546	28	94	0.031343283582089564	66	G5B8G5	28	94	0.017985074626865674	66
Q9QXT5	PF07645	137	176	0.1194	39	G5B8G5	137	176	0.0	39
Q4VBE8	PF00400	111	143	16.926121212121213	32	G5C5Y0	112	144	22.78348484848485	32
Q4VBE8	PF00400	261	296	0.3260555555555554	35	G5C5Y0	262	297	0.30197222222222225	35
Q4VBE8	PF14077	382	428	0.7528297872340421	46	G5C5Y0	383	427	0.011111111111111113	44
Q9WTK7	PF00069	52	308	1.9752996108949423	256	G5C5Z0	53	316	1.799810606060605	263
Q8K083	PF00096	129	151	0.11369565217391304	22	G5BL40	130	152	0.11391304347826088	22
Q8K083	PF00096	344	366	3.933652173913043	22	G5BL40	345	367	3.9374782608695655	22
Q8K083	PF00096	631	652	0.0	21	G5BL40	632	653	0.0	21
Q8K083	PF00096	754	774	0.0	20	G5BL40	753	773	0.0	20
Q8K083	PF13909	157	180	0.0	23	G5BL40	158	181	0.0	23
Q8K083	PF16606	656	738	0.007228915662650602	82	G5BL40	657	737	0.0	80
Q810P3	PF05706	5	166	7.984629629629632	161	G5BF85	2	164	9.628877300613498	162
Q9D5W4	PF14908	26	92	5.02858208955224	66	G5B519	1	67	6.894179104477611	66
Q9D5W4	PF18289	102	176	9.550733333333332	74	G5B519	77	151	18.37722666666668	74
P70453	PF00233	184	411	6.524201754385966	227	G5C171	147	332	6.944220430107527	185
Q9CYR6	PF00408	452	517	0.03725757575757576	65	G5BZP0	453	517	0.03123076923076924	64
Q9CYR6	PF02878	53	91	4.5541282051282055	38	G5BZP0	54	92	5.1179999999999986	38
Q9CYR6	PF02878	101	165	17.055953846153848	64	G5BZP0	102	166	7.940307692307696	64
Q9DB60	PF13911	62	163	2.02343137254902	101	G5ATI9	63	175	1.832663716814159	112
Q8K370	PF00441	903	1051	0.4014832214765099	148	G5AKU5	889	1042	1.0293116883116882	153
Q8K370	PF01636	289	502	1.2019018691588792	213	G5AKU5	275	488	1.2157757009345802	213
Q8K370	PF02770	790	891	0.7795392156862744	101	G5AKU5	776	877	1.8308431372549012	101
Q8K370	PF02771	663	785	0.3026585365853657	122	G5AKU5	649	771	0.2162357723577236	122
Q8K370	PF13419	129	230	0.18544117647058836	101	G5AKU5	115	216	0.7845882352941177	101
Q9ERI5	PF02373	173	287	4.709826086956522	114	G5AQT9	174	288	4.7120434782608696	114
Q9D7I9	PF00868	9	125	5.783205128205128	116	G5BM43	5	121	9.98211111111111	116
Q9D7I9	PF00927	510	605	7.667635416666663	95	G5BM43	506	601	7.8677291666666695	95
Q9D7I9	PF00927	624	720	16.569020618556692	96	G5BM43	620	716	7.992391752577318	96
Q9D7I9	PF01841	277	365	11.248101123595506	88	G5BM43	273	361	11.2513595505618	88
Q9QYN3	PF00089	47	268	2.9737657657657675	221	G5BR96	22	241	0.5554454545454544	219
Q3TX51	PF13855	41	99	0.4789661016949152	58	G5ARY3	42	100	0.4788644067796609	58
Q3TX51	PF13855	119	168	3.44854	49	G5ARY3	120	169	0.11082000000000004	49
Q8BRH4	PF00628	389	435	0.0	46	G5AMU8	369	415	0.0	46
Q8BRH4	PF00628	952	1000	0.1501428571428571	48	G5AMU8	366	413	0.0	47
Q8BRH4	PF00628	1001	1047	0.3869361702127659	46	G5AMU8	368	413	0.0	45
Q8BRH4	PF00856	4773	4877	2.52655238095238	104	G5AMU8	4595	4699	2.5225428571428563	104
Q8BRH4	PF05964	4542	4593	0.5858461538461539	51	G5AMU8	4368	4419	0.514980769230769	51
Q8BRH4	PF05965	4599	4683	7.6616705882352925	84	G5AMU8	4425	4509	7.728517647058823	84
Q8BRH4	PF13771	250	328	1.0486202531645568	78	G5AMU8	183	261	1.8427594936708855	78
Q8BRH4	PF13832	4392	4488	0.3317835051546392	96	G5AMU8	4218	4314	0.4518350515463918	96
Q8VD62	PF08939	160	258	9.331757575757576	98	G5BWV7	114	212	10.139676767676766	98
Q9CZN8	PF01425	28	483	4.724138157894736	455	G5BMN6	5	463	4.991899782135075	458
Q9D1L9	PF16672	0	87	10.030829545454548	87	G5BD78	1	88	10.0825	87
P62843	PF00203	42	127	0.6575813953488371	85	G5AZL1	43	128	0.6575813953488371	85
Q08535	PF00123	32	58	0.0	26	G5C487	20	46	0.0	26
Q5SYD0	PF00063	30	681	7.7895444785276124	651	G5BVL5	1	652	7.796576687116578	651
Q5SYD0	PF00612	702	718	13.548529411764704	16	G5BVL5	673	689	7.999470588235292	16
Q5SYD0	PF06017	802	954	11.143647058823529	152	G5BVL5	773	924	9.876052631578947	151
Q9D1T5	PF15321	9	100	0.7522282608695652	91	G5C2B2	13	105	0.0	92
O88609	PF00046	219	274	6.1895	55	G5BLI0	220	274	6.312090909090909	54
O88609	PF00412	55	109	0.1978181818181818	54	G5BLI0	56	110	0.1970181818181818	54
O88609	PF00412	114	171	0.2437241379310345	57	G5BLI0	115	172	0.24267241379310345	57
Q64163	PF02319	128	198	3.9727746478873236	70	G5AZ59	103	172	5.218871428571427	69
Q64163	PF08781	264	351	2.8249772727272737	87	G5AZ59	286	362	0.4111818181818183	76
Q8BMD8	PF00153	192	278	0.1257586206896552	86	G5BQU4	193	279	0.12517241379310345	86
Q8BMD8	PF00153	282	372	2.060395604395604	90	G5BQU4	283	373	0.2704285714285713	90
Q8BMD8	PF00153	382	469	11.923079545454545	87	G5BQU4	383	470	10.578897727272727	87
Q8BMD8	PF13499	24	83	0.02658333333333333	59	G5BQU4	25	84	1.6115833333333331	59
Q8BMD8	PF13499	88	148	0.0479016393442623	60	G5BQU4	89	149	1.8458688524590168	60
Q8BJ34	PF01936	351	488	4.745601449275363	137	G5AK08	353	490	4.632449275362318	137
Q8BJ34	PF11608	508	592	8.009423529411766	84	G5AK08	510	594	8.00743529411765	84
Q8BJ34	PF12872	1091	1155	1.0244615384615383	64	G5AK08	1101	1165	0.976369230769231	64
Q8BJ34	PF12872	1249	1315	3.304313432835821	66	G5AK08	1259	1325	5.7729253731343295	66
Q8BJ34	PF12872	1326	1393	0.2838676470588235	67	G5AK08	1336	1403	0.2838382352941177	67
Q8BJ34	PF12872	1400	1468	9.190159420289856	68	G5AK08	1410	1478	9.196942028985507	68
Q8BJ34	PF12872	1475	1545	3.9545774647887315	70	G5AK08	1485	1555	3.9109859154929594	70
Q64434	PF00017	77	154	6.476064102564102	77	G5C8D1	78	155	2.0776282051282062	77
Q64434	PF00018	15	63	7.603530612244897	48	G5C8D1	16	64	1.9136734693877555	48
Q64434	PF07714	191	440	4.524775999999998	249	G5C8D1	187	436	4.5221680000000015	249
A2ABV5	PF08638	55	242	3.0476808510638285	187	G5B9K3	4	191	3.0292021276595764	187
Q921K8	PF13402	633	839	2.027777777777778	206	G5C2N0	633	838	0.8596553398058255	205
Q921K8	PF17291	525	632	11.867601851851854	107	G5C2N0	525	631	9.514570093457943	106
P57096	PF00021	22	92	6.8439718309859146	70	G5C8X5	23	93	0.17300000000000004	70
Q61247	PF00079	84	435	5.923642045454542	351	G5BCV1	85	436	5.599161931818184	351
Q9CXI0	PF01209	63	325	4.815311787072243	262	G5B770	64	326	4.610315589353612	262
Q9JKV1	PF04683	28	110	6.0117831325301205	82	G5BDW7	29	111	6.0117831325301205	82
Q9JKV1	PF16550	267	380	0.3677368421052632	113	G5BDW7	268	381	0.3677368421052632	113
Q8R1I2	PF02044	42	55	0.0	13	G5AYY6	41	54	0.0	13
Q922I5	PF00250	116	200	5.431494117647056	84	G5B466	124	208	5.263364705882354	84
Q6PDX6	PF13923	512	551	0.168875	39	G5ARV8	515	554	0.16912500000000005	39
Q6PDX6	PF15926	217	336	0.1637083333333333	119	G5ARV8	218	337	0.144025	119
Q6PDX6	PF15926	338	442	0.10476190476190476	104	G5ARV8	339	445	0.10294392523364486	106
Q3UGY8	PF09324	1240	1306	0.6178805970149254	66	G5AUC8	1203	1269	0.6177910447761193	66
Q3UGY8	PF16213	45	166	5.4603770491803285	121	G5AUC8	1	122	5.537393442622954	121
Q9JJ43	PF00076	118	184	6.43965671641791	66	G5B2N0	144	210	6.423537313432836	66
Q9JJ43	PF12414	251	340	0.16127777777777785	89	G5B2N0	277	367	0.11084615384615384	90
Q6TL19	PF00211	892	1077	7.08207526881721	185	G5BKD0	921	1106	7.810209677419355	185
Q6TL19	PF01094	68	416	5.866896848137532	348	G5BKD0	72	431	6.677730555555552	359
Q6TL19	PF07714	596	825	12.36238260869565	229	G5BKD0	608	854	14.564327935222677	246
P62965	PF00061	4	136	1.1121127819548866	132	G5AUK6	5	137	1.1292803030303027	132
Q6P7W0	PF02902	699	794	21.57902083333333	95	G5AL54	680	775	21.489635416666665	95
Q6P7W0	PF02902	991	1070	6.1480125	79	G5AL54	969	1048	6.088374999999999	79
Q91YK0	PF14580	182	317	1.0075808823529413	135	G5C6T8	183	317	0.8767407407407406	134
Q3UFS4	PF01585	69	112	0.06511363636363636	43	G5BZ80	74	117	0.06531818181818183	43
Q3UFS4	PF13821	212	260	8.133	48	G5BZ80	214	262	8.145918367346937	48
P50538	PF00010	56	107	0.09051923076923077	51	G5C6V9	58	109	0.08990384615384618	51
Q61823	PF02847	164	273	3.8930636363636353	109	G5BKC3	151	260	3.9025818181818193	109
Q61823	PF02847	328	438	4.114675675675676	110	G5BKC3	315	425	4.071981981981981	110
Q923U0	PF00790	12	149	0.9472318840579712	137	G5BPA0	13	150	0.9607753623188404	137
Q923U0	PF03127	211	287	11.384818181818176	76	G5BPA0	213	289	8.195532467532471	76
P83510	PF00069	24	288	2.488388679245283	264	G5BT58	25	289	2.489686792452832	264
P83510	PF00780	1014	1292	10.55110035842294	278	G5BT58	1050	1328	10.245989247311831	278
O35943	PF01491	86	193	1.6445555555555558	107	G5AVH9	15	122	1.5434722222222217	107
Q64368	PF00076	41	107	5.685820895522388	66	G5BMI0	42	108	5.41668656716418	66
Q64368	PF18872	170	189	1.47735	19	G5BMI0	171	190	1.6303499999999995	19
P48972	PF00249	134	177	0.0	43	G5BY90	51	94	0.0	43
P48972	PF09316	453	599	0.16981632653061227	146	G5BY90	328	473	0.2111712328767123	145
P48972	PF13921	66	93	0.10232142857142858	27	G5BY90	36	62	0.0	26
O70302	PF02017	34	108	16.52694666666666	74	G5C075	106	180	15.45456	74
Q921M7	PF07159	17	319	4.013178217821782	302	G5B4Q8	18	320	4.013178217821782	302
Q3TXZ1	PF00096	56	78	0.0	22	G5AZN9	164	186	0.0	22
Q3TXZ1	PF00096	84	106	0.0	22	G5AZN9	164	186	0.0	22
Q3TXZ1	PF00096	140	162	0.0	22	G5AZN9	220	242	0.0	22
Q3TXZ1	PF00096	170	189	0.0	19	G5AZN9	250	269	0.0	19
Q6IMB1	PF00071	28	196	4.670437869822484	168	G5ATV4	29	196	6.172845238095238	167
Q91V13	PF07359	0	65	17.66962121212121	65	G5BFF7	1	66	18.576846153846148	65
Q8CIM3	PF01565	115	251	1.23187591240876	136	G5C3S5	57	193	1.1811824817518253	136
Q8CIM3	PF02913	289	528	5.352762499999995	239	G5C3S5	231	470	4.9358458333333335	239
Q7TMB3	PF03370	152	255	0.3349615384615384	103	G5BV00	148	251	0.2520384615384616	103
Q8VH51	PF15519	341	441	1.467594059405941	100	G5B843	342	442	1.467594059405941	100
Q8VH51	PF00076	154	218	1.8794307692307688	64	G5B843	155	219	1.8516307692307692	64
Q8VH51	PF00076	251	320	3.7275	69	G5B843	252	321	3.720628571428572	69
Q3UHJ8	PF13639	354	395	4.170119047619048	41	G5BPZ1	385	426	3.4483333333333337	41
Q924C5	PF02816	1392	1589	3.7661161616161607	197	G5B1R8	1367	1564	3.7687323232323235	197
Q924C5	PF07679	76	168	0.9267311827956992	92	G5B1R8	87	179	0.9272365591397844	92
Q8R0P4	PF04430	5	118	0.5069736842105264	113	G5AW70	6	119	0.2288333333333333	113
Q6ZQF0	PF12738	202	265	9.402953125	63	G5BQB1	203	266	8.615906249999998	63
Q6ZQF0	PF12738	651	722	6.442388888888888	71	G5BQB1	654	725	14.122194444444444	71
Q6ZQF0	PF00533	104	174	0.3153661971830985	70	G5BQB1	105	175	4.0145915492957736	70
Q6ZQF0	PF00533	353	429	0.609038961038961	76	G5BQB1	356	432	0.5053246753246755	76
Q6ZQF0	PF00533	904	978	6.5382799999999985	74	G5BQB1	908	982	2.972600000000001	74
Q6ZQF0	PF00533	1262	1332	0.1711549295774648	70	G5BQB1	1272	1342	1.2994929577464789	70
Q8K4Q0	PF00400	1159	1193	7.160085714285715	34	G5BJ54	1159	1193	7.160342857142857	34
Q8K4Q0	PF02985	603	626	33.910999999999994	23	G5BJ54	603	626	33.94141666666666	23
Q8K4Q0	PF14538	54	205	8.332953947368418	151	G5BJ54	55	206	8.333059210526311	151
Q80ZI6	PF00536	576	628	5.267905660377358	52	G5BLH2	577	629	3.550094339622643	52
Q80ZI6	PF13855	82	138	10.891964912280702	56	G5BLH2	83	139	1.718754385964912	56
Q80ZI6	PF13920	676	718	6.745139534883719	42	G5BLH2	672	714	0.7776744186046511	42
Q8VI75	PF02985	394	423	6.074333333333334	29	G5B290	395	424	4.885833333333334	29
Q8VI75	PF03810	23	88	2.9130909090909087	65	G5B290	24	89	3.372939393939395	65
Q8VI75	PF13513	913	967	5.817745454545452	54	G5B290	911	967	5.5957368421052625	56
Q9D7P6	PF01592	35	158	0.005564516129032258	123	G5AWZ7	35	158	0.005564516129032258	123
A6H5Y3	PF00809	362	600	6.01481171548117	238	G5APN0	362	600	6.338133891213388	238
A6H5Y3	PF02310	761	851	13.563186813186805	90	G5APN0	769	859	12.140571428571427	90
A6H5Y3	PF02574	17	325	3.2800129449838216	308	G5APN0	18	325	3.354000000000001	307
A6H5Y3	PF02607	659	734	0.11953947368421053	75	G5APN0	659	734	0.17788157894736845	75
A6H5Y3	PF02965	953	1233	3.7677188612099655	280	G5APN0	961	1241	5.013395017793592	280
P18893	PF00726	14	172	1.9375094339622647	158	G5BP21	15	172	2.5507594936708857	157
Q8BX70	PF06650	2760	3011	4.424496031746032	251	G5AWB7	2732	2983	4.399626984126987	251
Q8BX70	PF09333	3500	3578	0.811481012658228	78	G5AWB7	3470	3547	7.266576923076923	77
Q8BX70	PF12624	33	114	5.104780487804878	81	G5AWB7	1	82	5.3725853658536575	81
Q8BX70	PF16908	181	412	0.6119353448275863	231	G5AWB7	149	380	0.4506077586206898	231
Q8BX70	PF16909	3318	3494	10.654163841807916	176	G5AWB7	3290	3464	14.068639999999993	174
Q8BX70	PF16910	610	831	1.1797072072072072	221	G5AWB7	579	800	2.4820090090090083	221
Q8BX70	PF16910	1174	1364	10.928057591623032	190	G5AWB7	1143	1334	8.796333333333333	191
Q8BX70	PF16910	1687	1878	7.002385416666669	191	G5AWB7	1658	1849	5.016000000000001	191
Q99PT1	PF02115	12	200	0.16296296296296292	188	G5BJ78	13	201	0.16142857142857145	188
P59242	PF01576	805	1140	0.001726190476190476	335	G5B8L7	808	1143	0.001711309523809524	335
Q6ZPJ3	PF00179	954	1099	12.579972602739725	145	G5AQU8	1133	1270	13.318260869565222	137
Q8R3V5	PF03114	20	278	0.15751351351351353	258	G5ASC8	6	311	0.16273529411764706	305
Q8R3V5	PF14604	346	396	2.1134313725490195	50	G5ASC8	381	431	2.112019607843137	50
Q8VCZ8	PF00849	17	181	2.4496303030303026	164	G5BXU8	18	182	1.942884848484848	164
P33611	PF04042	341	548	5.453091346153842	207	G5B6L1	342	549	4.360841346153847	207
P33611	PF08418	22	238	1.6494147465437794	216	G5B6L1	23	239	1.0521336405529955	216
Q9DCX2	PF05873	2	154	1.8441503267973864	152	G5BND2	3	155	1.4993594771241827	152
Q8VBU8	PF10523	257	325	3.769333333333337	68	G5BJE7	250	318	3.729608695652175	68
Q4G5Y1	PF07646	216	259	0.04215909090909091	43	G5B965	117	160	0.04229545454545455	43
Q4G5Y1	PF13418	267	306	13.148525000000005	39	G5B965	168	207	13.117799999999995	39
Q99N84	PF01084	109	160	1.5334615384615384	51	G5C3B7	112	163	1.1040769230769232	51
P24604	PF00017	245	328	2.24475	83	G5B8D6	248	331	2.244178571428572	83
P24604	PF00018	183	229	2.6979148936170216	46	G5B8D6	186	232	1.913	46
P24604	PF00169	6	109	3.81525	103	G5B8D6	7	110	6.551576923076923	103
P24604	PF00779	118	146	0.0	28	G5B8D6	119	147	0.0	28
P24604	PF07714	368	616	5.741967871485941	248	G5B8D6	371	619	6.11761044176707	248
Q91YR1	PF00241	16	130	5.7844695652173925	114	G5BX31	17	131	5.727486956521736	114
Q91YR1	PF00241	187	309	4.737528455284552	122	G5BX31	188	310	7.203487804878048	122
P33610	PF04104	211	447	2.60939240506329	236	G5C5L7	35	271	0.17238818565400835	236
P70392	PF00169	24	131	16.94106481481482	107	G5BK73	25	132	17.883	107
P70392	PF00617	956	1134	0.9704134078212292	178	G5BK73	996	1174	0.9841564245810056	178
P70392	PF00618	637	755	7.567075630252105	118	G5BK73	638	768	7.622091603053434	130
P70392	PF00621	249	422	7.121706896551722	173	G5BK73	250	423	3.834948275862069	173
Q3TAA7	PF15904	7	93	8.498160919540231	86	G5AKI5	8	94	8.472356321839083	86
P38533	PF00447	57	109	0.05339622641509434	52	G5B3W6	1	53	0.0	52
P38533	PF06546	229	509	0.6719359430604982	280	G5B3W6	123	404	0.6693014184397162	281
Q60631	PF00017	59	134	8.356421052631575	75	G5BNB5	60	135	8.356421052631575	75
Q60631	PF00018	3	49	0.09548936170212767	46	G5BNB5	4	50	0.09548936170212767	46
Q60631	PF00018	161	205	0.5691333333333334	44	G5BNB5	162	206	0.4248	44
Q8R179	PF07707	213	242	0.4983333333333334	29	G5BPD3	39	68	0.523	29
Q8R179	PF13964	333	381	5.126693877551023	48	G5BPD3	159	207	5.132857142857142	48
P17918	PF00705	0	123	2.2189193548387096	123	G5B4W1	1	124	2.2177741935483866	123
P17918	PF02747	126	253	2.0014296874999995	127	G5B4W1	127	254	2.56478125	127
G5E8A8	PF03148	94	476	1.0091148825065277	382	G5BWF7	96	466	0.9497816711590296	370
P62830	PF00238	21	137	6.7552051282051275	116	G5BK67	22	138	6.689324786324788	116
O35716	PF00017	79	154	5.3860789473684205	75	G5BVA2	79	154	5.3733815789473685	75
O35716	PF07525	171	204	2.733617647058824	33	G5BVA2	171	204	2.045911764705882	33
A2AAY5	PF00018	159	202	5.620727272727274	43	G5BBY1	163	206	4.643545454545454	43
A2AAY5	PF00018	227	271	0.19273333333333326	44	G5BBY1	231	275	0.11984444444444445	44
A2AAY5	PF00018	376	418	3.002348837209301	42	G5BBY1	380	442	2.545031746031746	62
A2AAY5	PF00787	31	123	0.14510752688172046	92	G5BBY1	12	127	0.1046551724137931	115
A2AAY5	PF07653	851	904	17.40051851851852	53	G5BBY1	875	928	16.074796296296302	53
Q9JM14	PF06941	4	192	1.282497354497354	188	G5BNC4	4	192	1.0410952380952383	188
Q8R034	PF05839	0	72	0.0	72	G5BL14	1	73	0.0319041095890411	72
P60334	PF05995	0	169	4.072417647058824	169	G5BL89	1	170	4.451364705882354	169
P97432	PF00564	4	84	0.6355555555555554	80	G5BN96	5	84	0.5580125	79
P97432	PF00569	216	249	0.00988235294117647	33	G5BN96	223	255	0.017181818181818184	32
P97432	PF16158	379	478	7.275679999999999	99	G5BN96	386	485	7.886730000000001	99
Q921Q7	PF02204	481	569	5.973247191011236	88	G5BWX6	472	559	5.963488636363636	87
Q9QX96	PF00096	399	421	0.0	22	G5BFU8	402	424	0.0	22
Q9QX96	PF00096	656	675	0.0	19	G5BFU8	660	679	0.0	19
Q9QX96	PF00096	690	710	0.042666666666666665	20	G5BFU8	694	714	0.042666666666666665	20
Q9QX96	PF13912	909	931	0.0	22	G5BFU8	913	935	0.0	22
P32114	PF00292	15	135	0.3886611570247933	120	G5CAE5	49	168	0.3928750000000001	119
P32114	PF12403	306	363	0.0	57	G5CAE5	623	679	0.0	56
Q8CIB5	PF00169	385	474	0.6767666666666665	89	G5BF91	386	475	0.6766555555555555	89
Q8CIB5	PF00373	280	384	2.5714380952380966	104	G5BF91	281	385	4.156819047619045	104
Q8CIB5	PF18124	12	96	0.03429411764705882	84	G5BF91	13	97	0.7287764705882352	84
Q91Y44	PF00439	43	118	6.118578947368423	75	G5ASI3	240	316	0.8452597402597402	76
Q91Y44	PF00439	274	361	0.8227159090909091	87	G5ASI3	229	316	0.7468295454545454	87
Q91Y44	PF17035	504	566	0.44453968253968257	62	G5ASI3	459	521	3.122111111111112	62
Q91Y44	PF17105	913	955	0.19839534883720933	42	G5ASI3	790	832	5.48807142857143	42
Q3UHF3	PF00249	281	325	15.4084	44	G5AU80	288	332	22.81613333333333	44
Q3UHF3	PF01448	175	223	0.6098571428571427	48	G5AU80	183	230	1.2566250000000003	47
Q8R5K2	PF00443	153	678	2.9948726235741425	525	G5AXK9	153	679	2.9902713472485765	526
Q8R5K2	PF02148	29	90	1.6827419354838704	61	G5AXK9	30	91	1.7011290322580646	61
Q8R5K2	PF06337	706	775	1.5131142857142852	69	G5AXK9	707	776	1.0407714285714291	69
Q8R5K2	PF06337	813	882	6.688099999999998	69	G5AXK9	814	883	5.920142857142854	69
Q91ZJ0	PF02732	281	412	2.687409090909092	131	G5B6I9	275	406	4.498893939393938	131
Q9Z131	PF05276	43	268	0.27838938053097345	225	G5BUL6	29	297	0.3588773234200744	268
Q9WVJ2	PF01399	231	333	1.6691165048543688	102	G5AUB9	232	334	5.781388349514563	102
Q4KMM3	PF01476	99	141	1.9417906976744184	42	G5AZ80	201	243	1.187604651162791	42
Q4KMM3	PF07534	729	864	9.477007352941179	135	G5AZ80	834	969	9.237485294117645	135
Q8BH02	PF06309	141	246	2.8160943396226417	105	G5BFZ4	147	252	5.682264150943398	105
O88986	PF00155	63	404	3.504131578947372	341	G5AYR6	67	408	3.775298245614035	341
A8Y5H7	PF00650	322	489	8.210636904761905	167	G5AQT4	322	489	8.212202380952384	167
A8Y5H7	PF03765	274	295	0.0	21	G5AQT4	274	295	0.0	21
A8Y5H7	PF04707	16	172	3.8547898089171984	156	G5AQT4	17	173	3.8546050955413995	156
Q8C7R4	PF00899	55	223	2.1656272189349117	168	G5B222	1	169	1.6872603550295855	168
Q8C7R4	PF00899	446	629	4.407423913043479	183	G5B222	392	575	4.3915434782608695	183
Q8C7R4	PF09358	954	1042	1.0422696629213486	88	G5B222	900	988	0.5915617977528087	88
Q8C7R4	PF10585	630	883	1.1766338582677172	253	G5B222	576	829	1.4700905511811022	253
Q8C7R4	PF16190	224	291	1.1837205882352946	67	G5B222	170	237	0.8279852941176472	67
Q8C7R4	PF16191	293	361	1.3442318840579712	68	G5B222	239	307	0.16143478260869565	68
Q6NSW3	PF05716	1593	1667	13.92410666666667	74	G5C9F6	1591	1665	10.979346666666665	74
Q68FG0	PF10146	13	143	0.0	130	G5C7V9	14	144	0.0	130
Q68FG0	PF10146	142	220	0.0	78	G5C7V9	143	221	0.0	78
Q99LM9	PF12767	6	110	5.891104761904762	104	G5AQ40	7	111	5.891342857142856	104
Q99LM9	PF12767	137	191	18.91536363636364	54	G5AQ40	138	192	18.929872727272727	54
P15331	PF00038	99	409	0.4701125401929261	310	G5AU23	176	446	0.522509225092251	270
P15331	PF04732	39	98	0.0	59	G5AU23	116	175	0.39635	59
Q9EQH3	PF03635	258	751	9.002313765182185	493	G5C3N6	284	767	8.50674173553719	483
Q6NZC7	PF00536	647	695	0.4348979591836735	48	G5BM77	96	144	0.408734693877551	48
Q6NZC7	PF02862	776	985	4.313819047619049	209	G5BM77	225	434	4.6748047619047615	209
Q8C142	PF14719	46	186	13.769815602836884	140	G5BHW2	48	188	14.090773049645396	140
Q6ZQF7	PF10513	48	174	0.4015826771653543	126	G5BN15	49	175	0.4073779527559056	126
Q6ZQF7	PF13831	213	246	0.057264705882352926	33	G5BN15	214	247	0.057088235294117634	33
Q6ZQF7	PF13832	252	363	2.383294642857144	111	G5BN15	253	364	1.12125	111
P17427	PF02296	824	844	0.0	20	G5C8F7	835	854	0.0	19
P17427	PF02883	711	815	3.55254285714286	104	G5C8F7	710	826	3.1861367521367514	116
P17427	PF01602	43	586	9.089343750000015	543	G5C8F7	42	586	9.015508256880752	544
Q6P926	PF15175	10	189	0.5027277777777777	179	G5AZ73	11	190	0.5745611111111109	179
Q8K0Q5	PF00620	342	488	4.401204081632653	146	G5C768	347	493	5.301374149659866	146
Q99PV0	PF01398	2100	2203	1.1846153846153846	103	G5BCV3	2101	2204	1.1741346153846153	103
Q99PV0	PF08082	57	208	1.5687236842105263	151	G5BCV3	58	209	1.5687236842105263	151
Q99PV0	PF08083	395	800	2.2363448275862066	405	G5BCV3	396	801	2.2363448275862066	405
Q99PV0	PF08084	2211	2331	8.935561983471077	120	G5BCV3	2212	2332	8.403991735537193	120
Q99PV0	PF10596	1441	1599	2.553452830188679	158	G5BCV3	1442	1600	2.553452830188679	158
Q99PV0	PF10597	1209	1342	5.861014925373137	133	G5BCV3	1210	1343	5.861014925373137	133
Q99PV0	PF10598	985	1075	14.79076923076923	90	G5BCV3	986	1076	14.79076923076923	90
Q99PV0	PF12134	1759	1988	6.917534782608694	229	G5BCV3	1760	1989	6.917534782608694	229
Q8BYH3	PF05206	164	467	4.615486842105264	303	G5C724	165	469	3.5105344262295053	304
Q8BYH3	PF05253	56	79	0.0	23	G5C724	57	80	0.0	23
Q8BYH3	PF11722	16	44	0.1117241379310345	28	G5C724	17	45	0.3643103448275861	28
Q9WTP3	PF00178	239	321	3.2509397590361444	82	G5BCF9	248	330	3.175	82
Q9WTP3	PF02198	121	201	2.4401604938271606	80	G5BCF9	130	210	2.5302098765432097	80
Q60974	PF00249	623	668	0.09076086956521738	45	G5BEV1	623	668	0.09076086956521738	45
Q60974	PF15784	151	237	3.5494022988505747	86	G5BEV1	150	236	4.408183908045976	86
P97737	PF00019	373	474	2.0808529411764707	101	G5AZY8	369	470	2.0855294117647065	101
O54915	PF00104	241	407	8.371670658682635	166	G5AU97	240	406	9.404532934131737	166
O54915	PF00105	36	105	0.013285714285714288	69	G5AU97	44	113	0.013214285714285715	69
Q9Z111	PF01248	24	106	7.444361445783132	82	G5BZ45	25	107	7.691819277108435	82
Q8R2V5	PF00169	134	230	2.4292474226804117	96	G5BVM4	244	340	4.0051030927835045	96
Q8R2V5	PF00169	257	358	0.1938627450980392	101	G5BVM4	392	524	0.15422556390977446	132
Q8R2V5	PF01412	25	122	4.425367346938773	97	G5BVM4	135	231	4.428618556701031	96
Q8BIY1	PF01585	410	455	0.0	45	G5AUS4	407	452	0.0	45
Q3KQP7	PF15162	10	170	14.143509316770196	160	G5AZX2	11	170	14.390012500000005	159
P80206	PF00046	38	94	0.5009649122807017	56	G5ANI6	47	105	0.4668813559322034	58
P80206	PF03529	152	233	0.0	81	G5ANI6	163	244	0.0	81
Q9D786	PF14817	7	614	1.5749539473684218	607	G5BXH9	8	629	1.816458199356913	621
P51642	PF01110	0	192	0.5218393782383418	192	G5AP46	1	191	0.5596335078534029	190
P47941	PF00017	13	87	1.0654666666666663	74	G5C031	14	88	1.1212399999999996	74
P47941	PF00018	129	174	10.568195652173912	45	G5C031	130	175	10.718434782608695	45
P47941	PF07653	238	292	0.14581818181818182	54	G5C031	239	293	0.14581818181818182	54
Q08761	PF00008	120	151	0.4421875	31	G5AV68	121	151	0.2669354838709677	30
Q08761	PF00054	328	451	5.745137096774191	123	G5AV68	329	451	5.894869918699192	122
Q08761	PF00594	45	84	0.0142	39	G5AV68	46	85	0.048450000000000014	39
Q08761	PF07645	200	240	0.0	40	G5AV68	201	241	0.0	40
Q08761	PF07645	242	281	0.0	39	G5AV68	243	282	0.0	39
Q08761	PF14670	165	198	0.0	33	G5AV68	166	199	0.0	33
Q9CPW9	PF00557	95	321	1.3148590308370047	226	G5ANG2	111	326	1.719453703703704	215
Q3UHD6	PF00595	62	129	7.148102941176472	67	G5B8L5	1	68	8.393279411764706	67
Q3UHD6	PF00787	187	261	0.05786666666666665	74	G5B8L5	126	200	0.05800000000000001	74
Q3UHD6	PF00788	273	357	5.629282352941177	84	G5B8L5	212	296	5.985200000000002	84
Q3UPH1	PF01931	261	374	6.625219298245616	113	G5B596	261	374	6.480815789473687	113
Q8K2B3	PF00890	62	456	1.5062202531645574	394	G5BPG8	64	458	1.5076759493670882	394
Q8K2B3	PF02910	511	663	0.7925163398692808	152	G5BPG8	513	665	2.1464868421052627	152
Q9D125	PF05047	43	93	3.486	50	G5ANT2	44	94	9.748392156862746	50
P58022	PF00530	67	161	0.042368421052631576	94	G5B9R8	68	162	0.04511578947368421	94
P58022	PF00530	203	303	0.2887821782178218	100	G5B9R8	207	307	0.6511782178217822	100
P58022	PF00530	332	427	1.6020208333333334	95	G5B9R8	336	431	1.58484375	95
P58022	PF00530	441	544	2.8307884615384635	103	G5B9R8	445	547	2.4544174757281545	102
P58022	PF01186	549	749	3.2822587064676614	200	G5B9R8	552	756	2.932507317073172	204
Q6P4T0	PF09333	1815	1907	3.1046774193548385	92	G5B6N4	1931	2023	2.174784946236559	92
Q6P4T0	PF12624	13	111	0.3478787878787877	98	G5B6N4	13	111	0.04458585858585858	98
D3Z070	PF15876	22	128	0.04658878504672897	106	G5B8T3	9	114	0.7454056603773584	105
Q6P6I6	PF15328	27	238	0.2273349056603774	211	G5BP56	2	214	0.02253521126760563	212
P25911	PF07714	246	495	6.092748000000002	249	G5B336	247	496	6.043815999999999	249
P25911	PF00017	128	210	1.4699759036144575	82	G5B336	129	211	0.8790843373493977	82
P25911	PF00018	68	114	4.582425531914893	46	G5B336	69	115	3.0747446808510634	46
Q8BH04	PF00821	277	635	1.1515403899721444	358	G5B2A0	278	636	1.9220974930362116	358
Q8BH04	PF17297	45	273	1.699956331877729	228	G5B2A0	46	274	0.9262576419213974	228
Q62177	PF00047	578	654	7.028857142857143	76	G5BZY7	580	656	1.5491948051948052	76
Q62177	PF01403	57	493	5.993363844393595	436	G5BZY7	58	495	6.379664383561644	437
Q7TSG3	PF00646	232	261	0.9891666666666666	29	G5BQ68	255	284	1.0617333333333336	29
Q8K2M3	PF07985	109	162	20.226000000000006	53	G5BGM4	81	134	15.956296296296287	53
Q6KAU8	PF00400	333	367	1.5748571428571427	34	G5AS65	334	368	1.7091142857142858	34
Q6KAU8	PF00400	419	453	0.0	34	G5AS65	420	454	0.0	34
Q6KAU8	PF08614	19	210	0.1526927083333333	191	G5AS65	20	211	0.21787500000000004	191
Q6NV66	PF00096	66	88	0.010869565217391304	22	G5BYC8	75	97	0.0	22
Q6NV66	PF00096	230	252	0.0	22	G5BYC8	239	261	0.0	22
Q6NV66	PF00096	365	387	0.0	22	G5BYC8	373	395	0.0	22
Q6NV66	PF00096	605	627	0.0	22	G5BYC8	614	636	0.0	22
Q6NV66	PF00096	1169	1191	0.0	22	G5BYC8	1182	1204	0.0	22
Q6NV66	PF00096	1224	1246	0.0	22	G5BYC8	1237	1259	0.0	22
Q6NV66	PF00096	1292	1314	0.0	22	G5BYC8	1305	1327	0.0	22
Q6NV66	PF00096	1694	1716	0.0	22	G5BYC8	1647	1669	0.0	22
Q6NV66	PF13912	832	855	0.0	23	G5BYC8	843	865	0.0	22
Q80U58	PF00806	729	763	0.051857142857142866	34	G5AZA3	723	757	0.026142857142857145	34
Q80U58	PF00806	767	794	9.793928571428566	27	G5AZA3	761	788	9.795964285714279	27
Q80U58	PF00806	801	828	0.07307142857142858	27	G5AZA3	795	822	0.07307142857142858	27
Q80U58	PF00806	839	870	4.614875	31	G5AZA3	833	864	5.4561875	31
Q80U58	PF00806	875	909	10.613057142857144	34	G5AZA3	869	903	9.737885714285714	34
Q80U58	PF00806	914	944	0.14696774193548387	30	G5AZA3	908	938	0.15516129032258064	30
Q80U58	PF00806	948	981	0.24444117647058825	33	G5AZA3	942	975	0.2503529411764706	33
Q80U58	PF00806	992	1023	2.7455	31	G5AZA3	986	1017	2.58409375	31
Q91YR7	PF06424	59	168	0.9171272727272728	109	G5C8B0	1	110	0.9158363636363636	109
Q91YR7	PF13432	683	740	0.15612068965517245	57	G5C8B0	584	641	0.22172413793103452	57
Q91YR7	PF14559	620	677	13.0125	57	G5C8B0	521	578	13.005	57
Q91WG5	PF00571	355	405	13.722529411764707	50	G5AMU5	354	404	14.383705882352944	50
Q91WG5	PF00571	430	477	4.885833333333333	47	G5AMU5	429	476	5.065229166666667	47
Q91WG5	PF00571	504	550	10.513872340425532	46	G5AMU5	503	549	11.251382978723408	46
F2Z461	PF00415	42	86	0.028711111111111107	44	G5BZ77	9	52	0.05640909090909092	43
F2Z461	PF00415	92	141	0.3794800000000001	49	G5BZ77	59	106	3.0253958333333317	47
F2Z461	PF00415	145	194	0.3278200000000001	49	G5BZ77	7	55	0.08836734693877553	48
F2Z461	PF00632	709	998	10.391634482758624	289	G5BZ77	599	887	8.169214532871965	288
F2Z461	PF13540	239	265	5.969222222222222	26	G5BZ77	45	71	5.474740740740741	26
Q8QZX2	PF14932	28	280	2.151154150197628	252	G5BCH9	29	281	1.4266956521739134	252
Q6PJN8	PF05746	398	536	4.980374100719426	138	G5BZU9	397	536	5.857521428571428	139
Q3TBL6	PF05527	21	200	2.1837111111111107	179	G5C8S6	105	284	4.957466666666666	179
Q9D5V5	PF00888	42	671	4.3270761904761885	629	G5BXQ9	18	581	4.049101063829784	563
Q9D5V5	PF10557	710	771	1.9539193548387104	61	G5BXQ9	620	681	2.0545161290322587	61
Q9D2N9	PF00995	33	590	3.98097670250896	557	G5AWQ7	34	589	4.036230215827338	555
E9PYY5	PF00400	662	690	2.175448275862069	28	G5BSP7	673	701	10.608413793103447	28
Q3TFK5	PF01585	18	53	0.0	35	G5AR85	19	54	0.0	35
O35231	PF00225	448	765	5.719122641509434	317	G5AUF6	451	768	5.8906446540880495	317
Q922R0	PF00069	109	299	10.84601047120419	190	G5BQR8	141	331	7.772387434554973	190
Q64267	PF01286	101	131	0.0	30	G5C1C5	82	112	0.0	30
Q64267	PF05181	133	184	0.0	51	G5C1C5	114	165	0.0	51
Q61140	PF12026	658	867	6.558338095238095	209	G5B5X8	717	926	6.63556666666667	209
Q61140	PF00018	8	55	5.0927291666666665	47	G5B5X8	85	132	5.084770833333334	47
Q61140	PF08824	457	610	0.8315194805194803	153	G5B5X8	516	669	0.22588311688311685	153
Q8BGE7	PF00622	353	471	8.397932773109245	118	G5BS54	353	471	7.476478991596638	118
Q8BGE7	PF00643	94	129	18.81683333333334	35	G5BS54	94	129	17.314361111111108	35
Q8BGE7	PF15227	14	58	1.4165111111111108	44	G5BS54	15	58	0.04486363636363636	43
Q812E0	PF16366	444	506	0.8019047619047617	62	G5AYP6	510	572	0.8021269841269845	62
Q812E0	PF16367	262	351	7.516422222222221	89	G5AYP6	328	417	7.5167222222222225	89
Q8CCB5	PF13383	169	295	0.04357480314960629	126	G5ARK1	107	233	0.043889763779527566	126
Q99JB6	PF00250	336	412	6.115	76	G5BJK3	337	413	5.816792207792206	76
Q99JB6	PF16159	191	258	0.02088235294117647	67	G5BJK3	193	260	0.020735294117647057	67
Q9D8Z6	PF07855	8	170	5.719478527607364	162	G5BL93	9	171	5.696963190184054	162
Q8BUG2	PF01546	102	214	5.140672566371683	112	G5BAR2	197	309	5.587805309734511	112
Q8BUG2	PF07687	215	373	1.8631383647798747	158	G5BAR2	310	468	2.087182389937107	158
Q4VAC9	PF00169	316	392	12.299363636363633	76	G5BD05	309	385	8.286805194805186	76
Q4VAC9	PF00621	96	269	4.69162068965517	173	G5BD05	89	262	4.686597701149426	173
A1A547	PF01510	76	184	12.462403669724765	108	G5BUZ6	68	177	7.661199999999999	109
A1A547	PF01510	205	330	8.107484126984126	125	G5BUZ6	198	323	8.807960317460319	125
P70365	PF08832	634	711	0.9321410256410254	77	G5C390	632	709	0.9323333333333332	77
P70365	PF14598	259	368	4.17869090909091	109	G5C390	260	369	4.1792	109
P70365	PF00010	28	79	0.0	51	G5C390	29	80	0.0	51
P70365	PF00989	114	171	16.99551724137931	57	G5C390	115	172	16.99622413793103	57
P70365	PF07469	1154	1209	0.0	55	G5C390	1150	1205	0.0	55
P70365	PF07469	1217	1272	0.0	55	G5C390	1213	1268	0.03901785714285715	55
P70365	PF08815	929	974	2.5891739130434783	45	G5C390	925	970	2.589695652173913	45
P70365	PF16665	471	590	0.15573333333333336	119	G5C390	472	591	0.19673333333333332	119
Q8K3V4	PF03068	280	678	2.6132456140350864	398	G5BZN1	279	657	0.956614775725594	378
Q8K3V4	PF08526	0	111	10.633883928571432	111	G5BZN1	1	112	21.9295	111
Q8K3V4	PF08527	113	268	5.701256410256407	155	G5BZN1	114	267	6.841298701298702	153
Q9QX66	PF00628	327	337	0.0	10	G5AMC4	335	344	0.0078	9
Q9QX66	PF14051	12	82	2.6591126760563384	70	G5AMC4	20	90	2.6622957746478875	70
Q6GQR8	PF00096	183	205	0.03804347826086957	22	G5B7L1	356	378	0.03804347826086957	22
Q6GQR8	PF00096	211	233	0.3065217391304348	22	G5B7L1	384	406	0.7459565217391304	22
Q6GQR8	PF00096	239	261	0.0	22	G5B7L1	412	434	0.0	22
Q6GQR8	PF00096	267	289	0.03565217391304347	22	G5B7L1	440	462	0.03543478260869565	22
Q6GQR8	PF00096	295	317	0.0	22	G5B7L1	468	490	0.0	22
Q6GQR8	PF00096	323	345	0.0	22	G5B7L1	496	518	0.0	22
Q6GQR8	PF00096	351	373	0.0	22	G5B7L1	524	546	0.0	22
Q6GQR8	PF00096	379	401	0.9019565217391304	22	G5B7L1	552	574	0.9015217391304348	22
Q6GQR8	PF00096	435	457	0.0	22	G5B7L1	608	630	0.0	22
Q6GQR8	PF00096	463	485	0.0	22	G5B7L1	636	658	0.0	22
Q6GQR8	PF00096	492	513	0.0	21	G5B7L1	665	686	0.0	21
P48193	PF00373	293	401	4.661504587155962	108	G5AP97	293	401	4.671266055045872	108
P48193	PF04382	660	708	0.0	48	G5AP97	660	708	0.0	48
P48193	PF05902	746	853	2.5300462962962964	107	G5AP97	746	853	2.5401203703703703	107
P48193	PF08736	499	542	0.0910227272727273	43	G5AP97	499	542	0.09147727272727274	43
P48193	PF09379	214	276	0.8721428571428571	62	G5AP97	214	276	1.6122539682539685	62
P48193	PF09380	407	491	6.384047058823531	84	G5AP97	407	491	6.3997764705882325	84
Q99NH2	PF00595	279	346	0.1331911764705882	67	G5BI20	395	462	0.1311470588235294	67
Q99NH2	PF00595	461	543	8.301975903614457	82	G5BI20	575	657	9.307433734939758	82
Q99NH2	PF00595	594	664	4.3943802816901405	70	G5BI20	708	778	4.369492957746481	70
Q99NH2	PF12053	66	82	20.98394117647059	16	G5BI20	184	200	34.02811764705883	16
P53368	PF00293	7	124	4.8458474576271175	117	G5BI84	8	125	4.0919745762711885	117
Q9QY15	PF00270	122	286	5.861206060606057	164	G5AXW2	118	282	5.204521212121211	164
Q9QY15	PF00271	327	439	11.508345132743365	112	G5AXW2	323	435	11.448858407079644	112
B1AVY7	PF00225	27	357	3.854380664652567	330	G5AMI1	1	331	3.7626404833836857	330
B1AVY7	PF00498	479	543	4.7750153846153855	64	G5AMI1	453	517	4.759615384615387	64
O54927	PF00400	161	198	13.30186842105263	37	G5BFG1	112	149	14.459868421052635	37
O54927	PF00400	204	241	12.483684210526313	37	G5BFG1	155	192	12.949236842105265	37
O54927	PF00400	248	283	0.4502500000000001	35	G5BFG1	199	234	0.44380555555555545	35
O54927	PF00400	309	337	0.0546551724137931	28	G5BFG1	260	288	0.0	28
O54927	PF00400	355	377	14.13282608695652	22	G5BFG1	306	328	17.32517391304348	22
O54927	PF07525	383	418	12.189777777777778	35	G5BFG1	334	369	8.192222222222222	35
Q9QZW9	PF00046	241	297	0.2504210526315789	56	G5C8R9	77	133	0.2597894736842106	56
Q9CV28	PF13898	28	298	8.987649446494471	270	G5BAI7	29	300	8.953334558823533	271
Q8K2T1	PF05368	6	246	5.58785477178423	240	G5C0J5	7	237	6.381030303030302	230
Q76KJ5	PF08208	37	247	0.1025829383886256	210	G5BKU5	38	250	0.047370892018779344	212
P01101	PF00170	134	193	0.1358833333333333	59	G5C1K6	135	194	0.9451	59
Q924D0	PF08240	70	144	0.3897999999999999	74	G5BMN5	71	145	0.3708933333333333	74
Q924D0	PF13602	246	392	7.125149659863945	146	G5BMN5	247	393	4.6899795918367335	146
Q9JKY0	PF04078	54	282	6.038262008733626	228	G5AZI6	1	229	6.02479912663756	228
Q9WVF6	PF00068	20	128	0.34337614678899075	108	G5C4W1	28	136	6.718559633027527	108
Q5SFM8	PF00076	614	666	4.42556603773585	52	G5C841	597	649	4.4245660377358496	52
Q5SFM8	PF00642	275	298	1.215	23	G5C841	256	279	1.2145833333333331	23
Q5SFM8	PF01480	20	73	11.32168518518518	53	G5C841	1	54	11.327981481481476	53
Q9EQP2	PF00350	88	222	7.90554814814815	134	G5BM21	1	135	7.909762962962966	134
Q9EQP2	PF12763	449	533	0.6261764705882352	84	G5BM21	362	446	0.6268235294117647	84
Q9EQP2	PF18150	291	396	2.6567264150943406	105	G5BM21	204	309	2.8485660377358486	105
P17532	PF00351	108	437	3.002869696969698	329	G5BNP8	106	435	2.857736363636362	329
Q3U129	PF00535	44	185	3.2112464788732398	141	G5BJB5	1	141	1.0591702127659577	140
Q8C7V8	PF15002	26	222	2.2010355329949216	196	G5BPQ4	27	223	2.923675126903552	196
D3YY23	PF02190	556	752	5.990817258883246	196	G5ANJ5	329	525	6.233350253807106	196
D3YY23	PF13445	117	143	0.038074074074074066	26	G5ANJ5	240	266	0.0	26
D3YY23	PF13923	466	504	0.0	38	G5ANJ5	239	277	0.0	38
Q80WB5	PF09764	24	201	3.8971460674157314	177	G5C2Z9	24	201	3.97479213483146	177
Q9JHG0	PF00386	64	193	2.028253846153845	129	G5BDS2	73	202	1.9886538461538457	129
B7ZMP1	PF00557	253	480	2.9619692982456147	227	G5BVC2	175	398	4.440183035714289	223
B7ZMP1	PF05195	79	197	6.882789915966388	118	G5BVC2	1	119	5.228025210084034	118
Q9EQ61	PF06732	6	276	7.062988929889296	270	G5AVP2	7	277	7.1688929889298905	270
Q9EQ61	PF16589	322	411	5.690466666666665	89	G5AVP2	319	408	5.6918	89
O08576	PF02759	59	186	4.459039062500001	127	G5BIZ6	62	189	7.9500625	127
Q61085	PF00595	501	573	9.010698630136984	72	G5AWF9	503	575	9.116150684931506	72
Q61085	PF02185	43	105	0.0	62	G5AWF9	37	99	0.0	62
Q61085	PF03097	132	473	2.2343099415204684	341	G5AWF9	118	457	2.0204176470588244	339
Q7TNI7	PF06083	74	152	0.027417721518987345	78	G5BC80	132	210	6.422949367088608	78
E9PV87	PF15324	268	1344	1.6083259052924779	1076	G5C0A1	260	1334	0.7781934883720926	1074
Q6NZM9	PF00850	671	983	7.353811501597447	312	G5BHI3	668	985	7.744210691823904	317
Q6NZM9	PF12203	89	132	0.0915681818181818	43	G5BHI3	85	127	0.0	42
Q9D824	PF05182	152	194	0.0	42	G5C9V2	98	140	0.0	42
Q9EQZ6	PF00027	66	143	7.239641025641028	77	G5ALR1	236	308	14.723726027397255	72
Q9EQZ6	PF00027	377	457	13.289469135802472	80	G5ALR1	233	313	13.28892592592592	80
Q9EQZ6	PF00617	774	951	6.1218258426966266	177	G5ALR1	631	808	6.2253820224719085	177
Q9EQZ6	PF00618	499	604	5.718179245283017	105	G5ALR1	355	461	4.254654205607476	106
Q9EQZ6	PF00610	221	288	0.7211029411764707	67	G5ALR1	77	144	0.7378235294117649	67
P47856	PF01380	378	506	11.388379844961245	128	G5BNZ1	437	565	11.575472868217053	128
P47856	PF01380	548	678	5.792954198473284	130	G5BNZ1	616	746	5.7976488549618335	130
P47856	PF13522	85	188	8.341653846153845	103	G5BNZ1	160	263	7.869971153846151	103
Q8BVZ1	PF03036	34	395	0.1762099447513812	361	G5BZ98	1	363	1.1414132231404963	362
Q9Z0L4	PF00019	289	390	1.6905882352941175	101	G5C852	299	400	1.5624803921568624	101
P97297	PF00214	0	148	8.719268456375843	148	G5BFH3	1	145	9.949441379310343	144
O88811	PF00018	207	252	1.231739130434783	45	G5BIX5	195	240	9.023739130434778	45
O88811	PF00790	13	139	2.650685039370079	126	G5BIX5	1	127	2.0792519685039363	126
O88811	PF02809	165	180	0.0	15	G5BIX5	153	168	0.0	15
Q3UIZ8	PF00069	492	745	6.298287401574802	253	G5C3N4	506	759	6.259350393700785	253
Q8VD33	PF00515	153	185	0.2488787878787879	32	G5B0E9	154	186	0.21715151515151512	32
Q8VD33	PF13414	91	131	0.21475609756097566	40	G5B0E9	92	132	0.7068292682926829	40
Q8VD33	PF16546	4	62	8.319949152542371	58	G5B0E9	5	63	8.025101694915254	58
O35280	PF00069	10	263	7.1492952755905534	253	G5APF0	83	336	6.951913385826772	253
Q8BWP5	PF00650	96	247	11.87000657894737	151	G5BIT1	97	248	11.18376315789474	151
Q8BWP5	PF03765	47	71	0.43272	24	G5BIT1	48	72	0.34824000000000005	24
P97489	PF00320	195	228	0.0	33	G5C8E8	15	48	0.0	33
P97489	PF00320	259	282	0.0	23	G5C8E8	79	102	0.0	23
Q80VL3	PF00412	185	244	15.472533333333335	59	G5BJJ9	96	155	16.364616666666667	59
Q80VL3	PF00412	250	305	0.0	55	G5BJJ9	161	216	0.0	55
Q80VL3	PF00412	310	363	0.05055555555555556	53	G5BJJ9	221	274	0.05	53
Q80VL3	PF06297	104	174	0.715619718309859	70	G5BJJ9	15	85	3.5301408450704224	70
P47931	PF07648	117	163	0.0	46	G5C6Y7	118	164	0.0	46
P47931	PF07648	191	238	0.34810416666666666	47	G5C6Y7	192	239	0.3489583333333333	47
P47931	PF07648	269	315	0.07782978723404255	46	G5C6Y7	270	316	0.8460851063829788	46
P47931	PF09289	94	115	0.0	21	G5C6Y7	95	116	0.0	21
Q5NCC9	PF00622	343	448	13.327632075471705	105	G5ARG2	234	339	12.554358490566035	105
Q5NCC9	PF13765	291	339	0.4499183673469387	48	G5ARG2	182	230	0.3853673469387756	48
Q8R3P0	PF04952	9	298	3.263351724137931	289	G5B939	6	295	5.693955172413796	289
Q9DCS3	PF00107	194	326	6.7897593984962406	132	G5APA0	195	327	8.576924812030075	132
Q9DCS3	PF08240	71	130	1.5178166666666664	59	G5APA0	72	131	1.6459500000000005	59
Q9DB98	PF10197	7	43	0.08027027027027027	36	G5CBF7	8	44	0.0	36
P70168	PF03810	33	100	0.8791764705882352	67	G5BY29	51	118	0.8312499999999999	67
P70168	PF13513	379	434	3.891767857142857	55	G5BY29	397	452	3.888553571428572	55
P07356	PF00191	37	101	17.93666153846154	64	G5AWC0	168	232	18.44924615384615	64
P07356	PF00191	108	173	0.2880303030303031	65	G5AWC0	239	304	0.31636363636363635	65
P07356	PF00191	192	258	2.439567164179105	66	G5AWC0	323	389	2.6942686567164182	66
P07356	PF00191	268	333	6.7825454545454535	65	G5AWC0	399	515	1.8683418803418803	116
D3YUG0	PF00536	29	85	3.135736842105264	56	G5C930	30	86	3.20180701754386	56
Q9D0S9	PF01230	63	156	1.069872340425532	93	G5BKY9	64	157	1.0859468085106379	93
Q8BG71	PF02475	164	315	2.0815263157894743	151	G5AY93	166	317	2.319848684210524	151
Q66L42	PF07714	97	356	7.7327923076923035	259	G5AK34	98	357	7.749057692307693	259
Q66L42	PF14604	22	76	3.1276181818181827	54	G5AK34	23	77	2.065618181818182	54
Q6TYB5	PF07763	96	265	2.0858	169	G5BDS8	1	169	4.544260355029585	168
Q64191	PF01112	35	323	4.404889273356402	288	G5C3P6	36	324	3.3245951557093423	288
E9Q5L8	PF06021	0	191	3.322770833333333	191	G5BFM1	1	190	2.9954315789473687	189
E9Q5L8	PF08444	193	280	1.4575909090909092	87	G5BFM1	192	279	3.545977272727271	87
O70299	PF03281	62	342	4.226900355871888	280	G5AVY9	63	343	4.226900355871888	280
A2ANX9	PF00096	382	404	0.0	22	G5AYN7	441	463	0.0	22
A2ANX9	PF00096	504	526	0.0	22	G5AYN7	563	585	0.0	22
A2ANX9	PF00096	532	555	0.0	23	G5AYN7	591	614	0.054375000000000014	23
A2ANX9	PF00096	589	612	0.0	23	G5AYN7	648	671	0.0	23
A2ANX9	PF00096	618	640	0.0	22	G5AYN7	677	699	0.0	22
A2ANX9	PF00096	676	697	0.0	21	G5AYN7	735	756	0.0	21
A2ANX9	PF00096	703	726	0.0	23	G5AYN7	762	785	0.0	23
A2ANX9	PF04704	65	305	4.034921161825728	240	G5AYN7	66	317	3.7100317460317456	251
A2ANX9	PF04704	319	367	0.14957142857142858	48	G5AYN7	378	426	0.9176122448979591	48
A2ANX9	PF13909	475	500	0.0	25	G5AYN7	534	559	0.0	25
Q91V76	PF08925	19	302	0.9142605633802818	283	G5C3X9	20	303	1.9903556338028163	283
P22682	PF00627	864	898	1.8179428571428573	34	G5BHP2	804	838	1.8224000000000005	34
P22682	PF02262	62	172	0.9810900900900901	110	G5BHP2	1	111	0.9784414414414412	110
P22682	PF02761	176	259	0.6236547619047615	83	G5BHP2	115	198	0.6253690476190477	83
P22682	PF02762	261	346	5.554558139534883	85	G5BHP2	200	285	5.538999999999998	85
P22682	PF14447	378	425	0.0	47	G5BHP2	317	364	0.0	47
Q9R1A9	PF00929	10	200	5.944706806282718	190	G5B4W7	11	201	5.403879581151831	190
Q3UZZ4	PF02191	243	496	9.500074803149609	253	G5BN32	246	499	8.740728346456692	253
Q7TMY8	PF00627	1317	1351	0.0	34	G5C9Y4	1317	1351	0.0	34
Q7TMY8	PF00632	4071	4375	6.0122426229508195	304	G5C9Y4	4080	4387	7.810068181818186	307
Q7TMY8	PF02825	1616	1677	1.9775	61	G5C9Y4	1616	1677	2.3269354838709684	61
Q7TMY8	PF06012	89	366	11.717928057553962	277	G5C9Y4	90	367	11.717219424460433	277
Q7TMY8	PF06025	429	813	5.719927272727271	384	G5C9Y4	430	814	5.591942857142855	384
Q7TMY8	PF14377	2962	2989	0.03125	27	G5C9Y4	2975	3002	0.03125	27
Q7TMY8	PF14377	3010	3042	0.0	32	G5C9Y4	3023	3055	0.0	32
Q7TMY8	PF14377	3051	3081	0.5258709677419355	30	G5C9Y4	3064	3094	0.5630000000000001	30
Q9WV54	PF02275	141	379	9.653502092050212	238	G5AP74	117	355	7.186443514644356	238
Q9WV54	PF15508	43	103	2.391032786885245	60	G5AP74	19	79	0.4523934426229508	60
Q9D0R4	PF00270	30	206	1.989892655367232	176	G5BIK9	31	207	2.035881355932204	176
Q9D0R4	PF00271	242	379	8.733260869565223	137	G5BIK9	243	380	8.022514492753624	137
Q922S4	PF00233	653	886	8.514615384615384	233	G5AS68	665	898	8.521213675213673	233
Q922S4	PF01590	407	546	3.3234571428571424	139	G5AS68	419	558	3.3691928571428567	139
Q922S4	PF13185	236	372	5.969255474452554	136	G5AS68	252	384	7.379503759398495	132
Q8R088	PF05719	47	258	3.94092924528302	211	G5BH44	48	259	3.9374009433962263	211
Q62245	PF00125	58	167	7.461727272727272	109	G5CA65	59	168	7.447554545454547	109
Q62245	PF00169	448	543	2.865239583333333	95	G5CA65	449	544	3.094333333333333	95
Q62245	PF00617	782	961	12.227183333333342	179	G5CA65	783	962	12.224605555555565	179
Q62245	PF00618	600	716	2.940282051282052	116	G5CA65	601	717	3.8107863247863256	116
Q62245	PF00621	212	384	1.5138959537572252	172	G5CA65	213	385	1.5017803468208093	172
Q9JHW4	PF00009	7	186	6.504316666666668	179	G5BII3	8	186	5.7698603351955295	178
Q9JHW4	PF03144	223	275	1.3067358490566041	52	G5BII3	223	275	1.2709811320754718	52
Q8BHE5	PF00019	364	466	3.805728155339806	102	G5AME7	372	474	3.5787184466019424	102
O08523	PF00094	321	476	3.246705128205128	155	G5APF4	322	477	3.8298141025641033	155
O08523	PF00094	712	865	3.797506493506493	153	G5APF4	713	866	2.3993051948051938	153
O08523	PF00094	1099	1256	13.363702531645574	157	G5APF4	1100	1257	13.854518987341779	157
O08523	PF00094	1486	1637	8.969486842105265	151	G5APF4	1487	1638	8.945368421052637	151
O08523	PF00100	1805	2055	4.606597609561753	250	G5APF4	1806	2056	4.605872509960162	250
O08523	PF01826	596	649	0.2362037037037037	53	G5APF4	597	650	0.235925925925926	53
O08523	PF01826	983	1035	0.0	52	G5APF4	984	1036	0.0	52
O08523	PF01826	1371	1424	0.07087037037037038	53	G5APF4	1372	1425	0.07077777777777777	53
O08523	PF06119	163	249	6.485770114942532	86	G5APF4	164	250	6.44471264367816	86
O08523	PF08742	522	590	3.550173913043478	68	G5APF4	523	591	3.405289855072464	68
O08523	PF08742	911	979	2.04736231884058	68	G5APF4	912	980	2.044652173913044	68
O08523	PF08742	1300	1367	0.1512058823529412	67	G5APF4	1301	1368	0.15107352941176472	67
O08523	PF08742	1689	1756	0.2147647058823529	67	G5APF4	1690	1757	0.2145882352941177	67
O08523	PF12714	651	704	2.418185185185185	53	G5APF4	652	705	2.416444444444444	53
O08523	PF12714	1425	1478	0.015462962962962963	53	G5APF4	1426	1479	0.02009259259259259	53
Q8BVB5	PF17333	24	73	14.903520000000006	49	G5AMF1	25	73	17.18002040816327	48
Q8C6D4	PF10523	323	398	5.909381578947369	75	G5B6D9	324	399	5.909381578947369	75
Q99J25	PF00588	143	298	10.617506410256409	155	G5ARC1	118	281	7.336243902439027	163
Q99J25	PF08032	87	125	0.0	38	G5ARC1	62	100	0.0	38
Q93092	PF00923	23	324	4.76839072847682	301	G5C8H0	24	325	4.559953642384109	301
Q9EPW4	PF00059	85	192	3.719787037037037	107	G5C702	86	193	1.5129074074074078	107
Q9CW46	PF00076	60	122	7.506079365079365	62	G5B227	77	139	7.496888888888893	62
Q9CW46	PF00076	134	202	5.055159420289856	68	G5B227	151	219	4.66	68
P09174	PF04868	14	86	0.0	72	G5BJ67	15	87	0.0	72
P51954	PF00069	201	256	0.06910714285714288	55	G5BC21	39	94	0.057857142857142864	55
Q6PFD7	PF13873	7	84	0.0	77	G5BLF5	8	85	0.0	77
Q3UYV9	PF02854	107	239	9.44124060150375	132	G5C1C6	1	133	10.842233082706764	132
Q3UYV9	PF09088	458	469	0.0	11	G5C1C6	226	237	0.0305	11
Q3UYV9	PF09090	484	758	12.188778181818185	274	G5C1C6	252	526	13.404672727272724	274
Q8C4B4	PF05351	87	246	0.5478000000000002	159	G5AWX2	56	213	0.5245696202531644	157
Q9WUL6	PF00069	405	648	1.3732090163934425	243	G5BIZ1	396	639	2.465725409836065	243
Q5DTX6	PF15351	0	1308	0.4345278838808256	1308	G5C5F3	1	1328	0.3443177710843375	1327
Q8CI96	PF01302	284	347	0.6295	63	G5C2X7	246	309	0.63359375	63
Q8CI96	PF01302	486	549	3.7564843750000017	63	G5C2X7	499	562	3.7635781249999987	63
Q8CI96	PF01302	625	688	1.268609375	63	G5C2X7	638	701	0.6461875	63
Q99K82	PF01593	33	267	0.8422851063829785	234	G5B4V3	34	324	0.6795085910652919	290
Q99K82	PF01593	307	543	3.972037974683544	236	G5B4V3	364	633	3.5027296296296297	269
P59108	PF00168	29	128	4.496749999999999	99	G5BR72	30	129	2.5939999999999994	99
P59108	PF00168	161	250	0.23024444444444445	89	G5BR72	162	251	0.13734444444444446	89
P59108	PF07002	325	541	8.569990783410137	216	G5BR72	326	542	8.624391705069119	216
Q8BHB0	PF00619	20	102	7.155493975903611	82	G5BRM7	21	103	7.143072289156628	82
Q8BHB0	PF05729	196	366	8.821233918128659	170	G5BRM7	197	367	7.477152046783626	170
Q8BHB0	PF13516	728	748	0.007714285714285716	20	G5BRM7	729	749	0.0	20
Q8BHB0	PF13516	782	804	0.8753478260869565	22	G5BRM7	783	805	0.6113478260869565	22
Q8BHB0	PF13516	820	832	0.0	12	G5BRM7	821	833	0.0	12
Q8BHB0	PF13516	838	860	3.613999999999999	22	G5BRM7	839	861	23.06773913043479	22
Q8BHB0	PF13516	865	888	25.74895833333333	23	G5BRM7	866	889	21.224333333333327	23
Q8BHB0	PF17776	516	665	11.771926666666667	149	G5BRM7	517	666	12.085079999999996	149
Q8BHB0	PF17779	459	514	7.4508392857142836	55	G5BRM7	459	515	6.817017543859649	56
Q923X4	PF00462	61	123	5.218	62	G5ASG3	69	131	6.901253968253968	62
Q6PF93	PF00454	696	830	13.324644444444447	134	G5AQ16	649	783	13.318185185185179	134
Q6PF93	PF00613	284	520	7.649367088607597	236	G5AQ16	237	473	7.6397257383966215	236
Q6PF93	PF00792	53	197	2.6485655172413787	144	G5AQ16	54	150	0.9235773195876286	96
Q8C4J7	PF00400	107	136	0.7190000000000001	29	G5BY55	108	137	1.8539333333333332	29
Q8C4J7	PF00400	143	180	13.213131578947367	37	G5BY55	144	181	5.0063947368421085	37
Q8C4J7	PF00400	185	222	16.56031578947368	37	G5BY55	186	223	13.765947368421047	37
Q8C4J7	PF00400	370	403	9.753823529411765	33	G5BY55	371	404	9.717205882352943	33
Q8C4J7	PF00400	412	448	1.7338648648648651	36	G5BY55	413	449	1.5698918918918916	36
Q8C4J7	PF00400	471	505	0.11337142857142855	34	G5BY55	472	506	0.4118285714285715	34
Q8C4J7	PF00400	511	547	5.373243243243244	36	G5BY55	512	548	5.301054054054056	36
Q8C4J7	PF00400	553	589	0.3831081081081081	36	G5BY55	554	590	0.3810540540540541	36
Q8C4J7	PF00400	595	632	1.205421052631579	37	G5BY55	596	633	1.5937368421052631	37
Q8C4J7	PF08625	653	787	7.8497333333333295	134	G5BY55	654	775	9.544483606557382	121
Q9WUB0	PF13445	279	321	1.3318139534883715	42	G5C6M2	245	287	1.3254883720930228	42
Q8C7U7	PF00535	179	364	7.193037634408606	185	G5ATY4	180	365	7.363295698924731	185
Q8C7U7	PF00652	497	618	3.3655573770491807	121	G5ATY4	498	619	0.4749344262295083	121
Q9Z2Y8	PF01168	35	249	1.106586046511628	214	G5B097	36	250	2.492655813953488	214
Q810Z1	PF00061	35	143	15.868458715596326	108	G5BQR1	40	148	12.09285321100917	108
Q91WP0	PF00084	299	360	8.485483870967753	61	G5C521	311	372	1.365725806451613	61
Q91WP0	PF00084	365	428	0.16271875000000005	63	G5C521	377	441	0.14723076923076925	64
Q91WP0	PF00089	443	677	3.74156170212766	234	G5C521	456	690	3.772276595744681	234
Q91WP0	PF00431	27	132	0.6055754716981133	105	G5C521	39	144	1.6600283018867923	105
Q91WP0	PF00431	183	292	3.636518181818182	109	G5C521	195	304	5.651227272727272	109
Q91WP0	PF07645	137	179	0.0872093023255814	42	G5C521	149	191	3.731511627906977	42
Q9QZH6	PF06239	50	265	6.508930555555558	215	G5AJT8	20	235	8.102486111111116	215
Q9QZH6	PF14784	268	392	0.8160720000000004	124	G5AJT8	238	362	2.027448	124
Q8VI36	PF00412	357	411	0.2813818181818182	54	G5B781	480	534	0.28281818181818186	54
Q8VI36	PF00412	416	471	5.7785178571428535	55	G5B781	539	594	5.788285714285713	55
Q8VI36	PF00412	475	527	0.3490188679245285	52	G5B781	598	632	0.4650571428571429	34
Q8VI36	PF00412	534	588	8.383472727272727	54	G5B781	640	694	8.241345454545456	54
Q8VI36	PF03535	51	252	0.004653465346534653	201	G5B781	116	317	0.02806930693069307	201
P28661	PF00735	140	416	2.44002166064982	276	G5BJU2	21	297	2.453104693140796	276
P70458	PF00079	44	404	6.994576177285316	360	G5B492	36	396	13.332144444444435	360
Q8BN78	PF00651	21	113	7.744870967741936	92	G5BTM8	22	114	7.650774193548383	92
Q99MN1	PF00152	219	570	1.4549602272727278	351	G5B5Y6	249	600	1.6834403409090912	351
Q99MN1	PF01336	124	203	0.1516	79	G5B5Y6	154	233	0.2420875	79
Q9CZD3	PF00458	57	98	0.0	41	G5BRM9	14	55	0.0	41
Q9CZD3	PF00587	284	349	0.4509393939393939	65	G5BRM9	241	306	0.4533030303030303	65
Q9CZD3	PF03129	624	697	3.0905000000000005	73	G5BRM9	529	602	3.102648648648649	73
Q8R3I9	PF01762	155	340	6.900940860215057	185	G5AZS4	164	349	7.608548387096772	185
Q8BIY3	PF11977	91	245	6.740825806451613	154	G5BMC7	86	240	6.822412903225808	154
Q8BIY3	PF18039	6	43	0.07136842105263158	37	G5BMC7	1	38	0.06539473684210527	37
Q99JW2	PF01546	75	187	3.4459823008849555	112	G5AXN3	153	265	4.032327433628319	112
Q99JW2	PF07687	188	297	3.7301909090909087	109	G5AXN3	266	375	2.114618181818182	109
Q9CRB6	PF05517	10	165	0.4539230769230769	155	G5C659	11	166	0.4532564102564105	155
Q99MB2	PF05308	22	248	0.09925991189427312	226	G5C170	23	250	1.2473640350877195	227
Q9QXP6	PF00097	280	333	0.06637037037037036	53	G5B567	225	278	0.049592592592592605	53
Q9QXP6	PF14608	368	390	0.0	22	G5B567	313	335	0.0	22
Q9QXP6	PF15815	391	480	4.18701111111111	89	G5B567	336	426	4.207422222222221	90
Q9QXP6	PF18044	61	79	0.0	18	G5B567	7	25	0.0	18
Q9QXP6	PF18044	87	107	0.32928571428571435	20	G5B567	33	53	0.3108095238095238	20
Q9QXP6	PF18044	212	232	0.0	20	G5B567	157	177	0.0	20
Q9WUU7	PF00112	63	282	1.3419227272727268	219	G5AKZ5	55	274	2.3944499999999995	219
Q8K114	PF16661	84	237	1.5463246753246758	153	G5B504	82	235	2.6426948051948056	153
P97369	PF00018	176	219	11.526863636363634	43	G5BAW0	167	210	11.51475	43
P97369	PF00564	236	265	0.023033333333333333	29	G5BAW0	227	256	0.6628333333333334	29
P97369	PF00787	45	134	1.9996777777777777	89	G5BAW0	36	125	3.6957444444444465	89
Q7TQF7	PF03114	42	231	1.101057894736842	189	G5B6T9	105	294	1.0895736842105264	189
Q7TQF7	PF14604	620	681	4.806919354838709	61	G5B6T9	679	740	3.1449032258064524	61
P63084	PF01023	4	41	3.8444736842105263	37	G5BEQ6	5	42	3.8993684210526314	37
E9PYK3	PF00644	381	557	3.3314124293785308	176	G5B1A8	388	564	4.2779717514124265	176
E9PYK3	PF08487	615	725	12.71923423423424	110	G5B1A8	622	732	12.637738738738737	110
E9PYK3	PF13768	867	1016	8.571759999999996	149	G5B1A8	874	1023	8.488439999999999	149
E9PYK3	PF16589	4	91	4.230636363636363	87	G5B1A8	5	92	0.7756136363636362	87
P55821	PF00836	38	172	1.6512444444444443	134	G5BAJ8	28	162	1.6562666666666666	134
Q5SVL6	PF02145	258	437	6.6109555555555595	179	G5BCT2	252	431	6.858661111111117	179
Q9QY48	PF03265	26	352	3.8764525993883816	326	G5C929	27	356	3.742560606060608	329
Q9WV72	PF07525	459	500	0.0958095238095238	41	G5B8U5	424	465	0.05971428571428571	41
Q9WV72	PF12796	15	107	1.2949354838709677	92	G5B8U5	16	108	2.152225806451613	92
Q9WV72	PF12796	157	238	3.34879268292683	81	G5B8U5	122	203	5.2070487804878045	81
Q9WV72	PF13606	113	138	11.706999999999995	25	G5B8U5	145	170	7.305269230769232	25
Q9WV72	PF13637	249	299	4.3853333333333335	50	G5B8U5	214	264	4.431921568627451	50
Q6Y685	PF05010	567	766	2.7913850000000013	199	G5B0B2	608	807	2.796619999999999	199
Q8R4W6	PF00431	31	139	7.344770642201836	108	G5ALG8	32	140	7.742128440366974	108
Q8R4W6	PF00431	152	260	10.00304587155963	108	G5ALG8	153	261	10.965321100917427	108
Q8R4W6	PF01759	308	409	15.896245098039222	101	G5ALG8	309	410	17.042519607843133	101
O35474	PF00008	25	57	0.0	32	G5BHB0	4	36	0.0	32
O35474	PF00008	77	114	9.719026315789472	37	G5BHB0	56	93	9.75263157894737	37
O35474	PF00754	172	310	0.2683741007194244	138	G5BHB0	151	289	0.325136690647482	138
O35474	PF00754	333	472	0.20581428571428573	139	G5BHB0	312	451	0.21552857142857146	139
O35474	PF12661	127	145	0.06421052631578948	18	G5BHB0	106	124	0.06473684210526316	18
Q8CI12	PF00307	348	452	6.603704761904762	104	G5B917	348	452	5.73644761904762	104
P28704	PF00104	322	499	7.679960674157307	177	G5BAZ9	319	500	7.487587912087908	181
P28704	PF00105	190	258	0.061884057971014476	68	G5BAZ9	186	254	0.05563768115942029	68
P49813	PF03250	2	142	0.5326241134751774	140	G5C1C8	3	143	0.5337234042553192	140
Q9DBG1	PF00067	86	526	6.2704331065759575	440	G5AKL6	17	457	6.503038548752838	440
Q9R144	PF05175	175	221	5.760638297872344	46	G5BW13	8	54	7.7499574468085095	46
P63037	PF00226	5	64	0.0	59	G5B038	6	80	0.10136000000000003	74
P63037	PF00684	133	199	0.0	66	G5B038	149	215	0.0	66
P63037	PF01556	107	132	0.09826923076923078	25	G5B038	123	148	0.09788461538461538	25
Q9DCH2	PF12328	32	132	0.5167920792079209	100	G5BBZ4	33	133	0.5167623762376238	100
O88621	PF00250	62	141	12.806300000000002	79	G5C5S0	29	108	12.804850000000002	79
Q8K400	PF00400	240	265	2.8440000000000003	25	G5AND4	241	266	3.2178846153846155	25
Q8K400	PF08366	276	384	7.1711376146789005	108	G5AND4	277	385	7.1823119266055055	108
Q8K400	PF08596	904	1025	3.630131147540983	121	G5AND4	905	1026	3.5921967213114763	121
Q8K2Y0	PF13923	17	54	5.703184210526314	37	G5B9S9	18	55	6.222815789473684	37
Q8BGZ1	PF00036	65	89	12.32476	24	G5C4Y8	66	90	13.734280000000002	24
Q8BGZ1	PF13499	97	174	14.897205128205126	77	G5C4Y8	98	175	14.897205128205126	77
Q9QXZ7	PF00104	204	352	6.0240134228187925	148	G5C6U0	202	351	6.98893959731544	149
Q9QXZ7	PF00105	38	106	0.021521739130434783	68	G5C6U0	38	106	0.021521739130434783	68
Q9CQR6	PF00149	46	237	6.200864583333331	191	G5B6V9	89	280	6.182114583333332	191
Q99ME9	PF06858	234	291	14.826999999999998	57	G5BUS7	220	277	14.827344827586206	57
Q99ME9	PF08155	394	445	0.0	51	G5BUS7	380	431	0.0	51
Q99ME9	PF17835	15	164	0.21618666666666664	149	G5BUS7	1	150	0.21622666666666665	149
Q8C6I2	PF03937	64	137	11.017270270270267	73	G5AYG0	60	133	12.33382432432432	73
Q3UMG5	PF00307	660	756	1.6694020618556702	96	G5BL49	435	531	1.9021340206185564	96
Q3UMG5	PF13855	125	176	1.080711538461539	51	G5BL49	29	80	0.5086538461538461	51
Q3UMG5	PF13855	188	244	2.36261403508772	56	G5BL49	24	80	2.2896491228070173	56
Q80X91	PF14160	142	228	0.1502528735632184	86	G5AUQ6	194	279	0.15186046511627907	85
Q80X91	PF14161	11	41	0.0	30	G5AUQ6	68	98	0.0	30
Q60674	PF00104	399	573	8.63589142857143	174	G5BFQ0	399	572	8.64302873563218	173
Q60674	PF00105	101	170	0.1662	69	G5BFQ0	97	166	0.06874285714285715	69
Q9QZ04	PF01454	1058	1223	20.351548192771087	165	G5C218	887	1052	15.32410240963856	165
Q9CZR3	PF01459	25	301	6.914920577617327	276	G5BWH7	26	302	6.922512635379062	276
Q921M3	PF03178	862	1182	6.406604361370716	320	G5C1Q0	844	1206	5.805561983471078	362
Q921M3	PF10433	75	591	8.17306963249516	516	G5C1Q0	76	573	7.425216867469881	497
Q80YT9	PF00076	11	79	8.743333333333336	68	G5B4Q3	12	80	8.105	68
Q8R1R4	PF15036	28	182	5.149670967741933	154	G5C1Q1	29	183	6.54694193548387	154
Q810A7	PF00270	276	447	6.0012732558139525	171	G5BDJ1	278	449	6.000947674418606	171
Q810A7	PF00271	487	592	5.510716981132081	105	G5BDJ1	489	594	5.508886792452833	105
Q9DBS5	PF13374	377	420	0.24338636363636354	43	G5BNL4	378	421	0.09427272727272727	43
Q9DBS5	PF13374	465	492	0.0	27	G5BNL4	466	493	0.0	27
Q9DBS5	PF13424	210	284	12.983466666666665	74	G5BNL4	211	285	12.983906666666664	74
Q9DBS5	PF13424	293	368	4.322618421052631	75	G5BNL4	294	368	4.287706666666667	74
Q3UN58	PF15750	149	183	0.11537142857142857	34	G5ATI2	221	255	0.0	34
Q3UN58	PF15751	34	140	0.7078691588785049	106	G5ATI2	111	211	1.5344455445544547	100
Q3UU96	PF00069	76	342	3.237602996254679	266	G5BL22	77	343	3.1721573033707857	266
Q3UU96	PF00130	999	1049	2.1761176470588235	50	G5BL22	1000	1050	2.171039215686274	50
Q3UU96	PF00433	361	403	5.393883720930233	42	G5BL22	362	404	5.769744186046512	42
Q3UU96	PF00780	1219	1480	4.978198473282445	261	G5BL22	1220	1480	5.257869731800769	260
Q3UU96	PF08826	880	940	0.0	60	G5BL22	881	941	0.0	60
Q3UU96	PF15796	528	607	0.0064375000000000005	79	G5BL22	529	608	0.0064375000000000005	79
P58742	PF00400	239	272	14.848	33	G5BIG0	240	273	6.743794117647059	33
Q6SJ95	PF00352	174	253	2.4843375	79	G5AJQ6	209	288	3.17095	79
Q6SJ95	PF00352	262	294	3.706151515151515	32	G5AJQ6	297	328	0.12456250000000002	31
Q5NC57	PF14886	17	120	0.4110769230769231	103	G5BK80	18	121	0.30288461538461536	103
Q810N5	PF15047	93	234	1.4995	141	G5BV50	1	138	2.929478260869565	137
Q8K4J2	PF01833	255	337	17.905192771084334	82	G5B4S0	256	338	15.787192771084332	82
Q8K4J2	PF16422	20	247	7.359969298245611	227	G5B4S0	21	248	7.34545614035088	227
Q8K4J2	PF16423	340	383	1.7309545454545452	43	G5B4S0	341	384	0.06459090909090909	43
P63042	PF00836	48	182	0.1196296296296296	134	G5BY96	92	261	0.026235294117647055	169
Q811H0	PF00096	359	381	0.0	22	G5AWI8	341	363	0.0	22
Q811H0	PF00096	388	410	0.0	22	G5AWI8	370	392	0.0	22
Q811H0	PF00651	54	119	0.7833939393939396	65	G5AWI8	52	117	1.6743787878787877	65
Q811H0	PF13894	332	353	0.0	21	G5AWI8	314	335	0.0	21
Q9CR24	PF00293	40	147	1.652805555555555	107	G5BTW3	41	148	2.9758796296296315	107
O88502	PF00233	549	800	3.5423015873015893	251	G5B1R6	481	733	2.1584545454545463	252
O88502	PF13426	221	319	0.42595959595959604	98	G5B1R6	154	252	0.3985353535353535	98
Q80UY1	PF07942	136	398	7.5940456273764205	262	G5BHT9	72	334	8.300688212927762	262
Q8R3J5	PF04752	33	206	9.374718390804592	173	G5BM07	33	210	6.362769662921346	177
Q6DFV7	PF01476	119	160	0.2716428571428572	41	G5C4S9	377	418	0.2634523809523809	41
Q6DFV7	PF07534	806	941	6.700919117647058	135	G5C4S9	1074	1209	6.66479411764706	135
Q9ET26	PF05605	140	200	0.0	60	G5AZ06	140	200	0.0	60
Q9ET26	PF13445	29	61	0.1416060606060606	32	G5AZ06	29	61	0.14030303030303032	32
Q9ET26	PF18574	85	117	0.0	32	G5AZ06	85	117	0.0	32
P28660	PF09735	36	1061	8.422468810916186	1025	G5AVJ8	1	1025	8.348906249999999	1024
Q3UE37	PF00179	107	232	9.356055555555557	125	G5C4N1	6	131	9.423	125
Q8CCJ9	PF02820	17	67	0.021470588235294116	50	G5C6Q4	18	68	0.021470588235294116	50
Q8CCJ9	PF12618	216	310	0.12876842105263156	94	G5C6Q4	217	312	0.1163229166666667	95
Q8CCJ9	PF16660	317	412	0.55978125	95	G5C6Q4	319	415	0.20587628865979374	96
Q8CCJ9	PF18104	89	122	1.6724705882352942	33	G5C6Q4	90	123	1.6752941176470588	33
Q3UJZ3	PF00514	87	125	21.25325641025641	38	G5BNC5	104	142	23.254384615384613	38
Q9D8U7	PF03942	66	286	7.7820859728506795	220	G5CA46	67	285	8.618292237442922	218
Q9Z2N8	PF00022	7	427	2.8998456057007123	420	G5BX65	8	428	2.1880855106888357	420
Q8K3M5	PF00134	364	457	17.343723404255325	93	G5C8F0	345	438	17.35031914893618	93
P21614	PF00273	27	198	2.9789302325581404	171	G5BE53	28	199	1.8163313953488367	171
P21614	PF00273	218	384	2.576041916167666	166	G5BE53	219	385	5.104491017964073	166
P21614	PF09164	404	465	0.0	61	G5BE53	405	465	0.16262295081967212	60
Q99LD9	PF01008	27	332	4.928366013071896	305	G5C1L3	28	333	5.490199346405226	305
P70390	PF00046	140	196	0.7833333333333333	56	G5BVR4	141	197	0.7868596491228069	56
Q8VEK6	PF12998	2	103	0.022401960784313727	101	G5BNR0	3	104	0.0225	101
O55229	PF01633	96	307	3.4805990566037703	211	G5B2F9	28	239	3.7116603773584913	211
Q8CIV3	PF00151	38	323	3.7874230769230777	285	G5BT99	226	512	6.053975609756094	286
Q9R0G6	PF11598	28	54	0.009259259259259259	26	G5C5B1	30	55	0.0	25
Q9R0G6	PF02412	298	333	0.0	35	G5C5B1	226	261	0.0	35
Q9R0G6	PF02412	357	392	0.0	35	G5C5B1	262	320	0.0	58
Q9R0G6	PF02412	394	415	0.0	21	G5C5B1	322	343	0.0	21
Q9R0G6	PF02412	416	453	0.0	37	G5C5B1	344	381	0.0	37
Q9R0G6	PF02412	454	489	0.0	35	G5C5B1	344	381	0.0	37
Q9R0G6	PF02412	490	524	0.008514285714285714	34	G5C5B1	418	452	0.01277142857142857	34
Q9R0G6	PF05735	543	740	5.507893939393939	197	G5C5B1	471	668	5.54711616161616	197
Q9R0G6	PF07645	126	158	0.0	32	G5C5B1	54	86	0.0	32
Q9R0G6	PF07645	177	218	0.0	41	G5C5B1	105	146	0.0	41
Q8CDA1	PF02383	59	413	6.798847887323941	354	G5BVW4	18	371	6.622980225988692	353
Q8CDA1	PF12456	592	696	10.506933333333334	104	G5BVW4	494	598	7.485457142857142	104
Q8BVH9	PF08242	83	181	11.984838383838385	98	G5BUL1	84	182	10.61941414141414	98
Q6P6N5	PF00568	43	105	0.33085714285714285	62	G5AMB5	60	122	0.5729206349206349	62
Q6P6N5	PF05210	306	398	1.0005268817204305	92	G5AMB5	263	355	1.0131720430107527	92
Q3UNZ8	PF00107	179	294	5.650465517241378	115	G5BIB1	180	295	6.961939655172419	115
Q3UNZ8	PF08240	50	127	0.5837820512820513	77	G5BIB1	51	128	0.1794871794871795	77
Q8R3C6	PF00076	3	71	4.9309420289855055	68	G5AKX5	4	72	4.967550724637679	68
Q8R3C6	PF00076	300	360	5.592147540983605	60	G5AKX5	297	357	5.528754098360655	60
Q8R3C6	PF00076	401	470	9.578657142857145	69	G5AKX5	399	468	10.417471428571432	69
Q8R3C6	PF00076	723	795	6.066671232876713	72	G5AKX5	727	799	0.7980410958904112	72
Q8R3C6	PF00076	825	896	0.8577916666666664	71	G5AKX5	829	900	0.6598194444444445	71
Q8CE96	PF04189	20	254	4.809804255319145	234	G5BY78	20	254	4.847497872340429	234
Q9R0M5	PF04263	31	144	3.2398596491228067	113	G5C2P1	18	131	3.5761228070175437	113
Q9R0M5	PF04265	168	205	0.0	37	G5C2P1	155	191	0.0	36
Q9Z321	PF01131	169	581	2.460859564164648	412	G5BKF9	170	582	2.536992736077481	412
Q9Z321	PF01751	3	154	5.3215723684210525	151	G5BKF9	4	155	4.955894736842106	151
Q14BV6	PF04794	6	286	3.1593665480427062	280	G5BKG7	7	287	3.4880391459074755	280
Q7TT28	PF15870	793	952	4.1937750000000005	159	G5BW56	824	983	4.202968750000002	159
Q9DD19	PF00788	8	86	9.443658227848095	78	G5C483	12	90	9.0627088607595	78
P70178	PF00046	200	249	0.07177999999999997	49	G5AUX8	75	124	0.0	49
P70178	PF16878	126	188	0.2821904761904762	62	G5AUX8	1	63	0.019523809523809527	62
Q61147	PF00394	222	355	2.218261194029852	133	G5BSL1	246	379	1.6842985074626873	133
Q61147	PF07731	950	1001	1.3433269230769231	51	G5BSL1	909	959	7.386627450980392	50
Q61147	PF07732	91	198	4.591453703703703	107	G5BSL1	114	222	0.5857064220183484	108
Q61147	PF07732	446	520	0.039560000000000005	74	G5BSL1	470	549	0.0108125	79
Q61147	PF07732	801	861	0.0	60	G5BSL1	760	820	0.03901639344262296	60
Q8C669	PF04710	9	417	1.3567286063569683	408	G5C8M6	10	418	1.3600539215686276	408
Q08189	PF00868	2	116	7.1543652173913035	114	G5B4R5	3	119	7.565982905982906	116
Q08189	PF00927	483	586	7.468375000000003	103	G5B4R5	486	589	11.954730769230776	103
Q08189	PF00927	594	690	1.9119690721649483	96	G5B4R5	597	693	1.3282474226804122	96
Q08189	PF01841	269	354	5.1095930232558135	85	G5B4R5	272	357	4.960593023255815	85
E9PXF8	PF00169	1768	1869	0.13077450980392166	101	G5BRL2	1720	1821	0.13116666666666665	101
E9PXF8	PF02141	116	296	13.055370165745854	180	G5BRL2	26	206	13.786546961325964	180
E9PXF8	PF02893	867	1003	3.0298759124087584	136	G5BRL2	756	892	3.1151897810218947	136
E9PXF8	PF06602	1111	1542	8.59891435185185	431	G5BRL2	1088	1494	7.680353808353808	406
E9PXF8	PF12335	529	751	5.096650224215247	222	G5BRL2	439	640	4.713702970297027	201
Q8R2E9	PF04137	55	454	4.870004999999998	399	G5APM2	56	460	4.984622222222222	404
P63040	PF05835	10	130	0.0607603305785124	120	G5BCK6	98	218	0.013355371900826446	120
Q9CZ44	PF00789	289	367	11.142164556962022	78	G5AV71	290	368	11.115848101265822	78
Q9CZ44	PF08059	183	257	0.05968	74	G5AV71	184	258	0.0	74
Q9CZ44	PF14555	5	46	8.004904761904761	41	G5AV71	6	47	8.340595238095236	41
Q6DFV8	PF00094	430	587	3.1052784810126584	157	G5BJL8	399	555	4.86779617834395	156
Q8BHP2	PF12881	15	508	0.6658724696356275	493	G5C299	79	575	0.8382474849094569	496
Q8BHP2	PF12881	906	1122	0.4211705069124425	216	G5C299	964	1180	1.2644884792626727	216
P61963	PF00400	258	294	0.04240540540540541	36	G5BDJ8	259	295	0.04240540540540541	36
Q61210	PF00621	418	601	1.3698478260869564	183	G5AZQ3	636	819	1.5276249999999998	183
Q61210	PF09128	39	229	4.041554973821991	190	G5AZQ3	198	388	3.870230366492146	190
Q61210	PF17838	631	756	8.87303174603174	125	G5AZQ3	849	974	10.818547619047617	125
Q61122	PF04902	320	484	0.027181818181818182	164	G5BGK7	321	488	0.164625	167
Q61122	PF04904	5	82	2.8215512820512823	77	G5BGK7	6	83	2.8218461538461534	77
Q61122	PF04905	189	316	0.6612265625	127	G5BGK7	190	317	0.6581406249999999	127
Q571F8	PF04960	176	462	6.388080139372819	286	G5BB70	241	528	6.964850694444443	287
Q571F8	PF12796	489	574	11.73477906976744	85	G5BB70	555	640	10.695802325581397	85
Q571F8	PF17959	72	154	10.164530120481928	82	G5BB70	137	219	10.144530120481926	82
P97433	PF00130	651	698	0.11658333333333333	47	G5AMI8	642	688	0.0	46
P97433	PF00621	849	1037	4.251407407407407	188	G5AMI8	841	1043	4.943852216748769	202
P97433	PF17838	1066	1184	12.907689075630248	118	G5AMI8	1072	1190	12.23505882352941	118
Q8BGZ2	PF14944	0	243	0.2429549180327869	243	G5ASA4	1	244	0.2439547325102881	243
Q9CQ24	PF00646	93	136	9.115295454545453	43	G5ASW6	103	146	13.317045454545456	43
Q571I4	PF00069	1092	1288	2.802319796954316	196	G5ANJ6	1098	1303	2.763286407766992	205
Q8K3Y3	PF00098	137	152	0.0	15	G5AUR6	138	153	0.0	15
Q8K3Y3	PF00313	41	110	0.33188571428571423	69	G5AUR6	42	111	0.33188571428571423	69
Q99LB0	PF18192	65	130	0.0443939393939394	65	G5B7N8	66	131	0.2317878787878788	65
P70349	PF01230	37	119	0.2151084337349398	82	G5BCB1	1	83	0.31363855421686754	82
Q78J03	PF01641	45	171	0.060748031496063025	126	G5AVX7	60	186	0.0701417322834646	126
O70343	PF00076	677	737	2.2788196721311467	60	G5C133	678	738	2.128754098360655	60
P42228	PF00017	573	628	11.895053571428573	55	G5BGK4	573	628	10.938125	55
P42228	PF01017	139	307	2.549023668639053	168	G5BGK4	140	307	3.238940476190476	167
P42228	PF02864	322	454	2.5005939849624057	132	G5BGK4	322	454	1.8995187969924812	132
P42228	PF02865	1	118	7.836016949152544	117	G5BGK4	2	119	7.827033898305086	117
Q8BFZ9	PF01145	24	206	3.643196721311475	182	G5B096	25	207	3.643551912568309	182
Q99L88	PF00169	323	430	4.466527777777778	107	G5C9Q6	226	333	4.46687962962963	107
Q99L88	PF18012	262	293	1.38459375	31	G5C9Q6	165	196	1.40903125	31
Q8BRK8	PF00069	31	267	4.6110675105485255	236	G5APP8	52	288	4.604358649789027	236
Q8BRK8	PF16579	400	479	2.105349999999999	79	G5APP8	421	500	2.0182124999999993	79
P62700	PF03226	13	106	1.597425531914894	93	G5C2X5	14	107	1.5946170212765962	93
Q9D892	PF01725	9	186	3.446162921348316	177	G5B4T5	23	196	8.285649425287357	173
Q3U515	PF00093	377	431	0.0	54	G5AYG7	367	421	0.20705454545454546	54
Q3U515	PF00093	492	550	0.0	58	G5AYG7	482	538	0.0	56
Q3U515	PF00093	620	675	1.127625	55	G5AYG7	608	663	1.1993035714285714	55
Q3U515	PF07645	141	178	0.0	37	G5AYG7	135	172	0.0	37
Q3U515	PF07645	180	217	0.0	37	G5AYG7	176	213	0.0	37
Q3U515	PF07645	219	260	0.16492857142857145	41	G5AYG7	215	256	0.16571428571428573	41
Q6PAL1	PF15550	155	342	2.089324468085106	187	G5C510	1	186	1.9831567567567567	185
P0C5K1	PF00069	61	316	7.788468750000002	255	G5BVY7	60	315	8.001187500000002	255
E9Q5M6	PF00400	362	380	0.0	18	G5BXQ7	16	34	10.77915789473684	18
Q9JM13	PF01754	16	39	0.0	23	G5BIR9	112	135	0.0	23
Q9JM13	PF02204	269	369	14.818871287128713	100	G5BIR9	446	546	14.75615841584159	100
Q9JM13	PF18151	157	219	0.0	62	G5BIR9	289	396	0.034962962962962967	107
Q99P58	PF00071	10	181	7.487395348837213	171	G5ARQ4	11	182	7.630750000000003	171
P39054	PF00169	519	619	9.959445544554457	100	G5BUH8	522	622	9.955673267326732	100
P39054	PF00350	33	205	8.419601156069357	172	G5BUH8	34	206	8.356861271676294	172
P39054	PF01031	215	500	3.7578986013986	285	G5BUH8	216	507	3.5799520547945183	291
P39054	PF02212	649	737	9.286999999999997	88	G5BUH8	651	739	10.38958426966292	88
Q8BPB0	PF03637	32	203	4.153191860465116	171	G5BN03	29	200	4.154924418604651	171
P04184	PF00265	32	188	5.506592356687898	156	G5AVE6	41	197	4.287745222929933	156
P10833	PF00071	41	190	10.20696	149	G5B8P9	42	191	10.303793333333337	149
Q9Z2I4	PF00041	557	640	7.869249999999999	83	G5BEE8	496	579	9.555583333333333	83
Q9Z2I4	PF00041	783	856	0.7231891891891892	73	G5BEE8	722	795	0.6455540540540542	73
Q9Z2I4	PF07679	167	248	5.595329268292682	81	G5BEE8	106	187	3.7887439024390246	81
Q9Z2I4	PF07679	257	342	0.4096046511627909	85	G5BEE8	196	281	0.450325581395349	85
Q9Z2I4	PF07679	452	531	0.7455625000000003	79	G5BEE8	391	470	1.541025	79
Q9Z2I4	PF13927	63	146	1.5983690476190473	83	G5BEE8	2	85	1.5986309523809523	83
Q9Z2I4	PF13927	345	425	0.9910370370370368	80	G5BEE8	284	364	1.3318271604938274	80
Q99M85	PF00096	195	212	0.0	17	G5C5T1	73	90	0.0	17
Q99M85	PF00096	247	269	0.0	22	G5C5T1	125	147	0.0	22
Q99M85	PF00096	277	297	0.0	20	G5C5T1	155	175	0.0	20
Q99M85	PF00096	303	322	0.0	19	G5C5T1	181	200	0.0	19
Q99M85	PF13912	221	243	0.0	22	G5C5T1	99	121	0.0	22
Q91YT7	PF04146	410	543	5.897373134328357	133	G5AP95	403	536	5.900514925373132	133
Q9QXV9	PF05210	179	290	0.07250000000000002	111	G5BF24	186	297	0.1196339285714286	111
Q9D7I5	PF13242	186	259	0.06386486486486488	73	G5BZ30	187	260	0.3336486486486485	73
Q9D7I5	PF13344	13	111	2.028232323232323	98	G5BZ30	14	111	0.3164693877551019	97
Q8CF98	PF00059	165	271	7.6140560747663555	106	G5C9R8	166	272	7.383168224299067	106
Q8CF98	PF01391	46	94	0.0	48	G5C9R8	47	94	0.0	47
Q8CF98	PF01391	64	116	0.0	52	G5C9R8	65	117	0.0	52
Q8BFS9	PF00733	478	593	2.5040948275862074	115	G5B3P1	485	600	3.9195	115
Q8BFS9	PF13537	62	157	11.198062500000008	95	G5B3P1	68	163	8.307062499999994	95
Q8BVW3	PF00622	318	427	4.7850636363636365	109	G5AZ23	302	411	3.795763636363637	109
Q8BVW3	PF00643	19	55	0.02581081081081081	36	G5AZ23	5	41	0.02581081081081081	36
Q8BVW3	PF13765	267	314	0.0	47	G5AZ23	251	298	0.7738958333333333	47
Q9DA03	PF05347	5	59	0.23481818181818184	54	G5BCB0	1	55	0.7230909090909091	54
P05201	PF00155	31	404	2.410799465240641	373	G5C4U7	32	405	1.9965267379679144	373
Q9R1C0	PF04658	11	175	0.8750969696969696	164	G5AQQ1	12	176	0.1868969696969697	164
Q00493	PF00246	112	362	4.40285657370518	250	G5BD31	1	251	4.294458167330676	250
Q00493	PF13620	375	449	0.17074666666666666	74	G5BD31	264	338	0.17044	74
B2RXC1	PF11817	262	520	7.864173745173749	258	G5CAK9	263	521	7.7478764478764495	258
B2RXC1	PF12742	1035	1094	0.5402500000000002	59	G5CAK9	1036	1095	0.5391666666666667	59
Q9JKD9	PF00096	349	371	0.0	22	G5BXM9	370	392	0.0	22
Q9JKD9	PF00651	23	113	8.322945054945055	90	G5BXM9	24	114	7.49032967032967	90
Q9JKD9	PF12874	404	426	0.0	22	G5BXM9	425	447	0.0	22
Q9CYZ2	PF04201	54	118	0.42236923076923066	64	G5C8B5	55	119	0.038200000000000005	64
Q9CYZ2	PF04201	118	210	0.0	92	G5C8B5	119	226	0.0	107
Q8BKC8	PF00454	622	753	8.251416666666659	131	G5AK00	631	762	8.247613636363633	131
Q9WVM1	PF00130	287	335	0.0	48	G5AU06	287	335	0.0	48
Q9WVM1	PF00620	363	507	10.510172413793104	144	G5AU06	363	507	4.501848275862068	144
Q99N42	PF00591	95	324	4.471434782608695	229	G5B2G3	109	338	3.5969347826086984	229
Q99N42	PF02885	23	84	1.5647096774193552	61	G5B2G3	37	98	1.7188387096774194	61
Q99N42	PF07831	374	436	0.0	62	G5B2G3	388	450	5.985079365079364	62
Q80VG1	PF00536	338	403	1.8973484848484845	65	G5BMP4	344	409	2.0253636363636365	65
Q80VG1	PF12140	94	203	8.73838181818182	109	G5BMP4	95	204	3.732772727272728	109
Q80VG1	PF17208	0	59	0.014499999999999997	59	G5BMP4	1	60	0.0	59
Q3UTY6	PF00090	62	74	0.0	12	G5C6T9	585	596	0.0	11
Q3UTY6	PF05986	412	526	0.44865217391304346	114	G5C6T9	78	192	0.4861913043478262	114
Q3UTY6	PF08686	974	1004	1.3616129032258066	30	G5C6T9	639	669	1.3749677419354838	30
Q3UTY6	PF19030	626	675	0.0	49	G5C6T9	291	340	0.0	49
Q3UTY6	PF19030	679	735	0.0	56	G5C6T9	344	400	0.0	56
Q3UTY6	PF19030	738	792	0.0	54	G5C6T9	403	457	0.0	54
Q3UTY6	PF19030	796	849	0.39342592592592607	53	G5C6T9	461	514	0.4059259259259258	53
Q3UTY6	PF19030	855	911	0.0	56	G5C6T9	520	576	0.0	56
Q3UTY6	PF19030	915	966	0.0	51	G5C6T9	580	631	0.0	51
Q9ET54	PF07679	277	367	0.8106043956043956	90	G5BC17	273	363	0.7886813186813187	90
Q9ET54	PF07679	447	544	2.4601530612244904	97	G5BC17	443	540	2.118469387755102	97
Q9ET54	PF07679	1025	1116	0.2545326086956522	91	G5BC17	773	864	0.6546847826086958	91
Q9ET54	PF07679	1159	1249	1.8995494505494503	90	G5BC17	907	997	2.251846153846154	90
Q9ET54	PF07679	1258	1349	5.467750000000002	91	G5BC17	1006	1097	5.559282608695653	91
Q9DCM2	PF01323	7	209	3.0691674876847297	202	G5C2L7	8	210	2.3729950738916252	202
P50518	PF01991	17	215	0.5508391959798996	198	G5BWN6	18	216	0.4524673366834172	198
P58802	PF00566	114	312	14.670934673366823	198	G5APV3	122	320	14.648608040201006	198
Q91XT6	PF00168	240	333	9.872031914893613	93	G5ASH4	243	336	8.851297872340425	93
Q91XT6	PF00168	365	468	10.634067307692307	103	G5ASH4	368	470	11.645980582524269	102
Q3UHX2	PF10252	84	161	0.0	77	G5AX90	61	138	0.0	77
Q8BGW1	PF12933	35	321	1.8334111498257823	286	G5BSE1	22	307	1.5553146853146853	285
Q8BGW1	PF12934	325	452	0.775359375	127	G5BSE1	311	437	6.9184126984126975	126
Q5D1E7	PF11977	134	289	9.703846153846156	155	G5C6G8	136	291	9.21564743589744	155
Q5D1E7	PF18039	48	88	0.0	40	G5C6G8	50	90	0.0	40
Q5D1E7	PF18561	546	589	0.015113636363636362	43	G5C6G8	545	588	0.0	43
Q9ESJ1	PF00134	462	549	13.450443181818175	87	G5BTR3	301	388	12.232840909090907	87
Q6PDQ2	PF00176	733	1016	6.453577464788733	283	G5CAQ0	741	1024	6.455454225352113	283
Q6PDQ2	PF00271	1043	1156	5.184192982456142	113	G5CAQ0	1051	1164	5.1875175438596495	113
Q6PDQ2	PF00385	615	664	0.0479	49	G5CAQ0	623	672	0.048	49
Q6PDQ2	PF00628	364	408	0.17917777777777774	44	G5CAQ0	372	416	0.1793111111111111	44
Q6PDQ2	PF00628	443	487	0.0	44	G5CAQ0	451	495	0.0	44
Q6PDQ2	PF06461	1375	1512	1.5742173913043476	137	G5CAQ0	1383	1520	1.5756956521739132	137
Q6PDQ2	PF06465	1286	1344	0.0272542372881356	58	G5CAQ0	1294	1352	0.0272542372881356	58
Q6PDQ2	PF08073	156	209	0.38446296296296295	53	G5CAQ0	164	217	0.385	53
Q6PDQ2	PF08074	1728	1853	5.755515873015871	125	G5CAQ0	1726	1851	5.756682539682541	125
P86174	PF10523	421	494	2.9361891891891894	73	G5ALP0	249	322	2.9487432432432428	73
Q61324	PF00010	64	115	0.023673076923076925	51	G5BEY5	56	107	0.023673076923076925	51
Q61324	PF00989	139	242	6.753374999999999	103	G5BEY5	131	234	6.7534230769230765	103
Q61324	PF14598	335	435	4.3560198019802	100	G5BEY5	327	427	4.34389108910891	100
Q7TST3	PF07647	114	181	7.30641176470588	67	G5C8B1	85	152	6.4138529411764695	67
Q3UHA3	PF14649	2082	2373	3.7096061643835614	291	G5BVF7	2097	2387	3.730780068728524	290
Q7TQK5	PF09762	27	205	5.424519553072623	178	G5BIB7	28	206	5.582558659217874	178
P19182	PF04836	389	442	0.0	53	G5BCA4	361	414	0.0	53
P19182	PF05004	39	344	7.207199346405231	305	G5BCA4	11	316	6.453653594771242	305
Q9ER74	PF00096	477	499	0.0	22	G5C253	467	489	0.0	22
Q9ER74	PF00096	732	754	0.0	22	G5C253	723	745	0.0	22
Q9ER74	PF00096	1027	1049	2.5143043478260867	22	G5C253	1018	1040	2.0314782608695654	22
Q9ER74	PF00096	1132	1154	0.0	22	G5C253	1123	1145	0.0	22
Q9ER74	PF00096	1160	1182	0.15760869565217392	22	G5C253	1151	1173	0.12608695652173912	22
Q9ER74	PF12874	765	784	2.0039	19	G5C253	756	775	2.0034	19
Q9ER74	PF12874	1001	1021	0.0	20	G5C253	992	1012	0.0	20
A2A9F4	PF15551	45	396	1.0280482954545456	351	G5AUS7	45	395	0.4375028571428571	350
P16015	PF00194	3	257	5.467149019607843	254	G5ATW8	4	258	5.497360784313726	254
Q9D3I6	PF15034	0	83	0.0	83	G5C3M4	1	75	0.0	74
Q8R1T1	PF03357	242	398	0.11494267515923565	156	G5B9R6	245	400	0.10562820512820514	155
Q9CZ91	PF09073	366	439	0.05135135135135135	73	G5B7Y8	306	379	0.0522972972972973	73
Q9WUR9	PF00406	52	124	1.0182054794520548	72	G5BSN7	1	73	1.0526575342465752	72
Q9WUR9	PF05191	125	160	0.0	35	G5BSN7	74	108	0.0	34
Q9D2H5	PF00643	285	325	0.8134634146341463	40	G5APL6	312	350	1.1361282051282051	38
Q5BN45	PF14892	54	136	0.2756987951807228	82	G5B8J3	24	106	0.040602409638554215	82
Q9D1C3	PF03966	49	87	9.979512820512822	38	G5BZ75	57	95	0.0	38
P12658	PF00036	189	216	0.0	27	G5BBP1	179	206	0.0	27
P12658	PF13499	102	168	0.0102089552238806	66	G5BBP1	92	158	0.4026567164179105	66
Q6P9R4	PF00621	488	679	3.464567708333332	191	G5B7I8	107	298	2.7340572916666672	191
Q6P9R4	PF17838	707	824	11.770932203389824	117	G5B7I8	326	442	12.041264957264955	116
Q62000	PF13855	126	178	0.0	52	G5C2Q8	127	179	0.0	52
P68181	PF00069	43	297	7.0233372549019615	254	G5C931	89	343	6.9920470588235295	254
Q9DCM4	PF01221	20	103	16.16542857142857	83	G5AYU0	21	104	16.16779761904762	83
Q8BXR9	PF01237	594	942	3.985103151862464	348	G5B0U6	595	943	3.9636475644699134	348
Q8BXR9	PF15409	90	177	0.1943068181818182	87	G5B0U6	91	178	0.1941022727272728	87
Q711T7	PF00795	5	281	2.303891696750902	276	G5BST1	6	282	2.1878989169675087	276
Q711T7	PF02540	338	597	7.959211538461537	259	G5BST1	339	598	7.7720615384615375	259
Q69ZK6	PF02373	2192	2290	1.406040404040403	98	G5C607	2378	2476	1.3095757575757572	98
Q8R519	PF04909	2	283	1.6374148936170216	281	G5BMI7	3	250	3.1052943548387097	247
P06240	PF00017	126	208	0.22468674698795185	82	G5BU89	127	209	0.2596867469879517	82
P06240	PF00018	66	111	3.472652173913043	45	G5BU89	67	112	2.3585869565217394	45
P06240	PF07714	244	492	5.452538152610444	248	G5BU89	245	493	5.457212851405624	248
Q8BKX6	PF00454	2147	2423	6.6943176895306875	276	G5AY29	2153	2429	6.696613718411554	276
Q8BKX6	PF02260	3627	3656	0.0	29	G5AY29	3635	3664	0.0	29
Q8BKX6	PF15785	628	1239	8.548893790849675	611	G5AY29	628	1239	8.539099673202626	611
Q8BKX6	PF17229	29	137	0.0	108	G5AY29	30	137	0.0	107
P58545	PF00651	121	226	14.07283962264152	105	G5B0X6	53	158	13.99290566037736	105
P58545	PF07707	241	307	0.20019402985074625	66	G5B0X6	173	239	0.1967761194029851	66
P58545	PF08005	383	528	5.0932876712328765	145	G5B0X6	315	460	4.997164383561644	145
Q9D032	PF04503	110	364	0.17578431372549022	254	G5C9M2	1	254	0.1734015748031496	253
Q8C827	PF00096	130	152	0.0	22	G5AY76	225	247	0.0	22
Q8C827	PF00096	158	180	0.0	22	G5AY76	253	275	0.0	22
Q8C827	PF00096	215	236	0.13422727272727275	21	G5AY76	310	331	0.13359090909090907	21
Q8C827	PF00096	242	264	0.0	22	G5AY76	337	359	0.0	22
Q8C827	PF00096	270	292	0.0	22	G5AY76	365	387	0.0	22
Q8C827	PF00096	298	320	0.06434782608695654	22	G5AY76	393	415	0.06413043478260869	22
Q8C827	PF00096	326	348	0.6790869565217391	22	G5AY76	421	443	0.6760869565217392	22
Q8C827	PF00096	354	376	0.0532608695652174	22	G5AY76	449	471	0.05282608695652173	22
Q8C827	PF00096	382	404	0.0	22	G5AY76	477	499	0.0	22
Q8C827	PF00096	410	432	0.11956521739130432	22	G5AY76	505	527	0.11904347826086957	22
Q8C827	PF00096	438	460	0.0	22	G5AY76	533	555	0.0	22
Q8C827	PF00096	466	488	0.0	22	G5AY76	561	583	0.0	22
Q8C827	PF00096	494	516	0.0	22	G5AY76	589	611	0.0	22
Q8C827	PF00096	524	544	0.0	20	G5AY76	619	639	0.0	20
Q8C827	PF00096	550	572	1.0063478260869565	22	G5AY76	645	667	1.0017826086956525	22
Q8C827	PF00096	606	628	0.17669565217391306	22	G5AY76	701	723	0.17530434782608695	22
Q8C827	PF00096	634	656	0.0	22	G5AY76	729	751	0.0	22
Q8C827	PF00096	662	684	0.0	22	G5AY76	757	779	0.0	22
Q8C827	PF00096	690	712	0.0	22	G5AY76	785	807	0.0	22
Q8C827	PF00096	718	740	0.02847826086956522	22	G5AY76	813	835	0.028260869565217388	22
Q8C827	PF00096	746	768	0.0	22	G5AY76	841	863	0.0	22
Q8C827	PF00096	829	851	0.0	22	G5AY76	924	946	0.0	22
Q8C827	PF13912	186	209	0.05458333333333334	23	G5AY76	281	304	0.054375000000000014	23
Q8C827	PF13912	578	601	3.2706250000000003	23	G5AY76	673	696	3.286666666666666	23
Q8BPP0	PF00096	119	141	0.0	22	G5BHZ0	138	160	0.0	22
Q8BPP0	PF00096	147	169	0.0	22	G5BHZ0	166	188	0.0	22
Q8BPP0	PF00096	175	197	0.0	22	G5BHZ0	194	216	0.0	22
Q8BPP0	PF00096	203	225	0.0	22	G5BHZ0	222	244	0.0	22
Q8BPP0	PF00096	231	253	0.0	22	G5BHZ0	250	272	0.0	22
Q8BPP0	PF00096	259	281	0.0	22	G5BHZ0	278	300	0.0	22
Q8BPP0	PF00096	287	309	0.0	22	G5BHZ0	306	328	0.0	22
Q8BPP0	PF00096	315	337	0.0	22	G5BHZ0	334	356	0.0	22
Q8BPP0	PF00096	343	365	0.0	22	G5BHZ0	362	384	0.0	22
Q8BPP0	PF00096	371	393	0.0	22	G5BHZ0	390	412	0.0	22
Q8BPP0	PF00096	399	421	0.0	22	G5BHZ0	418	440	0.0	22
Q8BPP0	PF00096	427	449	0.0	22	G5BHZ0	446	468	0.0	22
Q8BPP0	PF01352	0	35	0.37430555555555545	35	G5BHZ0	19	54	0.4009444444444443	35
Q8BVZ5	PF15095	4	263	2.6496846153846163	259	G5AY64	5	269	5.892498113207549	264
Q9Z140	PF00168	26	124	5.014737373737373	98	G5B2A2	27	125	0.27937373737373744	98
Q9Z140	PF00168	158	254	1.2298865979381444	96	G5B2A2	159	262	0.981519230769231	103
Q9Z140	PF07002	324	540	5.961612903225805	216	G5B2A2	333	549	6.206396313364057	216
Q9DBS9	PF01237	494	837	3.727116279069765	343	G5BCX7	483	827	3.5158898550724635	344
Q9DBS9	PF15409	54	141	0.1748181818181818	87	G5BCX7	12	99	0.1871477272727273	87
P11983	PF00118	27	532	4.526903162055338	505	G5BC67	28	496	4.786388059701488	468
P14106	PF00386	120	246	9.266834645669293	126	G5BHZ6	209	333	7.548968000000002	124
P14106	PF01391	46	84	0.0	38	G5BHZ6	135	173	0.0	38
P14106	PF01391	60	116	0.0	56	G5BHZ6	149	205	0.0	56
Q8BIH0	PF16014	634	1039	0.2430714285714285	405	G5C325	605	1010	0.20139162561576354	405
O88508	PF00145	629	762	14.725208955223875	133	G5CBL5	636	769	14.689716417910445	133
O88508	PF00855	286	369	9.692654761904766	83	G5CBL5	293	376	9.707154761904764	83
O88508	PF17980	470	525	0.14783928571428576	55	G5CBL5	477	532	0.14773214285714284	55
Q923K4	PF01926	250	341	3.3590652173913043	91	G5B7V7	76	160	3.8113529411764713	84
Q923K4	PF12631	192	249	3.729241379310344	57	G5B7V7	18	75	1.307258620689655	57
P61222	PF00005	101	243	5.620517482517483	142	G5C7E5	102	244	5.620517482517483	142
P61222	PF00005	366	489	1.2041854838709676	123	G5C7E5	367	490	1.1995887096774192	123
P61222	PF00037	48	69	3.0641818181818183	21	G5C7E5	49	70	3.203545454545455	21
P61222	PF04068	5	36	1.245625	31	G5C7E5	6	37	1.245625	31
Q5YD48	PF00076	57	121	5.9454615384615375	64	G5CAC5	58	122	5.954476923076923	64
Q5YD48	PF00076	137	198	1.6391129032258065	61	G5CAC5	138	199	1.6327903225806453	61
Q5YD48	PF00076	232	295	0.7094531249999999	63	G5CAC5	233	289	0.8176491228070176	56
Q5YD48	PF14709	446	522	0.15084415584415586	76	G5CAC5	440	516	0.1699350649350649	76
Q9QZM9	PF12937	90	132	23.078372093023265	42	G5B500	91	133	22.506348837209305	42
Q3UYV8	PF14737	74	121	22.633749999999992	47	G5BW06	1	48	14.527062500000005	47
Q3UYV8	PF14740	158	381	1.5322857142857145	223	G5BW06	65	288	3.802713004484304	223
Q61985	PF03131	594	685	0.048195652173913056	91	G5BY17	647	738	0.03945652173913043	91
Q4VA36	PF14968	6	320	0.08215238095238096	314	G5BHN0	7	321	0.08125714285714287	314
P29452	PF00619	4	88	7.219941176470589	84	G5BVT7	3	87	0.9686000000000002	84
P29452	PF00656	161	397	6.0251814345991574	236	G5BVT7	156	393	11.637525210084018	237
Q6RHR9	PF00595	466	532	5.819238805970151	66	G5B0Q3	465	531	5.740134328358211	66
Q6RHR9	PF00595	635	711	7.313766233766232	76	G5B0Q3	634	710	6.896090909090908	76
Q6RHR9	PF00595	838	912	1.6890933333333331	74	G5B0Q3	809	883	1.6604400000000001	74
Q6RHR9	PF00595	991	1069	10.379911392405058	78	G5B0Q3	957	1046	7.919966666666663	89
Q6RHR9	PF00595	1132	1207	0.008421052631578947	75	G5B0Q3	1109	1184	0.008223684210526315	75
Q6RHR9	PF00397	301	330	0.028666666666666663	29	G5B0Q3	290	319	0.028333333333333332	29
Q6RHR9	PF00397	360	389	13.289733333333333	29	G5B0Q3	350	379	13.179399999999998	29
Q6RHR9	PF00625	138	189	2.4355	51	G5B0Q3	127	178	2.389884615384615	51
Q6RHR9	PF16663	201	260	0.0	59	G5B0Q3	190	249	0.0	59
Q6RHR9	PF16666	714	797	0.0	83	G5B0Q3	713	795	0.0	82
Q8K012	PF00018	543	590	6.731354166666668	47	G5B698	533	580	6.72625	47
Q8K012	PF00611	9	86	9.407948717948717	77	G5B698	4	81	9.405076923076924	77
Q80T21	PF00090	46	70	0.0	24	G5BH41	48	71	0.0	23
Q80T21	PF05986	450	562	9.473300884955751	112	G5BH41	484	596	5.339212389380533	112
Q80T21	PF08686	994	1023	0.1738333333333334	29	G5BH41	1031	1060	0.18600000000000005	29
Q80T21	PF19030	631	682	5.896923076923077	51	G5BH41	665	715	4.486490196078432	50
Q80T21	PF19030	690	746	0.0	56	G5BH41	724	780	0.0568421052631579	56
Q80T21	PF19030	749	804	0.07308928571428573	55	G5BH41	783	838	0.08130357142857142	55
Q80T21	PF19030	808	869	0.8433225806451612	61	G5BH41	842	906	0.11169230769230767	64
Q80T21	PF19030	875	931	0.36157894736842106	56	G5BH41	912	968	1.6137543859649128	56
Q80T21	PF19030	935	986	1.8735	51	G5BH41	972	1023	0.06192307692307693	51
Q62172	PF00620	209	350	7.123971830985915	141	G5C062	210	351	7.6710211267605635	141
Q6P560	PF00096	234	256	0.05043478260869565	22	G5AXP2	178	200	0.0	22
Q6P560	PF00096	262	284	0.07847826086956522	22	G5AXP2	206	228	0.07717391304347826	22
Q6P560	PF00096	290	312	3.796652173913044	22	G5AXP2	234	256	3.744739130434782	22
Q6P560	PF00096	318	340	0.0	22	G5AXP2	262	284	0.0	22
Q6P560	PF00096	346	368	0.4328260869565216	22	G5AXP2	290	312	0.0774782608695652	22
Q6P560	PF00096	374	396	1.8873913043478263	22	G5AXP2	318	340	0.10565217391304346	22
Q6P560	PF00096	402	424	1.9086956521739131	22	G5AXP2	346	368	1.8791304347826083	22
Q6P560	PF00096	430	452	0.0	22	G5AXP2	374	396	0.0	22
Q6P560	PF00096	458	480	0.11608695652173913	22	G5AXP2	402	424	0.11413043478260868	22
Q6P560	PF00096	486	508	2.034782608695652	22	G5AXP2	430	452	2.0043478260869567	22
Q6P560	PF00096	514	536	0.0	22	G5AXP2	458	480	0.0	22
Q6P560	PF00096	542	564	4.33904347826087	22	G5AXP2	486	508	4.270913043478262	22
Q6P560	PF00096	570	592	0.24347826086956526	22	G5AXP2	514	536	0.2796521739130435	22
Q6P560	PF00096	598	620	0.0	22	G5AXP2	542	564	0.0	22
Q6P560	PF01352	36	46	0.4090909090909091	10	G5AXP2	1	11	0.1109090909090909	10
Q922H2	PF02518	237	358	4.152180327868852	121	G5AUJ0	231	352	4.146303278688523	121
Q922H2	PF10436	25	187	4.267110429447847	162	G5AUJ0	20	181	4.288666666666668	161
Q6PGC1	PF00270	579	738	8.228849999999998	159	G5C6X0	577	736	7.354943750000001	159
Q6PGC1	PF00271	850	983	11.847201492537312	133	G5C6X0	847	980	10.985649253731342	133
Q6PGC1	PF04408	1047	1130	12.715119047619051	83	G5C6X0	1044	1127	12.720869047619052	83
Q6PGC1	PF07717	1211	1297	6.820770114942527	86	G5C6X0	1211	1297	7.2809425287356335	86
Q8BMS2	PF06468	39	233	3.012835897435897	194	G5BCJ6	223	417	2.7246512820512816	194
Q8BMS2	PF19028	276	328	0.11635849056603773	52	G5BCJ6	479	531	0.05811320754716981	52
Q7TNM2	PF00643	223	262	0.064925	39	G5BDF1	218	257	0.13055	39
Q7TNM2	PF13445	32	57	0.0	25	G5BDF1	66	91	0.0	25
Q7TNM2	PF18568	372	388	0.04088235294117648	16	G5BDF1	367	382	0.043125	15
Q2TJ95	PF15913	41	141	4.9170396039603945	100	G5C4S5	171	271	4.934079207920792	100
Q3U0P1	PF16756	757	1101	9.57061739130435	344	G5BV70	837	1183	9.350204610951007	346
Q8BP74	PF08433	141	342	3.62117821782178	201	G5AKG5	141	339	4.2592864321608035	198
Q9R0Y5	PF00406	12	167	5.300480769230772	155	G5BLG1	29	184	6.045557692307693	155
O54962	PF02961	0	87	10.538727272727273	87	G5BWW3	1	88	10.538727272727273	87
Q91WS4	PF02574	23	303	2.422501779359433	280	G5ASU1	24	304	2.1137544483985744	280
Q8BQH4	PF14555	12	49	8.546868421052631	37	G5AQV3	13	50	7.968631578947371	37
P47738	PF00171	46	509	5.314913793103449	463	G5AKU7	49	512	6.6009590517241445	463
Q80TY5	PF12624	1	50	0.0	49	G5ALF4	2	50	1.9133877551020395	48
Q80VH0	PF14545	202	323	6.375991803278684	121	G5BWS5	180	301	7.321336065573772	121
Q80VH0	PF18567	28	152	11.617224000000006	124	G5BWS5	7	131	13.526024000000012	124
Q8BY02	PF01424	604	659	0.5380714285714285	55	G5BU70	605	660	0.6749107142857144	55
Q8BY02	PF01585	551	592	0.0	41	G5BU70	552	593	0.0	41
Q8R010	PF00043	246	307	10.0715	61	G5BF35	247	308	10.076080645161293	61
Q8R010	PF16780	0	43	0.0	43	G5BF35	1	44	0.0	43
Q8R010	PF18569	117	207	7.836659340659339	90	G5BF35	118	208	7.838285714285716	90
Q9CWR8	PF17980	68	122	0.31420000000000003	54	G5BG15	31	85	0.1809818181818182	54
Q9QYA2	PF01459	78	354	4.822014440433214	276	G5CBM8	49	325	4.833209386281587	276
Q32M07	PF00406	61	210	4.516119999999999	149	G5AT40	62	211	2.152613333333334	149
Q32M07	PF00406	272	447	1.1937443181818184	175	G5AT40	273	447	0.9943142857142856	174
Q8BZ03	PF00069	555	807	9.299798418972337	252	G5AUZ7	553	815	8.946034220532324	262
Q8BZ03	PF00130	138	188	6.842372549019608	50	G5AUZ7	134	184	6.841823529411764	50
Q8BZ03	PF00130	265	314	0.0	49	G5AUZ7	262	311	0.0	49
Q8K0E8	PF00147	227	475	1.254602409638554	248	G5BML3	225	473	0.908008032128514	248
Q8K0E8	PF08702	80	223	4.665291666666667	143	G5BML3	78	221	1.9014513888888893	143
Q60994	PF00386	116	241	14.684817460317463	125	G5BT83	181	306	12.074071428571427	125
Q60994	PF01391	74	106	0.0	32	G5BT83	139	170	0.087	31
O88554	PF00644	351	551	1.356452736318408	200	G5B0T6	370	570	1.6300646766169151	200
O88554	PF02877	207	337	0.6314045801526718	130	G5B0T6	226	356	1.2357175572519083	130
Q8BMK5	PF15726	0	189	0.04590526315789474	189	G5BWC1	1	194	0.09015463917525772	193
O70624	PF02191	233	485	9.960691699604748	252	G5BGT0	233	485	8.731193675889328	252
Q80VP0	PF06398	69	164	0.06342708333333334	95	G5BF26	114	209	0.4510520833333334	95
Q80VP0	PF06398	820	920	1.5000495049504956	100	G5BF26	864	964	0.246970297029703	100
Q80VP0	PF19193	205	284	7.0008250000000025	79	G5BF26	250	329	9.960837499999997	79
Q80VP0	PF19193	292	376	8.61864705882353	84	G5BF26	337	421	8.60381176470588	84
Q80VP0	PF19193	953	1096	9.90259027777778	143	G5BF26	1000	1120	15.311388429752068	120
Q8CDC0	PF00079	6	388	9.088644908616194	382	G5BH02	7	417	9.112460975609755	410
Q9D263	PF00014	40	90	8.581764705882355	50	G5B7N7	41	91	0.1748823529411765	50
Q9D5V6	PF03909	172	225	7.3413888888888925	53	G5B0F4	124	189	8.218348484848487	65
Q9ER58	PF00086	313	374	0.0	61	G5C2I5	312	373	0.0	61
Q9ER58	PF07648	134	179	0.0175	45	G5C2I5	132	177	0.017608695652173913	45
Q9ER58	PF10591	196	303	4.702907407407407	107	G5C2I5	194	302	4.857798165137615	108
Q9QXL8	PF00334	110	242	1.1470300751879694	132	G5CB50	92	224	1.3496315789473694	132
Q9QXL8	PF00334	257	387	1.1838625954198474	130	G5CB50	239	368	1.3168062015503867	129
Q9D8C3	PF02338	232	245	0.0575	13	G5B3J5	239	251	3.885	12
Q9D8C3	PF04101	4	120	6.263230769230766	116	G5B3J5	5	121	7.3751880341880325	116
Q60900	PF00076	40	110	0.968239436619718	70	G5AJS3	38	108	0.8531690140845073	70
Q60900	PF00076	126	189	0.11709374999999995	63	G5AJS3	124	187	0.10287499999999997	63
Q60900	PF00076	285	347	10.287666666666674	62	G5AJS3	283	344	8.985704918032788	61
P18293	PF00211	862	1047	6.1166182795698925	185	G5BER6	626	800	6.455428571428568	174
P18293	PF01094	236	410	6.270194285714285	174	G5BER6	1	174	3.5357011494252872	173
P18293	PF07714	555	794	3.073608333333333	239	G5BER6	319	558	1.8308791666666675	239
Q9CR42	PF00023	251	281	2.8115161290322583	30	G5B101	252	282	9.294741935483867	30
Q9CR42	PF12796	186	248	0.3394126984126984	62	G5B101	187	249	0.5432857142857145	62
Q9CR42	PF13637	125	171	0.23853191489361705	46	G5B101	126	172	1.1670212765957446	46
Q61414	PF00038	96	407	0.6489070512820515	311	G5B0M9	103	414	0.17528525641025638	311
Q8VHI4	PF15299	227	455	0.04219213973799126	228	G5C1R9	250	478	0.03402620087336245	228
Q505F5	PF03483	366	485	0.1985916666666666	119	G5CBI3	227	346	0.1607583333333334	119
Q505F5	PF13855	129	166	0.0	37	G5CBI3	62	98	0.0	36
Q505F5	PF13855	183	238	0.0	55	G5CBI3	43	98	0.0	55
Q9CXE0	PF00096	198	220	0.0	22	G5BZJ9	194	216	0.0	22
Q9CXE0	PF00096	288	310	0.0	22	G5BZJ9	194	216	0.0	22
Q9CXE0	PF00096	400	423	0.0	23	G5BZJ9	318	341	0.0	23
Q9CXE0	PF00096	429	451	0.0	22	G5BZJ9	347	369	0.0	22
Q9CXE0	PF00096	458	479	0.0	21	G5BZJ9	376	397	0.0	21
Q9CXE0	PF00096	485	507	0.0	22	G5BZJ9	403	425	0.0	22
Q9CXE0	PF00096	513	535	0.0	22	G5BZJ9	431	453	0.0	22
Q9CXE0	PF00096	541	563	0.62	22	G5BZJ9	459	481	0.6169565217391305	22
Q9CXE0	PF00096	571	593	0.0	22	G5BZJ9	489	511	0.0	22
Q9CXE0	PF12874	264	281	0.09088888888888888	17	G5BZJ9	260	277	0.06883333333333333	17
Q9CXE0	PF12874	344	364	0.0	20	G5BZJ9	347	367	0.0	20
Q9CXE0	PF13912	166	191	0.0	25	G5BZJ9	162	187	0.0	25
Q9CXE0	PF13912	316	335	0.0	19	G5BZJ9	347	366	0.0	19
Q8K296	PF01363	1112	1175	2.4444375	63	G5APV9	1119	1191	2.1464657534246583	72
Q8K296	PF06602	157	523	2.8686348773841943	366	G5APV9	158	524	2.588049046321526	366
O88561	PF00501	244	533	6.754306896551727	289	G5BER8	1	290	6.680927586206899	289
O88561	PF13193	542	618	0.8593896103896104	76	G5BER8	299	375	1.2353896103896105	76
Q8CGY6	PF11701	298	488	4.987492146596857	190	G5B753	15	205	4.893345549738219	190
Q7TMI3	PF00240	2	74	10.94045205479452	72	G5AY63	3	75	10.957972602739725	72
Q7TMI3	PF00628	347	394	0.4681666666666667	47	G5AY63	348	395	0.4644166666666667	47
Q7TMI3	PF02182	446	614	1.198059171597633	168	G5AY63	447	615	1.2480295857988162	168
Q7TMI3	PF12148	125	312	0.5620744680851065	187	G5AY63	126	313	0.5624148936170216	187
Q9JJT0	PF01137	9	181	0.856728323699422	172	G5B4Y3	10	183	0.5161321839080462	173
Q9JJT0	PF05189	182	286	0.8287047619047624	104	G5B4Y3	184	288	0.8269809523809525	104
P62717	PF01775	6	109	5.438596153846156	103	G5B4E2	7	109	5.48414563106796	102
P48318	PF00282	149	506	5.465561452513968	357	G5BLX0	368	780	4.955849878934624	412
O70306	PF00907	114	303	2.348115789473684	189	G5BDM4	115	304	2.3466105263157893	189
Q9DCG6	PF02567	8	283	4.849876811594204	275	G5B7Z4	9	284	5.985485507246375	275
P54279	PF01119	309	358	22.1415	49	G5BF34	317	366	21.88052	49
P54279	PF08676	674	818	3.840255172413794	144	G5BF34	686	830	4.507855172413794	144
P54279	PF13589	33	137	2.472076190476192	104	G5BF34	41	145	2.0040571428571425	104
Q62419	PF00018	311	355	0.44006666666666666	44	G5BZA3	467	511	0.8922	44
Q62419	PF03114	5	240	0.5783008474576269	235	G5BZA3	6	241	0.5445974576271186	235
P83093	PF07647	132	200	2.1628985507246377	68	G5CB19	55	123	2.590130434782609	68
P83093	PF16533	344	444	0.3433366336633662	100	G5CB19	267	367	0.34709900990099	100
Q9EQ28	PF09507	18	461	1.0257972972972966	443	G5AS89	19	464	1.1053977528089884	445
Q6ZPK7	PF01363	830	890	0.02114754098360656	60	G5BCH7	844	904	0.033852459016393444	60
Q9CTN4	PF00071	87	187	8.519356435643568	100	G5BU29	111	211	8.602514851485147	100
Q9CTN4	PF00651	413	516	10.104615384615387	103	G5BU29	438	541	10.306711538461538	103
Q9ESJ7	PF04402	51	213	2.6112269938650297	162	G5BC12	53	214	2.0632901234567904	161
Q9D9Q6	PF00262	22	246	6.537262222222222	224	G5C2V8	23	247	4.1178444444444455	224
O54918	PF06773	3	39	0.0	36	G5BQZ0	4	40	0.0	36
O54918	PF08945	127	163	0.0035945945945945953	36	G5BQZ0	132	168	0.03162162162162162	36
Q6ZQ38	PF08623	1039	1201	5.186883435582823	162	G5BGB3	1040	1202	5.186883435582823	162
Q9DBK0	PF01852	352	512	10.428645962732924	160	G5BK70	309	469	10.240062111801242	160
Q9DBK0	PF03061	43	94	1.3941730769230771	51	G5BK70	1	52	0.2859807692307693	51
Q9DBK0	PF03061	197	270	9.429297297297301	73	G5BK70	154	227	9.193540540540543	73
Q8R2Q6	PF07773	77	378	1.1842516556291391	301	G5C150	91	391	2.0112757475083067	300
Q9Z2U0	PF00227	25	210	10.754225806451617	185	G5BDX2	26	211	10.754188172043015	185
Q9Z2U0	PF10584	2	24	11.92495652173913	22	G5BDX2	3	25	11.92495652173913	22
Q80U40	PF07653	903	932	0.0	29	G5AWP5	857	886	0.0	29
Q80U40	PF14604	202	242	10.609975609756098	40	G5AWP5	179	219	10.622268292682929	40
Q80U40	PF14604	978	1034	6.318280701754387	56	G5AWP5	932	988	7.730438596491228	56
Q06194	PF00754	2030	2112	16.226325301204813	82	G5B9E2	2041	2122	11.803756097560973	81
Q06194	PF00754	2189	2265	8.512610389610389	76	G5B9E2	2043	2114	12.853180555555555	71
Q06194	PF07731	1884	1968	0.6253294117647056	84	G5B9E2	1958	2041	0.6969047619047617	83
Q06194	PF07732	90	199	13.6344	109	G5B9E2	132	241	10.830654545454543	109
Q06194	PF07732	454	538	7.077823529411766	84	G5B9E2	498	582	7.047329411764704	84
Q9D600	PF05916	65	152	0.1046363636363636	87	G5BJF8	1	88	0.059375	87
Q6PD03	PF01603	60	442	8.723242819843348	382	G5B604	1	383	6.2561984334203675	382
P56959	PF00076	279	352	0.5885270270270272	73	G5BYC2	273	345	0.5272191780821918	72
Q6ZQ82	PF00169	267	363	0.2807835051546392	96	G5AQS1	231	327	0.3586185567010309	96
Q6ZQ82	PF00620	391	541	6.403701986754968	150	G5AQS1	355	505	6.232953642384106	150
Q6ZQ82	PF14604	762	811	0.37894	49	G5AQS1	779	828	0.36158	49
Q6ZQ82	PF16746	48	248	6.0982736318407955	200	G5AQS1	12	212	5.972517412935322	200
O35127	PF14974	10	112	1.8135631067961169	102	G5CAS0	11	113	1.8143203883495145	102
Q9DBA9	PF03909	179	232	0.057814814814814826	53	G5AKA4	181	234	0.057814814814814826	53
Q9DBA9	PF08567	16	96	2.0285555555555557	80	G5AKA4	17	97	2.0307901234567907	80
Q1H9T6	PF00651	15	115	3.8755742574257424	100	G5C559	16	115	4.062380000000002	99
Q1H9T6	PF00096	311	330	0.0	19	G5C559	320	339	0.0	19
Q1H9T6	PF00096	342	364	0.3694347826086957	22	G5C559	351	373	0.3071304347826087	22
Q1H9T6	PF00096	457	479	0.0	22	G5C559	466	488	0.0	22
Q1H9T6	PF00096	485	507	0.0	22	G5C559	494	516	0.0	22
Q1H9T6	PF00096	543	564	0.0	21	G5C559	552	573	0.0	21
Q1H9T6	PF00096	570	592	0.0	22	G5C559	579	601	0.0	22
O08740	PF13656	30	102	1.862082191780822	72	G5AXA4	31	103	1.7197945205479452	72
Q8CJ96	PF00788	2	79	10.435769230769226	77	G5BQA3	3	80	10.40151282051282	77
Q91YD6	PF00626	27	106	3.798125	79	G5ATL4	28	86	7.7442711864406775	58
Q91YD6	PF00626	148	218	3.6960704225352106	70	G5ATL4	128	200	2.564671232876711	72
Q91YD6	PF00626	272	340	0.3038840579710145	68	G5ATL4	254	321	0.3841176470588236	67
Q91YD6	PF00626	402	481	17.8260625	79	G5ATL4	383	452	12.265128571428571	69
Q91YD6	PF00626	640	698	8.327186440677963	58	G5ATL4	507	571	15.590599999999995	64
Q91YD6	PF02209	823	851	0.06931034482758623	28	G5ATL4	667	694	0.07629629629629629	27
Q60932	PF01459	16	288	0.9525201465201464	272	G5BN09	4	276	0.9563772893772892	272
Q6P5G0	PF00069	21	311	3.4369037800687283	290	G5BVS8	22	312	3.475793814432987	290
P06684	PF01821	701	735	0.0	34	G5AXS5	698	732	0.117	34
P06684	PF00207	775	862	2.3779772727272728	87	G5AXS5	772	859	1.6092272727272736	87
P06684	PF01759	1553	1659	4.549560747663552	106	G5AXS5	1528	1635	7.781981481481483	107
P06684	PF01835	125	217	6.438118279569899	92	G5AXS5	126	218	5.8134301075268855	92
P06684	PF07677	1424	1512	3.4784382022471916	88	G5AXS5	1397	1487	3.4843186813186824	90
P06684	PF07678	981	1303	12.78083281733746	322	G5AXS5	978	1276	10.75529431438127	298
P06684	PF07703	475	610	7.99966911764706	135	G5AXS5	476	610	7.725503703703703	134
P06684	PF17789	353	456	6.303740384615384	103	G5AXS5	354	457	3.1629230769230765	103
P06684	PF17790	19	119	1.7363465346534648	100	G5AXS5	20	120	5.174069306930692	100
P06684	PF17791	220	302	6.516542168674699	82	G5AXS5	221	303	8.056722891566261	82
Q6NZL8	PF00431	827	936	2.425227272727272	109	G5BM84	885	996	2.381312499999999	111
Q6NZL8	PF07645	352	386	0.018000000000000002	34	G5BM84	408	442	0.018000000000000002	34
Q6NZL8	PF07645	391	427	0.0	36	G5BM84	447	483	0.0	36
Q6NZL8	PF07699	665	712	0.0	47	G5BM84	721	768	0.0	47
Q6NZL8	PF07699	719	766	0.0	47	G5BM84	777	824	0.0	47
Q6NZL8	PF07699	775	822	0.0	47	G5BM84	833	880	0.0	47
Q6NZL8	PF12662	97	119	0.0	22	G5BM84	110	132	0.0	22
Q6NZL8	PF12947	36	71	0.0	35	G5BM84	49	84	0.0	35
Q6NZL8	PF14670	120	155	0.14519444444444446	35	G5BM84	133	168	0.14505555555555555	35
Q6NZL8	PF14670	274	309	0.41791666666666666	35	G5BM84	330	365	0.41777777777777775	35
Q6NZL8	PF14670	315	350	0.022361111111111116	35	G5BM84	371	406	0.022222222222222227	35
P56380	PF00293	20	128	5.57705504587156	108	G5B054	21	129	8.99959633027523	108
Q569E7	PF00096	279	301	0.0	22	G5BDM7	263	285	0.0	22
Q569E7	PF00096	309	329	0.0	20	G5BDM7	293	313	0.0	20
Q569E7	PF00096	335	357	0.0	22	G5BDM7	319	341	0.0	22
Q569E7	PF00096	376	398	0.0	22	G5BDM7	355	377	0.0	22
Q569E7	PF00096	406	426	0.0	20	G5BDM7	385	405	0.0	20
Q569E7	PF00096	432	454	0.0	22	G5BDM7	411	433	0.0	22
Q569E7	PF00096	460	482	0.0	22	G5BDM7	439	461	0.0	22
Q569E7	PF00096	490	510	0.0	20	G5BDM7	469	489	0.0	20
Q569E7	PF00096	516	538	0.0	22	G5BDM7	495	517	0.0	22
Q569E7	PF00096	544	566	0.0	22	G5BDM7	523	545	0.0	22
P97366	PF00566	166	367	12.794905940594056	201	G5AZW7	167	368	16.63565346534653	201
Q3UMB9	PF14744	604	947	6.277363372093028	343	G5C464	585	928	6.071316860465121	343
Q3UMB9	PF14745	31	602	12.392239510489507	571	G5C464	12	583	12.01735664335664	571
Q3UMB9	PF14746	965	1134	5.940770588235292	169	G5C464	946	1115	8.897388235294116	169
Q9CPT5	PF09420	13	78	0.0	65	G5BPY7	14	79	0.0	65
Q9CPT5	PF09420	77	154	0.4436410256410257	77	G5BPY7	78	155	0.07456410256410258	77
Q9DA69	PF15305	96	189	0.6172340425531916	93	G5B690	59	152	0.6020425531914892	93
Q6PAL0	PF10523	261	331	0.17905633802816906	70	G5BMP1	198	267	0.0	69
Q6PAL0	PF10523	406	475	8.3501	69	G5BMP1	199	267	0.0	68
Q6PAL0	PF10523	568	642	0.4794133333333335	74	G5BMP1	198	271	0.0	73
Q6PAL0	PF10523	734	808	0.0	74	G5BMP1	198	272	0.0	74
Q8C5T8	PF13870	180	352	1.9529306358381504	172	G5AUG5	181	353	1.738578034682081	172
Q9D1C1	PF00179	33	167	2.9394666666666667	134	G5B7N9	36	170	2.155318518518519	134
Q9QYB5	PF00596	139	297	1.0222641509433965	158	G5BKB7	140	270	1.138526717557252	130
Q99NF1	PF03055	18	530	3.4270350877192968	512	G5CAZ1	35	615	4.705752151462998	580
Q80V70	PF00053	569	614	0.0	45	G5CBI8	655	700	0.0	45
Q80V70	PF00053	831	867	0.0	36	G5CBI8	938	974	0.0	36
Q80V70	PF00053	874	918	0.0	44	G5CBI8	981	1025	0.0	44
Q80V70	PF00053	1176	1221	0.0	45	G5CBI8	1194	1239	0.0	45
Q80V70	PF00053	1392	1431	0.0	39	G5CBI8	655	694	0.0	39
Q80V70	PF00053	1435	1478	0.0	43	G5CBI8	1317	1360	0.0	43
Q80V70	PF07645	286	325	0.0	39	G5CBI8	374	413	0.0	39
Q80V70	PF07645	413	452	0.0	39	G5CBI8	501	540	0.0	39
Q80V70	PF07974	1086	1116	0.0	30	G5CBI8	1147	1177	0.0	30
Q80V70	PF12661	528	547	0.066	19	G5CBI8	614	633	0.0709	19
Q80V70	PF12661	790	809	0.0	19	G5CBI8	897	916	0.0	19
Q80V70	PF12661	920	939	0.0	19	G5CBI8	1027	1046	0.0	19
Q80V70	PF12661	1006	1025	0.0608	19	G5CBI8	1070	1089	0.0	19
Q80V70	PF12661	1135	1154	0.0	19	G5CBI8	1196	1215	0.0	19
Q80V70	PF12662	142	165	0.017375	23	G5CBI8	441	464	0.0	23
Q80V70	PF12662	356	375	0.0	19	G5CBI8	444	463	0.0	19
Q80V70	PF14670	167	201	0.017085714285714284	34	G5CBI8	255	289	0.04402857142857143	34
Q80V70	PF14670	249	284	0.0	35	G5CBI8	337	372	0.0	35
Q99KN2	PF00400	11	42	12.59028125	31	G5BMW0	12	43	13.04884375	31
Q99KN2	PF00400	52	88	0.4912702702702703	36	G5BMW0	53	89	0.4935675675675676	36
Q99KN2	PF00400	95	131	2.4559729729729733	36	G5BMW0	96	132	2.4691081081081085	36
Q99KN2	PF00400	140	176	0.19443243243243247	36	G5BMW0	141	177	0.12905405405405404	36
Q99KN2	PF00400	184	220	3.8441081081081068	36	G5BMW0	185	221	4.643135135135135	36
Q99KN2	PF00400	295	330	0.15838888888888888	35	G5BMW0	296	331	0.3291666666666667	35
Q69ZQ2	PF06246	1	265	0.11525283018867925	264	G5AMJ2	2	265	0.11494318181818185	263
P35242	PF00059	144	247	0.4736153846153846	103	G5C4H8	145	248	1.1549029126213592	103
Q8C160	PF06060	56	583	7.368119318181818	527	G5BXU9	50	576	6.9953149905123375	526
Q91WK2	PF01398	33	144	8.8055625	111	G5AT83	34	145	8.8055625	111
Q8BM47	PF00169	362	453	5.152130434782606	91	G5C177	362	453	5.936141304347829	91
Q8BM47	PF13901	528	727	1.12418	199	G5C177	528	727	1.1275650000000002	199
O35654	PF04042	195	410	2.47088425925926	215	G5BIK2	196	411	1.9985555555555548	215
O35654	PF18018	48	174	6.806724409448821	126	G5BIK2	49	175	7.212937007874014	126
Q61553	PF06268	20	133	4.15507894736842	113	G5BI79	21	134	4.15307894736842	113
Q61553	PF06268	142	255	1.8537894736842104	113	G5BI79	143	256	1.7850438596491225	113
Q61553	PF06268	277	377	0.7423762376237624	100	G5BI79	338	438	1.148762376237624	100
Q61553	PF06268	391	492	0.20107843137254908	101	G5BI79	452	600	0.2399864864864865	148
Q99LX0	PF01965	3	169	4.259874251497006	166	G5C551	4	170	4.111347305389221	166
Q5KU39	PF00637	571	708	4.164949275362318	137	G5B6U0	602	739	4.305463768115943	137
Q3UMM4	PF00069	43	322	8.046435714285716	279	G5APH9	40	319	8.646457142857145	279
Q61733	PF15433	84	377	0.31654421768707497	293	G5B958	86	379	1.3073095238095238	293
Q61817	PF00170	183	244	6.9418870967741935	61	G5BKZ7	149	210	0.09643548387096773	61
Q91X43	PF00018	499	544	10.040500000000002	45	G5C1K4	499	544	10.051608695652174	45
Q91X43	PF00018	575	619	4.503288888888889	44	G5C1K4	576	620	0.7909999999999999	44
Q91X43	PF00018	665	710	0.26656521739130434	45	G5C1K4	666	711	0.1167391304347826	45
Q91X43	PF07653	417	469	9.325641509433963	52	G5C1K4	417	469	8.502433962264153	52
Q91X43	PF14604	735	783	1.7950000000000002	48	G5C1K4	736	784	2.0946938775510207	48
Q80V42	PF00246	27	301	2.674516363636364	274	G5BBG6	28	302	2.553396363636361	274
Q80V42	PF13620	314	378	5.749338461538462	64	G5BBG6	315	379	3.5524153846153843	64
Q8BZ94	PF12171	145	169	7.0516799999999975	24	G5APL2	121	145	6.862760000000001	24
Q8BZ94	PF12874	14	37	0.05045833333333333	23	G5APL2	121	144	7.1487083333333326	23
Q8BZ94	PF12874	75	98	2.3350833333333334	23	G5APL2	51	74	2.3351666666666664	23
Q8BZ94	PF12874	199	221	0.0	22	G5APL2	52	74	2.436695652173913	22
Q3LAC4	PF00169	238	348	6.805378378378384	110	G5BGQ6	195	305	7.5906666666666665	110
Q3LAC4	PF00610	387	453	2.597	66	G5BGQ6	344	410	2.59310447761194	66
Q3LAC4	PF00610	488	554	6.8081044776119395	66	G5BGQ6	445	511	2.091283582089552	66
Q3LAC4	PF00621	44	203	0.9965625000000008	159	G5BGQ6	1	160	0.9241375000000002	159
P43352	PF04098	36	178	4.946811188811188	142	G5BWP4	37	179	4.937041958041957	142
Q8C166	PF00168	11	108	0.6079387755102045	97	G5B847	13	111	0.5058686868686866	98
Q8C166	PF00168	178	232	0.18609090909090908	54	G5B847	130	184	2.9886727272727267	54
Q8C166	PF07002	302	516	7.938102325581398	214	G5B847	254	472	8.500086757990863	218
Q8BR21	PF15173	40	162	6.959170731707318	122	G5BS09	1	123	10.029390243902439	122
Q8BGU5	PF00134	158	264	13.277336448598135	106	G5BTY5	114	220	13.266514018691584	106
Q9Z0G2	PF00069	77	219	6.250202797202793	142	G5BQT8	80	222	6.35944755244755	142
Q9Z0G2	PF00069	385	562	0.35514044943820217	177	G5BQT8	387	564	0.35103932584269665	177
Q6URW6	PF00063	103	492	5.1302589743589735	389	G5B8S2	127	507	5.4044645669291365	380
Q6URW6	PF01576	1458	1898	0.8792222222222223	440	G5B8S2	1293	1730	0.3965776255707763	437
Q8C1R3	PF15470	6	162	0.4441974522292993	156	G5B747	19	169	1.7342317880794702	150
Q02053	PF00899	54	225	4.771703488372094	171	G5AZF9	55	226	4.608023255813952	171
Q02053	PF00899	450	636	1.2535508021390376	186	G5AZF9	451	641	2.444235602094241	190
Q02053	PF10585	637	883	1.348356275303643	246	G5AZF9	642	891	1.9423840000000008	249
Q02053	PF16190	226	295	0.30734285714285725	69	G5AZF9	227	296	0.4019571428571428	69
Q02053	PF16191	298	365	0.22604411764705884	67	G5AZF9	299	366	1.0714852941176471	67
Q02053	PF09358	954	1052	4.145999999999998	98	G5AZF9	962	1060	4.150363636363635	98
O35551	PF03528	11	494	1.1468057851239668	483	G5BW83	35	518	1.2397107438016532	483
O35551	PF09311	532	838	0.6816775244299674	306	G5BW83	556	829	0.4262554744525547	273
Q5F259	PF11904	162	489	0.9369329268292684	327	G5BVP3	141	500	0.8197555555555559	359
Q5F259	PF12796	38	102	5.528199999999999	64	G5BVP3	20	84	5.524138461538461	64
Q8VCE6	PF06941	33	216	0.5565978260869567	183	G5C329	1	197	0.5288071065989844	196
A6H6Q4	PF15041	22	197	0.8025909090909091	175	G5AKQ4	23	185	0.2708957055214724	162
Q3UMU9	PF00855	4	85	4.359170731707317	81	G5BZA0	5	86	4.372365853658536	81
Q3UMU9	PF11467	467	558	1.2653804347826083	91	G5BZA0	472	563	1.256413043478261	91
Q69ZP3	PF00753	155	290	7.579875	135	G5AZJ2	156	291	8.800750000000003	135
Q69ZP3	PF16123	291	379	0.2986067415730337	88	G5AZJ2	292	380	4.809494382022471	88
Q61151	PF01603	47	451	8.75252345679013	404	G5BCZ1	52	456	8.178108641975307	404
Q9EPR2	PF06951	72	191	0.017366666666666662	119	G5AQM0	1	119	0.13142372881355935	118
P43021	PF00019	253	352	3.2322299999999995	99	G5B198	208	307	3.24956	99
Q8K0V2	PF03556	166	194	1.4362068965517245	28	G5BV97	167	194	1.5995925925925922	27
Q9JII1	PF03372	307	586	10.717742857142856	279	G5B6B1	311	590	10.370528571428574	279
Q9D256	PF00050	31	86	0.00225	55	G5BQ84	4	58	0.0	54
Q9CY58	PF04774	188	311	0.0	123	G5BSQ3	189	315	0.07188976377952755	126
Q9CY58	PF16174	4	151	0.3076891891891892	147	G5BSQ3	5	152	0.30727027027027026	147
Q9CWJ9	PF01808	134	460	3.4450581039755352	326	G5BHR5	135	461	3.2762813455657493	326
Q9CWJ9	PF02142	15	129	1.3997043478260869	114	G5BHR5	16	130	0.4449739130434782	114
Q99M71	PF00811	88	209	7.322311475409834	121	G5B3V4	88	209	9.179245901639343	121
Q9EPW2	PF00096	319	343	0.0	24	G5B0V2	319	343	0.0	24
Q9EPW2	PF00096	349	373	0.0	24	G5B0V2	349	373	0.0	24
Q9EPW2	PF00096	379	401	0.0	22	G5B0V2	379	401	0.0	22
Q08274	PF00400	283	307	0.0584	24	G5AUY0	197	217	0.038571428571428576	20
Q08274	PF00400	325	350	19.227884615384614	25	G5AUY0	250	275	18.783961538461547	25
Q8BGT7	PF06003	65	161	6.86638144329897	96	G5BKB9	66	162	1.5099278350515457	96
Q4ACU6	PF17820	609	659	1.597137254901961	50	G5B2F6	496	546	5.638039215686276	50
Q4ACU6	PF12796	253	334	7.487146341463418	81	G5B2F6	187	268	7.502073170731706	81
Q4ACU6	PF00536	1666	1726	0.0	60	G5B2F6	1410	1470	0.0	60
Q4ACU6	PF07653	498	526	0.2747241379310345	28	G5B2F6	385	413	0.0	28
Q91X91	PF01729	113	283	0.29823976608187136	170	G5BYM3	209	379	1.4519356725146206	170
Q91X91	PF02749	33	111	1.1839113924050633	78	G5BYM3	129	207	2.049746835443038	78
Q14BI7	PF00270	138	295	11.338797468354429	157	G5AWI0	138	295	11.735759493670885	157
Q14BI7	PF00271	383	500	6.587567796610173	117	G5AWI0	383	500	6.504957627118646	117
Q14BI7	PF00567	904	1013	1.1841363636363635	109	G5AWI0	871	979	0.045862385321100915	108
Q14BI7	PF04408	568	650	15.576614457831328	82	G5AWI0	568	650	10.084927710843374	82
Q8VBW6	PF00899	12	517	6.314618577075096	505	G5BDH2	13	477	4.97761935483871	464
Q8K4K2	PF00069	112	314	13.207128078817735	202	G5C6M1	130	332	9.186852216748768	202
Q8C080	PF00787	132	210	5.496227848101264	78	G5BAK0	133	211	5.491658227848098	78
O08756	PF00106	11	210	7.749210000000006	199	G5BAY5	12	211	6.691024999999999	199
Q8CIF4	PF00795	64	244	8.160220994475141	180	G5BMH3	75	255	7.748121546961326	180
Q8CIF4	PF19018	370	518	5.0406510067114105	148	G5BMH3	381	529	6.877785234899327	148
Q9JHW2	PF00795	4	255	1.624753968253968	251	G5BUU4	5	256	1.8620039682539693	251
P70270	PF00176	175	461	5.318526132404179	286	G5AX53	240	526	6.159801393728223	286
P70270	PF00271	499	609	12.470189189189188	110	G5AX53	564	674	12.415639639639645	110
Q8R238	PF00291	13	309	6.502905723905728	296	G5AKX1	9	305	5.704323232323231	296
Q8K4Z3	PF03853	74	239	6.62042771084337	165	G5AR86	30	195	8.754867469879517	165
Q9QYM8	PF05837	121	232	1.1486696428571432	111	G5BKN6	89	200	3.6487142857142847	111
Q9CR40	PF00651	24	130	3.765682242990657	106	G5BUQ4	25	131	3.8750654205607455	106
Q9CR40	PF01344	319	372	10.968222222222225	53	G5BUQ4	320	373	7.804666666666668	53
Q9CR40	PF01344	375	418	7.974727272727272	43	G5BUQ4	376	419	14.248840909090914	43
Q9CR40	PF01344	422	464	6.523558139534883	42	G5BUQ4	423	465	7.453116279069768	42
Q9CR40	PF01344	468	511	24.252886363636364	43	G5BUQ4	469	512	24.252886363636364	43
Q9CR40	PF01344	514	552	11.383717948717944	38	G5BUQ4	515	553	5.481717948717949	38
Q9CR40	PF07707	136	235	3.1365700000000016	99	G5BUQ4	137	236	3.088359999999999	99
Q3UJK4	PF00009	173	392	7.7716772727272705	219	G5BNN1	126	345	7.840600000000002	219
Q9Z0Y1	PF07426	6	169	2.217060975609756	163	G5B061	7	170	2.1924024390243906	163
Q8K009	PF00171	450	918	1.7292643923240958	468	G5C465	542	1010	2.2082132196162063	468
Q8K009	PF00550	346	406	0.3986557377049179	60	G5C465	438	498	11.038852459016391	60
Q8K009	PF00551	23	201	4.248206703910616	178	G5C465	72	293	11.226576576576582	221
Q8K009	PF02911	226	326	2.7858910891089104	100	G5C465	318	418	2.2241188118811888	100
Q9D8Y7	PF05527	3	181	2.8135642458100563	178	G5AJZ2	4	182	1.6723966480446932	178
Q8K1L2	PF02513	40	89	1.8182200000000002	49	G5BJ25	41	90	1.81832	49
Q8K1L2	PF02513	118	167	22.66498	49	G5BJ25	119	168	22.665259999999996	49
Q8K1L2	PF02513	200	245	15.478456521739133	45	G5BJ25	201	246	15.47884782608696	45
Q4LDD4	PF00169	329	419	0.02	90	G5AS67	335	425	0.5858571428571429	90
Q4LDD4	PF00169	746	849	5.294490384615385	103	G5AS67	752	855	2.894990384615385	103
Q4LDD4	PF00169	1292	1395	9.579836538461539	103	G5AS67	1272	1364	12.285419354838705	92
Q4LDD4	PF00620	972	1116	5.597400000000002	144	G5AS67	978	1121	5.587472222222223	143
Q4LDD4	PF00788	1174	1260	3.6738160919540217	86	G5AS67	1154	1240	3.6714597701149416	86
Q4LDD4	PF01412	538	652	9.679721739130434	114	G5AS67	544	658	7.042443478260875	114
Q4LDD4	PF07647	9	62	0.847925925925926	53	G5AS67	10	63	0.5243703703703704	53
Q8BYL4	PF00579	67	368	7.396013245033113	301	G5BSI0	74	375	5.8586589403973495	301
Q8BX02	PF12075	30	68	0.0	38	G5BUI7	31	69	0.0	38
Q8BX02	PF12796	734	818	7.2383411764705885	84	G5BUI7	695	779	7.921729411764707	84
Q9CWH1	PF00651	13	120	5.125435185185184	107	G5B5J4	14	121	4.974787037037034	107
Q62073	PF07714	36	282	5.386259109311738	246	G5AL97	37	283	5.389931174089066	246
Q8VCS0	PF01510	385	511	5.8281417322834645	126	G5BYP3	374	500	5.4807401574803185	126
P08551	PF00038	88	399	1.2464775641025645	311	G5BYB0	89	400	1.2471346153846157	311
P08551	PF04732	9	87	0.04683544303797468	78	G5BYB0	10	88	0.03930379746835443	78
Q5DTY9	PF02214	61	117	12.025456140350876	56	G5APR8	2	58	12.052912280701756	56
Q32MG2	PF14645	80	196	2.2993504273504275	116	G5C904	81	197	2.8500085470085468	116
Q8BQY8	PF04005	0	278	0.9154982078853044	278	G5B3U7	1	279	0.9134050179211473	278
Q9R1Z8	PF00018	523	570	0.4503958333333333	47	G5B9Q7	460	507	0.39025	47
Q9R1Z8	PF02208	168	205	0.0	37	G5B9Q7	120	157	0.0	37
Q9R1Z8	PF14604	451	498	0.27729166666666666	47	G5B9Q7	388	435	0.2753125	47
Q9R1Z8	PF14604	680	730	5.632352941176472	50	G5B9Q7	617	667	5.614941176470588	50
P81183	PF00096	139	161	0.0	22	G5C866	146	168	0.0	22
P81183	PF00096	167	189	0.0	22	G5C866	174	196	0.0	22
P81183	PF00096	195	218	0.0	23	G5C866	202	225	0.0	23
Q9R257	PF04832	12	186	0.5342285714285715	174	G5BYF2	13	186	0.7928045977011496	173
Q8JZS6	PF13671	395	527	1.4911879699248118	132	G5B7X9	379	511	1.1414511278195492	132
P31240	PF00341	96	179	0.6538452380952379	83	G5AYU7	97	180	0.6442857142857141	83
P31240	PF04692	20	92	0.0	72	G5AYU7	21	93	0.0011780821917808221	72
Q3UDP0	PF00400	74	115	5.305833333333334	41	G5ATJ9	75	115	8.84329268292683	40
Q3UDP0	PF00400	316	348	0.0	32	G5ATJ9	314	346	0.037727272727272734	32
Q9DAT2	PF07904	56	94	0.1635897435897436	38	G5C8E5	1	39	0.0	38
Q99KN9	PF01417	28	152	6.293256000000002	124	G5BKW5	8	132	6.288791999999997	124
Q8BIL2	PF13837	43	129	6.692908045977013	86	G5BZF3	199	285	6.62019540229885	86
Q8R003	PF14608	19	39	0.04576190476190476	20	G5AJW5	20	40	0.005952380952380952	20
Q8R003	PF14608	53	71	4.530736842105263	18	G5AJW5	54	72	2.2635789473684214	18
Q8R003	PF14608	214	233	0.1341	19	G5AJW5	214	233	0.1599	19
Q8R003	PF18044	178	199	0.0	21	G5AJW5	178	199	0.0	21
Q8BX05	PF00370	25	286	6.786557251908401	261	G5AZ57	2	263	7.893255725190841	261
Q8BX05	PF02782	296	483	1.0993670212765956	187	G5AZ57	273	460	1.241063829787234	187
P51174	PF00441	277	425	2.4653557046979837	148	G5AY17	253	401	2.4656174496644305	148
P51174	PF02770	168	265	12.8550306122449	97	G5AY17	144	241	12.855806122448977	97
P51174	PF02771	54	163	0.28979090909090904	109	G5AY17	30	139	1.5640636363636369	109
Q6PD24	PF11904	154	468	0.3927206349206349	314	G5BSB4	138	457	0.5098406250000002	319
Q6PD24	PF12796	21	94	2.234405405405405	73	G5BSB4	5	78	2.085554054054054	73
P53347	PF01291	33	193	3.0791242236024847	160	G5APV5	39	199	0.1245714285714286	160
Q5XPI3	PF00622	133	250	2.1231779661016934	117	G5BZX0	134	251	1.520516949152542	117
Q5XPI3	PF13920	1250	1294	1.901222222222222	44	G5BZX0	1246	1289	1.1137906976744183	43
Q921J2	PF00071	16	166	5.881152317880794	150	G5AMU4	1	151	5.813841059602648	150
Q8BLU2	PF10294	61	222	10.08824074074074	161	G5B9M7	78	239	12.390259259259254	161
Q9DCT8	PF00412	4	59	5.313285714285715	55	G5AWK1	130	184	1.0340363636363636	54
Q9DCT8	PF00412	125	178	0.4030370370370371	53	G5AWK1	130	183	0.7270555555555555	53
Q8BVA5	PF10230	43	303	5.6934252873563205	260	G5AZB9	44	303	15.040673076923087	259
O35678	PF12146	40	273	7.90114102564103	233	G5C7W6	71	347	7.006162454873644	276
Q8JZK9	PF01154	12	185	9.796793103448278	173	G5BCR6	13	186	9.815954022988501	173
Q8JZK9	PF08540	186	468	2.8001095406360417	282	G5BCR6	187	469	2.7983321554770324	282
Q6NTA4	PF04670	41	295	8.991600000000004	254	G5C3P3	42	296	8.823090196078432	254
Q9ESK9	PF10377	1496	1581	14.647127906976745	85	G5BKS5	544	629	14.654267441860465	85
Q8K1K9	PF00096	250	273	0.0	23	G5BHN8	393	416	0.0	23
Q8K1K9	PF00096	340	363	0.0	23	G5BHN8	483	506	0.0	23
Q8K1K9	PF13894	224	246	0.0	22	G5BHN8	367	389	0.0	22
Q61164	PF00096	265	287	0.0	22	G5C665	266	288	0.0	22
Q61164	PF00096	293	315	0.3830434782608695	22	G5C665	294	316	0.3834782608695652	22
Q61164	PF00096	321	344	0.5855833333333332	23	G5C665	322	345	0.5864166666666667	23
Q61164	PF00096	378	400	0.0	22	G5C665	379	401	0.0	22
Q61164	PF00096	436	459	0.0	23	G5C665	437	460	0.0	23
Q61164	PF00096	554	572	0.2341052631578947	18	G5C665	555	573	0.16168421052631576	18
Q61164	PF13909	350	374	0.0	24	G5C665	351	375	0.0	24
Q8R3J4	PF02536	147	392	5.48394715447154	245	G5B8X3	153	398	7.328414634146341	245
Q8R1G6	PF00412	282	324	0.0	42	G5B9Q8	289	330	0.0	41
Q8R1G6	PF00595	8	78	5.762211267605635	70	G5B9Q8	9	79	5.746563380281692	70
Q8R1G6	PF15936	208	250	0.0	42	G5B9Q8	215	257	0.0	42
Q8VCQ3	PF08961	89	282	2.4674587628865985	193	G5C606	90	284	1.7669846153846158	194
Q8VCQ3	PF17169	3	85	1.0522530120481928	82	G5C606	4	86	1.1383614457831324	82
Q8C115	PF00169	703	794	0.6347500000000003	91	G5AL88	704	795	0.5783260869565219	91
Q8C115	PF00373	1233	1352	2.5163750000000005	119	G5AL88	1222	1341	2.4346083333333333	119
Q8C115	PF00784	999	1106	12.988842592592588	107	G5AL88	1000	1095	12.854187500000002	95
Q9CPY0	PF01728	51	235	6.805475675675675	184	G5BI85	49	233	4.085864864864863	184
Q80U62	PF02759	56	176	0.9885123966942148	120	G5ALA9	56	176	0.8403223140495865	120
Q80U62	PF13901	720	919	0.053405	199	G5ALA9	731	930	0.05344	199
Q8CGC7	PF00043	96	150	9.974363636363636	54	G5AQT1	97	151	12.881472727272728	54
Q8CGC7	PF00458	752	803	0.0739230769230769	51	G5AQT1	753	804	1.8735769230769233	51
Q8CGC7	PF00458	825	876	0.1196153846153846	51	G5AQT1	826	876	0.12196078431372548	50
Q8CGC7	PF00458	903	954	0.015980769230769232	51	G5AQT1	903	954	2.8720384615384615	51
Q8CGC7	PF00587	1113	1283	2.0179649122807017	170	G5AQT1	1113	1283	2.4510643274853803	170
Q8CGC7	PF00749	196	500	2.570672131147542	304	G5AQT1	197	501	2.551813114754101	304
Q8CGC7	PF03129	1302	1402	2.395346534653465	100	G5AQT1	1302	1401	1.88515	99
Q8CGC7	PF03950	503	680	2.165438202247192	177	G5AQT1	504	681	1.9003314606741573	177
Q8CGC7	PF09180	1430	1511	1.399939024390244	81	G5AQT1	1430	1511	1.4160246913580248	81
Q8CBB9	PF04055	79	237	0.3257295597484276	158	G5C0Y9	76	234	0.3529622641509431	158
Q8CBB9	PF13353	77	179	0.2797184466019418	102	G5C0Y9	74	176	0.5448640776699025	102
Q8R023	PF13923	46	84	6.159974358974358	38	G5AXF0	47	85	5.466692307692307	38
Q8R023	PF16207	189	252	1.4951718750000005	63	G5AXF0	190	253	1.6157187500000003	63
Q9Z2X2	PF12796	30	101	0.7147777777777776	71	G5ALZ6	31	102	0.25262499999999993	71
Q9Z2X2	PF13637	108	158	11.09456862745098	50	G5ALZ6	109	159	11.161098039215686	50
Q9Z2X2	PF13857	162	211	3.65856	49	G5ALZ6	163	212	0.24364	49
P12960	PF00041	611	694	0.3702500000000001	83	G5BGJ6	691	774	0.3572619047619047	83
P12960	PF00041	711	797	7.103609195402299	86	G5BGJ6	791	877	8.105264367816092	86
P12960	PF00041	812	894	0.19773493975903614	82	G5BGJ6	892	974	0.3452891566265058	82
P12960	PF00047	510	596	8.815609195402304	86	G5BGJ6	592	676	8.985929411764708	84
P12960	PF07679	243	324	2.963731707317073	81	G5BGJ6	231	312	4.386341463414634	81
P12960	PF07679	421	499	1.326253164556962	78	G5BGJ6	503	581	0.9678354430379748	78
P12960	PF13927	51	117	3.2257313432835817	66	G5BGJ6	39	105	3.1244477611940296	66
P12960	PF13927	333	394	0.0	61	G5BGJ6	415	476	0.005967741935483871	61
Q60855	PF00531	570	651	0.04951219512195123	81	G5BKE8	579	659	2.354950617283951	80
Q60855	PF07714	21	284	9.526662878787876	263	G5BKE8	18	280	8.120357414448675	262
Q60855	PF12721	496	535	0.17125	39	G5BKE8	502	541	0.0	39
Q6P5G6	PF00789	387	463	1.179415584415584	76	G5ALB9	377	453	1.1887012987012984	76
Q6P5G6	PF13899	130	210	8.504037037037035	80	G5ALB9	120	200	8.51979012345679	80
Q6P5G6	PF14555	33	52	7.5310000000000015	19	G5ALB9	1	20	7.5815	19
Q61087	PF00053	249	301	0.03313207547169812	52	G5BAM1	250	304	0.0	54
Q61087	PF00053	312	363	0.3684423076923077	51	G5BAM1	315	366	0.36825	51
Q61087	PF00053	375	424	0.5345	49	G5BAM1	378	427	0.32798	49
Q61087	PF00053	427	474	0.0	47	G5BAM1	430	477	0.0	47
Q61087	PF00053	477	522	0.0	45	G5BAM1	480	525	0.018043478260869567	45
Q61087	PF00053	530	570	0.0	40	G5BAM1	534	574	0.0	40
Q61087	PF00055	25	247	0.9771524663677134	222	G5BAM1	26	248	0.6061255605381166	222
Q9CRC8	PF12799	479	505	0.022222222222222227	26	G5C4T5	366	392	0.022222222222222227	26
Q9CRC8	PF13855	97	139	0.6367441860465116	42	G5C4T5	21	62	0.0	41
Q9CRC8	PF13855	147	185	0.0	38	G5C4T5	70	108	0.0	38
Q9CRC8	PF13855	264	323	5.8348499999999985	59	G5C4T5	187	246	4.8996499999999985	59
Q9CRC8	PF13855	518	575	1.965586206896552	57	G5C4T5	405	462	0.02887931034482759	57
P55099	PF03823	0	53	27.461111111111112	53	G5BB60	1	51	24.741882352941168	50
Q6PFY8	PF00630	396	493	9.459551020408163	97	G5BFJ1	397	494	9.807897959183672	97
Q6PFY8	PF00643	187	223	0.0	36	G5BFJ1	188	224	0.0	36
Q6PFY8	PF13445	28	53	0.13976923076923076	25	G5BFJ1	29	54	0.14515384615384613	25
Q8CBW3	PF00018	424	468	19.929711111111114	44	G5AUW3	335	379	18.16588888888889	44
Q8CBW3	PF07815	92	169	0.5069358974358975	77	G5AUW3	8	80	0.5395068493150686	72
Q80VN0	PF13863	153	271	2.3581428571428558	118	G5B0V3	105	223	1.5500084033613457	118
Q8CFN5	PF00319	9	56	12.070895833333335	47	G5BQZ1	10	57	12.082270833333338	47
Q8CFN5	PF12347	96	153	0.0038275862068965524	57	G5BQZ1	97	154	0.007655172413793105	57
Q6PDM2	PF00076	17	84	0.06297058823529411	67	G5C421	18	85	0.0633235294117647	67
Q6PDM2	PF00076	122	183	1.0186290322580644	61	G5C421	123	184	1.0118548387096775	61
Q9DB27	PF01472	93	169	3.48574025974026	76	G5BTM4	51	127	3.462909090909092	76
Q9DB27	PF17832	43	88	0.21610869565217386	45	G5BTM4	1	46	0.21369565217391312	45
Q80UP3	PF00130	172	230	3.5964745762711865	58	G5ATB6	367	425	3.6530338983050843	58
Q80UP3	PF00609	446	603	4.665284810126582	157	G5ATB6	641	798	4.613379746835443	157
Q80UP3	PF00781	295	410	10.412310344827592	115	G5ATB6	490	605	10.372620689655166	115
Q80UP3	PF12796	794	888	1.364578947368421	94	G5ATB6	989	1083	2.8244842105263164	94
Q6VYH9	PF00017	33	108	2.0769473684210524	75	G5C2V4	29	104	9.10532894736842	75
Q9DCS2	PF06080	0	202	3.5735172413793124	202	G5BXW4	136	338	4.034374384236454	202
P97769	PF04487	41	198	1.6831265822784809	157	G5AM91	64	212	1.7636107382550337	148
Q99JL1	PF06294	12	106	12.574347368421051	94	G5B4U6	13	107	12.923494736842107	94
Q9D7M8	PF03874	31	135	0.0359047619047619	104	E3VX68	32	136	0.23489523809523816	104
Q61245	PF01391	439	487	0.0	48	G5AYR1	823	871	0.0	48
Q61245	PF01391	526	583	0.0	57	G5AYR1	540	597	0.0	57
Q61245	PF01391	727	780	0.0	53	G5AYR1	739	792	0.0	53
Q61245	PF01391	1480	1538	0.0	58	G5AYR1	796	860	0.0	64
Q61245	PF01410	1573	1801	0.3529344978165939	228	G5AYR1	1581	1809	0.6329126637554587	228
Q61245	PF13385	94	224	11.919030534351144	130	G5AYR1	96	226	11.403129770992365	130
Q9ES18	PF00250	65	143	8.775835443037977	78	G5BPN2	66	144	8.803911392405073	78
P52793	PF00812	17	146	2.5045384615384614	129	G5BDE6	18	147	3.6	129
Q80W32	PF00612	373	390	0.0	17	G5ALA6	341	358	0.0	17
Q8K0T2	PF05783	29	165	8.464218978102194	136	G5AL87	28	164	8.356824817518248	136
Q8K0S9	PF09808	25	209	6.4874702702702765	184	G5C5I5	7	191	5.1292594594594565	184
Q9D0S4	PF07177	25	242	3.646532110091743	217	G5B7P6	26	243	3.6229862385321097	217
Q9D0S4	PF07525	248	283	0.0	35	G5B7P6	249	284	0.0	35
Q5SPX3	PF13639	325	367	0.023023255813953487	42	G5APV0	229	271	0.023023255813953487	42
Q925K9	PF00069	11	266	6.0052695312500015	255	G5AN44	12	267	5.376089843749997	255
E9Q8I9	PF14222	164	696	10.36991181988742	532	G5B7X4	147	687	10.988789279112744	540
E9Q8I9	PF14225	2049	2301	11.120517786561262	252	G5B7X4	2027	2279	9.540948616600788	252
E9Q8I9	PF14228	1208	1369	11.644419753086414	161	G5B7X4	1199	1354	2.9326923076923075	155
E9Q8I9	PF14228	1413	1499	6.596551724137927	86	G5B7X4	1398	1484	7.373103448275858	86
E9Q8I9	PF14228	1636	1697	19.779161290322584	61	G5B7X4	1622	1683	19.878000000000004	61
E9Q8I9	PF14228	1778	1894	2.7206752136752117	116	G5B7X4	1764	1880	2.7670683760683756	116
Q8CGS6	PF00270	102	267	7.392927710843374	165	G5BBK7	106	271	17.092006024096374	165
Q8CGS6	PF00271	401	483	0.2863855421686747	82	G5BBK7	405	487	0.2849759036144579	82
Q8CGS6	PF00476	2051	2537	2.045092402464066	486	G5BBK7	2080	2567	3.071043032786884	487
P83917	PF01393	117	169	12.111943396226414	52	G5BY16	118	170	12.111415094339618	52
P83917	PF00385	20	68	0.4675510204081635	48	G5BY16	21	69	0.42908163265306143	48
P70426	PF00071	38	143	6.113377358490563	105	G5ARB0	1	105	6.164619047619048	104
Q8BYH8	PF00176	873	1148	5.1653731884057965	275	G5BD86	875	1150	4.9599420289855045	275
Q8BYH8	PF00271	1182	1294	6.6525398230088495	112	G5BD86	1184	1296	6.645849557522122	112
Q8BYH8	PF00385	689	748	0.5562000000000001	59	G5BD86	691	750	0.3202833333333333	59
Q8BYH8	PF00385	772	824	11.339452830188675	52	G5BD86	774	826	11.132037735849057	52
Q9D8S9	PF01722	39	112	0.16745945945945945	73	G5BH23	40	113	0.16725675675675675	73
P50540	PF00010	68	119	0.023173076923076925	51	G5BKB8	130	181	0.022788461538461542	51
Q8BR93	PF13359	148	299	4.902750000000001	151	G5ATC0	149	300	1.9888289473684209	151
P18911	PF00104	228	398	7.320128654970758	170	G5BIG9	225	395	6.806239766081867	170
P18911	PF00105	88	156	0.009782608695652176	68	G5BIG9	85	153	0.009782608695652176	68
Q9JKX6	PF00293	58	178	7.382280991735536	120	G5BE25	77	196	7.539308333333333	119
Q02248	PF00514	229	261	31.30115151515151	32	G5ALX2	393	425	28.76106060606061	32
Q02248	PF00514	350	389	0.50545	39	G5ALX2	514	553	0.5024500000000001	39
Q02248	PF00514	431	472	0.3648333333333332	41	G5ALX2	595	636	0.3648333333333332	41
Q02248	PF00514	583	621	15.688717948717954	38	G5ALX2	747	785	15.68723076923077	38
Q62513	PF00096	78	100	0.0	22	G5BWF1	80	102	0.0	22
Q62513	PF00096	130	152	0.0	22	G5BWF1	133	155	0.0	22
Q62513	PF00096	158	180	0.0	22	G5BWF1	161	183	0.0	22
Q62513	PF00096	186	208	0.0	22	G5BWF1	189	211	0.0	22
Q62513	PF00096	214	236	0.0	22	G5BWF1	217	239	0.0	22
Q62513	PF00096	242	264	0.0	22	G5BWF1	245	267	0.0	22
Q62513	PF00096	270	292	0.09043478260869564	22	G5BWF1	273	295	0.09	22
Q62513	PF00096	298	320	4.897304347826087	22	G5BWF1	301	323	4.879130434782611	22
Q62513	PF00096	326	348	0.0	22	G5BWF1	329	351	0.0	22
Q62513	PF00096	356	376	0.6034285714285714	20	G5BWF1	359	379	0.05485714285714285	20
Q62513	PF00096	382	404	0.0	22	G5BWF1	385	407	0.0	22
Q62513	PF13912	21	45	0.0	24	G5BWF1	23	47	0.0	24
P37913	PF01068	539	743	2.531073170731707	204	G5B8A0	512	684	3.146710982658957	172
P37913	PF04675	285	461	3.0468983050847456	176	G5B8A0	258	434	3.256367231638419	176
P37913	PF04679	768	879	1.5298482142857135	111	G5B8A0	709	838	3.884253846153847	129
Q6P1B1	PF00557	328	541	3.4590794392523354	213	G5BKB6	329	542	4.182724299065423	213
Q6P1B1	PF01321	10	151	0.4085774647887325	141	G5BKB6	11	152	0.4106971830985916	141
Q6P1B1	PF16188	556	617	0.0	61	G5BKB6	557	618	0.0	61
Q6P1B1	PF16189	156	325	13.118535294117661	169	G5BKB6	157	326	13.204882352941176	169
Q8R2R9	PF00928	164	416	0.2090790513833992	252	G5BT54	165	417	0.8419525691699604	252
Q8R2R9	PF01217	0	127	12.043406249999995	127	G5BT54	1	128	12.020765624999996	127
Q6NZQ2	PF00270	127	303	5.3824519774011295	176	G5AT42	127	303	6.709757062146887	176
Q6NZQ2	PF00271	368	486	9.376915966386553	118	G5AT42	377	495	8.772638655462186	118
Q6NZQ2	PF13959	557	617	1.1118196721311475	60	G5AT42	571	631	1.5604918032786887	60
Q9WVS7	PF00069	169	418	11.830335999999996	249	G5C5F7	170	419	11.636824	249
Q9WVS7	PF00564	18	90	3.3968219178082184	72	G5C5F7	19	91	2.869191780821918	72
Q64112	PF14559	231	280	0.3937000000000001	49	G5B0Y7	305	354	0.07762000000000001	49
P16277	PF00017	117	198	0.4511707317073172	81	G5AMF8	118	199	0.344280487804878	81
P16277	PF00018	57	103	8.306191489361701	46	G5AMF8	58	104	1.6163404255319151	46
P16277	PF07714	234	482	8.485389558232935	248	G5AMF8	235	483	8.471200803212849	248
Q8R4B8	PF02758	7	82	13.348328947368419	75	G5C9A8	8	83	13.869473684210528	75
Q8R4B8	PF05729	215	384	7.024611764705888	169	G5C9A8	213	349	6.6628832116788335	136
Q8R4B8	PF13516	735	758	0.0	23	G5C9A8	827	850	2.086125	23
Q8R4B8	PF13516	793	815	0.13056521739130436	22	G5C9A8	885	907	0.4458260869565217	22
Q8R4B8	PF13516	852	872	0.4245238095238096	20	G5C9A8	773	793	0.0	20
Q8R4B8	PF13516	906	929	0.046750000000000014	23	G5C9A8	827	850	2.086125	23
Q8R4B8	PF13516	964	979	0.0	15	G5C9A8	885	900	0.0615625	15
Q8R4B8	PF14484	135	204	0.2456571428571428	69	G5C9A8	131	200	0.0295	69
Q8R4B8	PF17776	517	641	12.189855999999995	124	G5C9A8	562	682	17.34718181818181	120
Q8R4B8	PF17779	461	515	1.249836363636364	54	G5C9A8	506	560	4.713709090909092	54
Q99PE2	PF00023	246	276	7.363096774193545	30	G5AMJ0	248	278	7.362129032258062	30
Q99PE2	PF12796	160	241	2.508146341463416	81	G5AMJ0	162	243	2.2329634146341477	81
P52480	PF00224	42	393	2.7242556818181813	351	G5BHB1	134	487	4.00737570621469	353
P52480	PF02887	419	527	11.091403669724775	108	G5BHB1	577	685	11.018559633027522	108
Q9CXW2	PF10245	66	307	2.7800702479338844	241	G5AQA2	68	309	2.8973719008264447	241
P48379	PF02257	194	267	0.18047297297297293	73	G5C0P3	186	259	0.1813108108108108	73
P48379	PF04589	3	148	0.519	145	G5C0P3	15	166	1.131973684210526	151
Q99LH1	PF01926	312	414	2.188747572815535	102	G5C6H1	313	415	2.0907961165048548	102
Q99LH1	PF08153	42	173	0.0	131	G5C6H1	43	174	0.163030303030303	131
P97493	PF00085	67	162	0.8807604166666668	95	G5BAW6	68	163	0.8861875000000001	95
Q8BGH2	PF01103	150	466	0.38725552050473183	316	G5BKH2	147	462	0.8157025316455702	315
Q99JX1	PF04719	107	192	5.418279069767442	85	G5BCF5	107	193	5.240678160919541	86
Q8C0X0	PF15619	140	330	0.024162303664921458	190	G5AM07	144	334	0.0	190
Q9Z0G7	PF00651	46	148	7.1631941747572805	102	G5BB45	47	149	7.1628640776699015	102
A0JNU3	PF00710	64	218	11.804032258064515	154	G5AWI1	4	158	13.984412903225806	154
A0JNU3	PF13857	423	470	13.305354166666662	47	G5AWI1	366	413	4.814166666666666	47
A0JNU3	PF17763	237	350	2.066850877192983	113	G5AWI1	177	290	2.051333333333333	113
Q99JZ7	PF09027	6	58	0.09081132075471696	52	G5C550	7	59	0.0558490566037736	52
Q99JZ7	PF11555	313	336	0.0	23	G5C550	310	333	0.0	23
Q99JN2	PF00651	41	142	7.048078431372549	101	G5C045	42	143	7.073656862745098	101
Q99JN2	PF01344	392	431	15.180200000000005	39	G5C045	393	432	12.727974999999995	39
Q99JN2	PF01344	536	578	2.4329302325581392	42	G5C045	537	579	1.2385581395348837	42
Q99JN2	PF07707	152	255	1.6955096153846152	103	G5C045	153	256	2.4570096153846155	103
Q99JN2	PF13415	446	489	0.9524772727272728	43	G5C045	447	489	0.5109302325581396	42
Q99JN2	PF13964	337	384	17.443083333333334	47	G5C045	338	385	17.443270833333333	47
Q9R1A3	PF00053	254	298	0.0	44	G5AQD1	255	299	0.0	44
Q9R1A3	PF00053	310	361	0.0	51	G5AQD1	311	361	0.0	50
Q9R1A3	PF00053	373	415	0.0	42	G5AQD1	374	416	0.015627906976744186	42
Q9R1A3	PF00055	39	252	3.9859813084112186	213	G5AQD1	40	253	7.303023364485984	213
Q9R1A3	PF01759	456	464	6.0806666666666676	8	G5AQD1	457	464	0.0	7
Q80TN7	PF00004	2025	2106	6.02169512195122	81	G5C9I8	1950	2031	6.022134146341464	81
Q80TN7	PF00307	80	183	9.224528846153843	103	G5C9I8	1	104	9.229471153846154	103
Q8BMF4	PF00198	414	641	1.7482807017543862	227	G5CAZ8	428	655	1.562022026431718	227
Q8BMF4	PF00364	91	162	4.192708333333333	71	G5CAZ8	94	165	6.204513888888887	71
Q8BMF4	PF00364	218	291	4.5170810810810815	73	G5CAZ8	226	299	5.6090405405405415	73
Q8BMF4	PF02817	349	383	0.0	34	G5CAZ8	363	397	0.0	34
Q810A1	PF00096	415	436	0.030227272727272724	21	G5B2C2	410	431	0.4735454545454546	21
Q810A1	PF00096	442	464	0.0	22	G5B2C2	437	459	0.0	22
Q810A1	PF00096	471	492	0.0	21	G5B2C2	466	487	0.0	21
Q810A1	PF00096	498	520	0.0	22	G5B2C2	493	515	0.0	22
Q810A1	PF00096	526	548	0.0	22	G5B2C2	521	543	0.0	22
Q810A1	PF01352	228	255	0.0	27	G5B2C2	223	250	0.0	27
Q810A1	PF02023	36	123	0.5182727272727271	87	G5B2C2	37	124	0.3633409090909092	87
Q9R0B9	PF03171	651	735	10.942117647058824	84	G5BME9	673	757	9.956623529411765	84
Q80T11	PF00536	393	444	0.5384807692307692	51	G5BND8	384	435	0.5052884615384614	51
Q80T11	PF12796	37	116	10.284025000000002	79	G5BND8	38	117	10.105300000000002	79
Q76N33	PF01398	265	371	5.727130841121497	106	G5BT00	266	372	4.101971962616822	106
Q76N33	PF08969	26	129	8.866826923076921	103	G5BT00	27	130	8.866826923076921	103
Q9ERA0	PF04516	54	257	1.9310931372549016	203	G5ATZ0	55	258	1.931936274509804	203
Q9ERA0	PF18016	322	381	0.08716666666666664	59	G5ATZ0	322	381	0.0875	59
Q62446	PF00254	121	220	0.6141000000000003	99	G5BUQ7	122	221	0.6797400000000003	99
Q62446	PF18410	5	75	0.08422535211267608	70	G5BUQ7	6	76	0.8145492957746477	70
Q9D267	PF00061	33	173	7.4779432624113475	140	G5BQR4	34	174	15.756716312056735	140
Q91VI7	PF13516	49	67	1.2829473684210526	18	G5C479	50	68	6.021105263157895	18
Q91VI7	PF13516	108	128	0.0	20	G5C479	109	128	0.0	19
Q91VI7	PF13516	221	242	0.11609090909090908	21	G5C479	222	243	0.0	21
Q91VI7	PF13516	277	299	0.0	22	G5C479	278	300	1.9151304347826084	22
Q91VI7	PF13516	334	356	0.0	22	G5C479	335	357	0.0	22
Q91VI7	PF13516	364	385	0.7829090909090909	21	G5C479	365	386	3.9309545454545463	21
Q91VI7	PF13516	393	412	0.5558500000000002	19	G5C479	394	413	0.13715000000000002	19
Q91VI7	PF18779	0	29	0.0	29	G5C479	1	30	0.0	29
Q3TLI0	PF12584	1019	1245	2.9054801762114515	226	G5BG19	909	1135	3.1443436123348003	226
Q03358	PF00046	142	198	0.3249824561403509	56	G5CAV8	143	199	0.3259473684210526	56
Q3TIU4	PF03372	297	597	1.2942059800664454	300	G5BE70	301	601	1.3636777408637877	300
Q7TMW6	PF02256	417	463	0.2634042553191489	46	G5BXV1	418	464	6.145255319148936	46
Q7TMW6	PF02906	111	402	2.6000650684931506	291	G5BXV1	112	403	2.1463698630137	291
Q8BVL9	PF16034	414	604	0.3867329842931937	190	G5B319	387	577	0.3816020942408382	190
Q8R151	PF13086	589	726	5.950724637681158	137	G5B9N7	596	733	5.815362318840577	137
Q8R151	PF13086	875	1030	0.5720448717948717	155	G5B9N7	883	1038	0.5915192307692306	155
Q8R151	PF13087	1044	1226	6.952770491803277	182	G5B9N7	1052	1234	6.974704918032786	182
Q9D8Y0	PF13499	95	156	7.601870967741936	61	G5BRS5	31	92	7.613629032258063	61
Q7TQC7	PF01585	467	507	0.0	40	G5ATT3	469	509	0.0	40
Q91VY9	PF12756	252	350	0.9505454545454544	98	G5B0Y0	255	353	0.9542929292929292	98
Q9DB91	PF11568	50	183	1.606410447761194	133	G5BJE0	52	185	1.6048283582089549	133
Q99MQ1	PF00013	135	202	0.0	67	G5BLB8	74	141	0.0	67
Q99MQ1	PF00013	288	350	0.1753015873015873	62	G5BLB8	227	289	0.17431746031746034	62
Q99MQ1	PF00536	881	934	3.7682592592592594	53	G5BLB8	819	872	3.6985925925925915	53
Q9WUM5	PF00549	198	323	5.4445634920634935	125	G5BVG8	199	324	5.386174603174601	125
Q9WUM5	PF02629	52	145	4.4797553191489365	93	G5BVG8	53	146	4.399925531914893	93
Q9JHB4	PF00400	94	130	1.7584054054054052	36	G5B1Z4	178	214	0.8262162162162162	36
Q9JHB4	PF00400	139	173	11.267428571428573	34	G5B1Z4	223	257	7.411371428571428	34
Q9JHB4	PF00400	190	215	0.4805	25	G5B1Z4	274	299	0.3812307692307692	25
Q9JHB4	PF00400	271	309	1.4224358974358975	38	G5B1Z4	355	393	1.4255641025641026	38
Q9D5I4	PF03645	74	170	19.186010309278355	96	G5BSP5	81	177	19.01096907216495	96
Q61036	PF00069	282	533	2.8717777777777767	251	G5C7Y8	304	555	2.869940476190477	251
Q61036	PF00786	68	140	1.6425205479452056	72	G5C7Y8	69	162	1.2933297872340426	93
Q8K1R7	PF00069	54	153	11.26162	99	G5C1K9	55	153	9.085353535353537	98
Q8K1R7	PF00415	402	440	0.2855128205128205	38	G5C1K9	327	365	0.300948717948718	38
Q8K1R7	PF00415	443	494	6.199326923076924	51	G5C1K9	368	419	7.378480769230769	51
Q8K1R7	PF00415	499	546	13.354958333333334	47	G5C1K9	424	471	13.462208333333333	47
Q8K1R7	PF00415	615	663	0.09063265306122448	48	G5C1K9	538	586	0.09755102040816327	48
Q924W5	PF02463	53	1070	2.8659675834970515	1017	G5AZB4	53	1001	3.2058630136986297	948
Q924A4	PF00473	122	159	9.919105263157894	37	G5C4E0	120	157	10.391552631578945	37
Q61233	PF00307	120	233	13.307684210526313	113	G5C1E6	121	234	13.627456140350876	113
Q61233	PF00307	264	374	4.099108108108108	110	G5C1E6	265	368	4.371625	103
Q61233	PF00307	395	501	11.790233644859814	106	G5C1E6	389	495	11.860869158878506	106
Q61233	PF00307	517	621	8.418599999999998	104	G5C1E6	511	615	6.877952380952381	104
Q61233	PF13499	12	77	0.09081818181818184	65	G5C1E6	13	78	0.09072727272727274	65
Q80YR9	PF00076	286	347	5.243483870967742	61	G5C4D1	288	349	3.676758064516129	61
Q80YR9	PF00076	402	467	3.1079545454545454	65	G5C4D1	403	468	1.4362424242424237	65
Q80YR9	PF00076	763	830	0.8047794117647057	67	G5C4D1	887	954	4.169970588235293	67
P97496	PF00249	620	662	1.6147674418604652	42	G5BTA2	556	598	1.6149069767441857	42
P97496	PF04433	450	535	4.074709302325584	85	G5BTA2	386	471	4.076825581395349	85
P97496	PF16495	870	950	7.343543209876544	80	G5BTA2	806	886	7.312604938271606	80
P97496	PF16496	65	443	1.5584221635883913	378	G5BTA2	1	379	1.558562005277044	378
P97496	PF16498	704	770	1.0471194029850746	66	G5BTA2	640	706	0.0	66
Q8BUY9	PF00432	142	185	6.983659090909091	43	G5C1J2	233	276	6.995318181818183	43
Q8BUY9	PF00432	190	233	0.4457272727272728	43	G5C1J2	281	324	0.4455227272727272	43
Q8BUY9	PF00432	242	282	9.828926829268294	40	G5C1J2	333	373	9.827292682926828	40
Q8BUY9	PF00432	289	331	1.2670232558139536	42	G5C1J2	380	422	1.2563720930232558	42
B2RPV6	PF00008	1026	1055	0.06333333333333332	29	G5BZ64	1032	1060	0.0	28
B2RPV6	PF00386	1083	1206	15.434854838709676	123	G5BZ64	1089	1212	11.968443548387091	123
B2RPV6	PF07546	192	261	0.5155714285714286	69	G5BZ64	196	265	1.0512285714285716	69
Q6GQX2	PF15246	871	1170	0.09818333333333336	299	G5AU12	833	1155	0.26549535603715163	322
Q8VCW2	PF00038	73	386	0.8069840764331211	313	G5AX70	78	391	0.497980891719745	313
Q9D0C4	PF02475	218	411	2.2352989690721645	193	G5C5I0	1	194	0.634118556701031	193
P18653	PF00069	61	307	4.4813805668016204	246	G5AUR8	71	328	4.643569767441861	257
P18653	PF00069	406	663	6.1474496124031015	257	G5AUR8	427	684	6.246976744186047	257
P18653	PF00433	330	369	1.7861	39	G5AUR8	351	390	2.38885	39
Q9D9D3	PF00566	61	285	14.207520000000002	224	G5BRF6	62	286	16.623897777777763	224
Q8BFZ4	PF12937	42	84	10.86786046511628	42	G5BX08	43	85	0.06941860465116279	42
Q6NZQ4	PF00533	589	664	9.96686842105263	75	G5AVC7	464	539	10.541855263157887	75
Q6NZQ4	PF12738	101	164	13.83996875	63	G5AVC7	76	139	13.17625	63
Q6NZQ4	PF12738	696	757	8.012870967741938	61	G5AVC7	571	632	7.325419354838711	61
Q6NZQ4	PF16770	845	933	10.192898876404497	88	G5AVC7	720	808	12.678426966292136	88
Q8BGY4	PF00651	45	147	9.69181553398058	102	G5C5A9	30	132	10.870223300970867	102
Q8BGY4	PF01344	341	382	8.78654761904762	41	G5C5A9	326	366	11.103780487804878	40
Q8BGY4	PF01344	393	431	2.218410256410257	38	G5C5A9	360	397	5.362184210526316	37
Q8BGY4	PF01344	542	580	6.2019230769230775	38	G5C5A9	509	547	6.169564102564102	38
Q8BGY4	PF07707	155	256	5.47172549019608	101	G5C5A9	140	241	5.428019607843132	101
Q8BGY4	PF13964	441	488	0.0	47	G5C5A9	408	455	0.0	47
Q8VBX0	PF07525	238	276	0.0	38	G5BPJ6	213	251	0.0	38
Q8VBX0	PF12796	26	111	2.0148837209302317	85	G5BPJ6	1	86	2.014011627906976	85
Q8VBX0	PF12796	120	210	0.10549450549450548	90	G5BPJ6	95	185	0.1051648351648352	90
Q9D024	PF07946	134	457	9.27806172839506	323	G5BDJ3	135	457	9.298136222910225	322
Q8BY87	PF00443	217	560	2.970837209302325	343	G5C7T8	1	344	3.0194854651162784	343
Q62388	PF00454	2724	2970	3.2774858299595144	246	G5BXR2	2714	2960	3.198028340080972	246
Q62388	PF02259	2102	2497	3.176396464646462	395	G5BXR2	2096	2487	3.637691326530612	391
Q62388	PF02260	3035	3064	2.381833333333333	29	G5BXR2	3025	3054	1.9914666666666667	29
Q62388	PF11640	10	163	0.6487467532467531	153	G5BXR2	11	164	1.08037012987013	153
Q3U9F6	PF05605	148	207	0.0	59	G5C2U2	205	264	0.0	59
Q3U9F6	PF13923	44	71	0.0	27	G5C2U2	98	128	0.2822258064516129	30
Q3U9F6	PF18574	92	123	0.0	31	G5C2U2	149	180	0.0	31
Q99PM3	PF03153	12	246	0.4699574468085106	234	G5AJS0	30	261	0.4952586206896552	231
Q99PM3	PF03153	267	377	0.6322972972972973	110	G5AJS0	283	393	0.6438181818181821	110
Q8R3B7	PF00439	796	870	5.4909333333333326	74	G5BA38	788	862	5.490053333333332	74
Q9D7D2	PF00079	48	396	5.693272206303727	348	G5B494	42	389	3.507	347
Q9R1T4	PF00735	38	307	4.921107407407408	269	G5BU71	87	356	3.9738740740740734	269
O88990	PF00307	44	147	12.363519230769233	103	G5BWY6	45	148	12.406951923076914	103
O88990	PF00307	157	262	13.898575471698114	105	G5BWY6	158	263	13.903933962264153	105
O88990	PF00435	286	395	0.017190909090909087	109	G5BWY6	287	396	0.01709090909090909	109
O88990	PF00435	406	510	0.040047619047619054	104	G5BWY6	407	511	0.04	104
O88990	PF00435	522	632	0.2073243243243243	110	G5BWY6	523	633	0.15111711711711714	110
O88990	PF00435	643	744	0.4751960784313726	101	G5BWY6	644	745	0.4672352941176472	101
O88990	PF08726	829	895	2.5196268656716425	66	G5BWY6	830	896	0.8569850746268659	66
A2A5N8	PF00536	754	818	14.056492307692306	64	G5BCW9	782	846	13.89810769230769	64
A2A5N8	PF01530	626	654	0.0	28	G5BCW9	653	681	0.0	28
A2A5N8	PF02820	315	382	9.744514705882343	67	G5BCW9	332	398	9.886089552238804	66
A2A5N8	PF02820	422	489	2.9570588235294104	67	G5BCW9	449	516	3.1388382352941164	67
A2A5N8	PF02820	526	591	0.06546969696969697	65	G5BCW9	553	618	0.03977272727272727	65
P34022	PF00638	36	160	0.11422399999999995	124	G5CA28	33	157	0.113856	124
Q9CWQ2	PF04434	65	111	9.542765957446806	46	G5BEU9	66	112	14.724468085106384	46
Q3UEB3	PF00076	135	205	8.984647887323947	70	G5AWE4	128	198	8.067845070422534	70
Q3UEB3	PF00076	232	301	1.6091714285714291	69	G5AWE4	225	294	1.3676142857142863	69
Q91Y97	PF00274	14	363	3.4242199999999996	349	G5ANC4	15	364	5.0301289398280815	349
Q8VE19	PF17034	736	858	2.2906016260162607	122	G5BRY7	739	861	2.228878048780488	122
Q8VDS4	PF04818	7	124	12.553033898305086	117	G5C759	8	125	12.532466101694922	117
Q8VDS4	PF16566	164	309	0.004143835616438356	145	G5C759	165	310	0.004143835616438356	145
B1AUR6	PF14910	25	729	10.047868085106376	704	G5BLR1	24	726	10.626937411095305	702
B1AUR6	PF14911	848	1223	7.9174414893617024	375	G5BLR1	846	1220	7.385229333333329	374
Q9D554	PF11931	323	499	0.2193050847457627	176	G5C6I0	324	500	0.2193050847457627	176
Q9D554	PF12108	73	99	0.0	26	G5C6I0	74	100	0.0	26
Q9D554	PF13297	243	302	0.7189333333333331	59	G5C6I0	244	303	0.7189333333333331	59
Q9D554	PF16837	128	205	6.361551282051282	77	G5C6I0	129	206	6.361551282051282	77
Q99MH5	PF00334	12	144	8.603315789473685	132	G5BA37	13	144	4.979272727272725	131
Q99MH5	PF05186	156	196	7.920707317073171	40	G5BA37	157	197	9.183	40
Q60821	PF00096	296	318	0.0	22	G5BRT8	297	319	0.0	22
Q60821	PF00096	380	402	0.0	22	G5BRT8	378	400	0.0	22
Q60821	PF00096	408	430	0.0	22	G5BRT8	406	428	0.0	22
Q60821	PF00096	436	458	0.0	22	G5BRT8	434	456	0.0	22
Q60821	PF00096	465	486	0.0	21	G5BRT8	463	484	0.0	21
Q60821	PF00096	492	514	0.0	22	G5BRT8	490	512	0.07921739130434782	22
Q60821	PF00096	521	542	0.0	21	G5BRT8	519	540	0.0	21
Q60821	PF00096	548	570	0.0	22	G5BRT8	546	568	0.0	22
Q60821	PF00096	576	598	2.4306086956521735	22	G5BRT8	574	596	2.4447391304347827	22
Q60821	PF00096	604	627	0.0	23	G5BRT8	602	625	0.0	23
Q60821	PF00651	13	109	10.457020618556703	96	G5BRT8	14	110	10.467886597938149	96
Q7TNE1	PF02515	38	362	5.880538461538461	324	G5B6U7	14	305	4.978426116838491	291
P30285	PF00069	5	294	4.293789655172416	289	G5BEB8	6	295	4.298279310344832	289
Q8CCJ3	PF09743	6	283	0.6859999999999998	277	G5BQD0	7	284	0.6684316546762595	277
Q9CQV1	PF03656	1	124	6.637201612903228	123	G5C0J2	2	122	4.3054250000000005	120
Q8R0H9	PF00790	14	142	2.94117054263566	128	G5AYX4	80	208	2.219395348837209	128
Q8R0H9	PF02883	509	626	12.891067796610168	117	G5AYX4	661	778	10.860161016949153	117
Q8R0H9	PF03127	221	298	0.6563076923076924	77	G5AYX4	287	366	0.632775	79
Q8R0H9	PF18308	168	206	0.036000000000000004	38	G5AYX4	234	272	0.03553846153846154	38
O55071	PF00067	39	487	11.760801781737188	448	G5C9W0	39	486	9.25895089285714	447
Q9QUP4	PF00685	41	355	2.783209523809526	314	G5B5Y1	42	356	2.6022063492063503	314
Q6PGF3	PF11635	109	820	7.219575842696626	711	G5C5X6	147	885	7.002282814614336	738
Q8VD76	PF03850	8	286	10.623863799283153	278	G5AWT8	9	293	11.035284210526314	284
Q64520	PF00625	57	161	4.686590476190476	104	G5C998	61	164	0.9231057692307694	103
Q3U1G5	PF00929	194	349	0.2725320512820514	155	G5AR80	174	329	0.03760256410256412	155
E5FYH1	PF14669	1245	1420	6.396113636363636	175	G5C205	1158	1333	5.895221590909089	175
Q9QYY1	PF00340	52	151	2.912470000000001	99	G5B416	52	151	2.8302400000000008	99
Q8BWY3	PF03464	144	276	9.065398496240604	132	G5BA47	145	277	7.263120300751879	132
Q8BWY3	PF03465	279	416	3.0090000000000017	137	G5BA47	280	417	3.0090000000000017	137
Q8BWY3	PF03463	17	137	6.958355371900828	120	G5BA47	18	138	6.9783884297520675	120
Q3TIX9	PF00443	223	548	5.933708588957051	325	G5BU86	225	550	5.99006134969325	325
Q3TIX9	PF02148	123	183	1.7780000000000002	60	G5BU86	125	185	1.7750655737704917	60
Q9D819	PF00719	45	227	4.870054644808746	182	G5B194	46	228	4.993672131147541	182
Q8R016	PF03051	5	450	5.900186098654702	445	G5BVP9	6	451	5.8204529147982065	445
Q8BTC1	PF14990	0	45	1.5918043478260868	45	G5AR39	1	46	0.8998260869565218	45
P12979	PF00010	81	132	0.16501923076923075	51	G5B370	82	133	0.06653846153846152	51
P12979	PF01586	0	80	0.0	80	G5B370	1	81	0.0	80
Q148B6	PF15058	0	172	0.12364739884393065	172	G5C5U3	1	161	3.5006335403726743	160
Q148B6	PF15058	179	261	1.0700722891566263	82	G5C5U3	141	223	0.7289879518072286	82
Q148B6	PF15059	333	479	1.7074421768707482	146	G5C5U3	425	571	2.0699178082191785	146
Q8BH69	PF00586	81	168	3.4755454545454536	87	G5C5E7	82	169	4.328238636363636	87
Q8BH69	PF02769	192	366	8.589617142857149	174	G5C5E7	193	367	8.598257142857143	174
Q8CDJ8	PF00928	397	708	3.0033749999999984	311	G5ANC0	399	710	5.648673076923075	311
Q9D9C6	PF15835	0	137	1.9712246376811595	137	G5C426	18	154	1.9140072992700716	136
Q9DB72	PF00651	52	158	6.557252336448599	106	G5B5N2	53	159	6.568140186915888	106
Q9DB72	PF07707	171	266	2.666197916666667	95	G5B5N2	173	268	10.012624999999998	95
G3X9J0	PF02145	633	815	6.3774207650273205	182	G5AMC5	626	809	6.428717391304345	183
G3X9J0	PF11881	1470	1720	0.6304820717131474	250	G5AMC5	1470	1725	0.6185273437500001	255
Q5XJV7	PF00856	285	386	12.810264705882352	101	G5BX92	305	406	12.905147058823525	101
Q3US17	PF00096	83	104	0.0	21	G5BYL8	70	91	0.0	21
Q3US17	PF00096	110	132	0.0	22	G5BYL8	17	39	0.0	22
Q3US17	PF00096	164	184	0.0	20	G5BYL8	71	91	0.0	20
Q3US17	PF00096	190	212	0.0	22	G5BYL8	97	119	0.0	22
Q3US17	PF00096	245	267	0.9785652173913044	22	G5BYL8	152	174	0.9636086956521738	22
Q3US17	PF00096	275	295	0.0	20	G5BYL8	182	202	0.0	20
Q3US17	PF00096	301	323	0.0	22	G5BYL8	208	230	0.0	22
Q3US17	PF00096	329	351	0.0	22	G5BYL8	236	258	0.0	22
Q3US17	PF00096	422	444	0.0	22	G5BYL8	330	352	0.0	22
Q3US17	PF00096	301	323	0.0	22	G5BYL8	208	230	0.0	22
Q3US17	PF00096	515	537	0.0	22	G5BYL8	421	443	0.0	22
Q3US17	PF00096	543	565	0.0	22	G5BYL8	449	471	0.0	22
Q8CFG4	PF00751	81	127	0.3297872340425533	46	G5BA26	68	114	0.3692127659574468	46
Q8CFG4	PF03474	313	349	0.8108378378378379	36	G5BA26	289	325	0.4413783783783784	36
Q9CPY1	PF10244	38	125	2.441113636363637	87	G5CAP5	39	126	0.8054886363636367	87
D3YZG8	PF00763	43	159	4.5977521367521375	116	G5BU08	6	122	4.4422478632478635	116
D3YZG8	PF02882	162	334	4.690878612716767	172	G5BU08	125	296	6.084505813953488	171
Q9CZP0	PF07910	84	211	5.209367187500003	127	G5AV52	1	128	4.214750000000004	127
Q8BP99	PF15546	0	228	0.0939519650655022	228	G5C6E6	121	348	0.4819254385964912	227
Q80Z25	PF16045	73	99	0.527814814814815	26	G5AKY0	72	97	21.6663076923077	25
Q9JL60	PF01342	81	153	0.4245890410958904	72	G5AP94	92	164	0.3954109589041096	72
Q9CQJ4	PF13923	49	89	5.746048780487804	40	G5BGQ4	50	90	5.746048780487804	40
Q9CQJ4	PF16207	245	329	5.390023529411764	84	G5BGQ4	246	330	5.390023529411764	84
Q8R2G4	PF01129	28	250	2.9659237668161427	222	G5BJR2	29	252	6.512058035714286	223
A0JLY1	PF13868	141	472	0.02290662650602409	331	G5C8Q2	126	457	0.694813253012048	331
Q9CZ04	PF01399	78	153	3.9297500000000016	75	G5CAQ5	79	154	3.8064473684210527	75
Q9CZ04	PF18392	165	214	0.07976	49	G5CAQ5	166	215	0.15086000000000005	49
Q3U1N2	PF00010	319	369	0.06929411764705884	50	G5BPQ5	333	383	0.06952941176470588	50
Q8BTF7	PF00533	655	729	0.9120266666666668	74	G5B8M6	656	730	1.0116000000000005	74
Q8BTF7	PF00533	844	896	0.5650377358490567	52	G5B8M6	845	897	1.1151698113207549	52
Q8BTF7	PF01068	247	450	0.5386862745098038	203	G5B8M6	248	451	1.2935294117647065	203
Q8BTF7	PF04675	14	207	7.505474226804121	193	G5B8M6	15	208	7.758536082474227	193
Q8BTF7	PF04679	475	587	1.882548672566372	112	G5B8M6	476	588	2.4804778761061947	112
Q8BTF7	PF11411	749	781	5.920878787878787	32	G5B8M6	750	782	0.1984848484848485	32
P63158	PF00505	94	162	7.0039855072463775	68	G5B268	95	163	7.0039855072463775	68
P63158	PF09011	5	77	6.197931506849316	72	G5B268	6	78	6.197931506849316	72
Q9DB00	PF02671	1671	1716	7.166934782608695	45	G5ARB2	1552	1597	8.07032608695652	45
Q9CWD3	PF00293	93	217	15.371464	124	G5BBM3	90	213	10.43300806451613	123
O88745	PF15224	21	96	0.08432894736842103	75	G5B402	21	96	0.07664	75
Q9WUJ8	PF05460	6	93	0.35940909090909084	87	G5C3N5	7	94	0.056806818181818174	87
Q5NCF2	PF04099	2	135	7.119067164179106	133	G5B5E7	3	136	6.52381343283582	133
Q9Z2D8	PF01429	56	68	0.0	12	G5BW52	1	13	0.0	12
Q9Z2D8	PF14048	152	242	0.6300769230769231	90	G5BW52	157	247	0.6199230769230772	90
Q9Z2D8	PF16564	91	147	0.010263157894736842	56	G5BW52	96	152	0.0	56
O54833	PF00069	39	324	1.7378846153846144	285	G5AUG4	5	290	1.7418146853146848	285
Q9CWH5	PF01170	189	319	1.5604503816793889	130	G5C4S7	190	320	1.4701374045801516	130
Q7TS63	PF00096	270	292	0.0	22	G5C6R2	260	282	0.0	22
Q7TS63	PF00096	903	925	0.0	22	G5C6R2	897	919	0.0	22
Q7TS63	PF13909	298	322	0.0234	24	G5C6R2	288	312	0.0234	24
Q7TS63	PF13909	960	982	0.0	22	G5C6R2	1012	1034	0.0	22
Q80TY0	PF00018	554	601	2.144104166666668	47	G5ASB4	584	632	4.343469387755102	48
Q80TY0	PF00611	9	87	1.1031012658227846	78	G5ASB4	43	121	0.3281645569620253	78
O55028	PF02518	267	400	3.5456865671641786	133	G5BYC5	229	362	3.610485074626865	133
O55028	PF10436	72	221	5.552419999999999	149	G5BYC5	34	183	5.710993333333335	149
O08599	PF00995	28	579	3.853625000000002	551	G5BLH0	88	659	3.707657342657349	571
Q8VDQ9	PF05178	345	427	0.0	82	G5BUH3	352	434	0.0	82
Q8VDQ9	PF12936	499	585	0.0	86	G5BUH3	634	720	0.0	86
Q922U1	PF01480	8	76	3.38117391304348	68	G5BH37	9	77	3.38117391304348	68
Q922U1	PF06544	544	672	13.432178294573648	128	G5BH37	545	673	13.430984496124037	128
Q922U1	PF08572	307	520	1.246817757009346	213	G5BH37	308	521	1.246817757009346	213
Q9Z1E4	PF05693	30	661	7.529969936708867	631	G5BAG4	31	662	7.477759493670895	631
O89023	PF00082	317	488	4.751325581395347	171	G5BBQ3	319	490	4.498104651162791	171
O89023	PF09286	32	175	6.165083333333333	143	G5BBQ3	33	176	5.316256944444445	143
Q69ZW3	PF00307	455	557	10.218019417475727	102	G5AL60	315	417	13.073805825242722	102
Q69ZW3	PF10358	12	38	2.1336296296296293	26	G5AL60	13	38	2.189	25
Q69ZW3	PF12130	1132	1208	3.518	76	G5AL60	1048	1124	4.687402597402596	76
Q921N6	PF00270	207	377	1.1201754385964908	170	G5B9N6	211	381	1.1203976608187134	170
Q921N6	PF00271	418	523	11.092518867924529	105	G5B9N6	422	527	9.993094339622642	105
P39428	PF16673	179	236	12.816379310344832	57	G5AXS6	186	243	8.554896551724138	57
Q6X1Y6	PF00858	20	457	6.884627853881277	437	G5AMS9	14	454	6.436337868480727	440
Q9CYR0	PF00436	29	134	3.7461320754716985	105	G5B580	22	126	4.3887307692307695	104
Q9Z1E3	PF00023	215	246	13.35971875	31	G5B118	126	157	13.326375	31
Q9Z1E3	PF12796	127	211	7.48054117647059	84	G5B118	38	122	1.7898588235294124	84
Q80TQ2	PF00443	588	884	7.673350168350166	296	G5C252	571	867	8.977720538720538	296
Q80TQ2	PF01302	136	200	13.51646153846154	64	G5C252	118	182	13.527476923076925	64
Q80TQ2	PF01302	474	533	1.2988000000000004	59	G5C252	457	516	1.29815	59
Q80TQ2	PF16607	303	466	0.6860975609756097	163	G5C252	285	449	0.7019454545454543	164
Q9DCD2	PF13181	256	283	1.6438571428571431	27	G5B7I2	257	284	1.7790714285714284	27
Q9DCD2	PF13181	396	425	14.688433333333327	29	G5B7I2	379	408	12.347299999999995	29
Q9QZJ6	PF05507	16	128	0.13124778761061948	112	G5BPM6	25	117	0.1522258064516129	92
Q80XJ3	PF12770	1384	1706	5.628891640866871	322	G5APY8	1257	1579	5.937145510835912	322
Q80XJ3	PF13176	269	302	1.3369411764705879	33	G5APY8	142	175	1.7420000000000002	33
Q80XJ3	PF13424	307	378	3.9180972222222223	71	G5APY8	180	251	3.910124999999999	71
Q80XJ3	PF13424	386	458	0.0	72	G5APY8	259	331	0.0	72
Q80XJ3	PF13424	469	536	0.013161764705882355	67	G5APY8	342	409	0.013088235294117649	67
Q80XJ3	PF13424	546	618	1.1450410958904107	72	G5APY8	419	491	1.1421506849315068	72
Q80XJ3	PF13424	631	691	0.1141967213114754	60	G5APY8	504	564	0.1459016393442623	60
Q80XJ3	PF13424	708	779	0.05881944444444444	71	G5APY8	581	652	0.057916666666666665	71
Q80XJ3	PF13424	827	901	0.07510666666666667	74	G5APY8	700	774	0.07654666666666668	74
Q80XJ3	PF13424	909	981	2.0618630136986296	72	G5APY8	782	854	2.057397260273972	72
Q80XJ3	PF13424	992	1060	0.1348115942028985	68	G5APY8	865	933	0.14304347826086958	68
Q80XJ3	PF13424	1072	1141	0.8169142857142857	69	G5APY8	945	1014	0.814742857142857	69
Q62361	PF05438	16	115	0.3915299999999999	99	G5C711	17	113	0.1995257731958763	96
Q62361	PF05438	151	222	0.0	71	G5C711	105	177	0.13083561643835614	72
Q8BMZ5	PF01974	223	306	1.5444047619047614	83	G5CBG1	158	241	0.6740952380952387	83
Q9JIF0	PF13649	91	188	8.043367346938773	97	G5B8Q4	92	189	9.791744897959184	97
Q9ER38	PF06309	92	221	0.9387692307692308	129	G5C7J8	96	223	2.955335937500001	127
Q91WS7	PF00610	48	133	0.052662790697674405	85	G5AN93	49	134	0.11539534883720932	85
Q9Z0H7	PF00619	18	100	0.43155421686746975	82	G5C916	19	101	0.2068192771084337	82
Q9CQX4	PF15715	0	106	0.028411214953271032	106	G5AZ53	1	110	0.019372727272727274	109
Q61545	PF00076	361	432	0.6459999999999999	71	G5APX4	375	445	0.6146478873239437	70
Q9JJN5	PF00246	33	328	2.3976993243243228	295	G5AYP3	34	329	0.9474121621621624	295
Q9JJN5	PF13620	340	415	4.8801578947368425	75	G5AYP3	338	413	3.818828947368423	75
Q03265	PF00006	191	414	6.3247723214285765	223	G5BL81	192	415	6.322647321428577	223
Q03265	PF00306	421	546	8.006912698412698	125	G5BL81	422	547	8.344261904761904	125
Q03265	PF02874	68	134	8.024208955223884	66	G5BL81	69	135	8.030462686567168	66
Q8JZW4	PF00168	28	126	4.4178282828282835	98	G5B539	29	127	4.436878787878785	98
Q8JZW4	PF00168	183	279	5.445721649484539	96	G5B539	184	280	5.448030927835048	96
Q8JZW4	PF07002	346	563	7.119022935779818	217	G5B539	347	568	7.006828828828827	221
Q80ZN9	PF02297	20	83	0.14359375000000002	63	G5BVZ6	21	84	0.035078124999999995	63
Q61768	PF00225	13	324	4.198298076923078	311	G5BE28	14	325	4.851919871794873	311
Q8BU51	PF01273	32	180	6.217308724832216	148	G5BPV9	33	184	13.295855263157895	151
Q8BU51	PF02886	266	413	0.1086418918918919	147	G5BPV9	271	399	5.170651162790699	128
Q8CGA0	PF00481	153	402	6.763971999999996	249	G5BKG0	231	480	10.364867999999989	249
Q8BZX4	PF00076	70	138	1.5556666666666668	68	G5C371	184	252	1.5579420289855077	68
Q9JKP5	PF00642	181	203	0.0	22	G5C116	124	146	0.0	22
Q9JKP5	PF14608	18	38	0.046285714285714284	20	G5C116	126	146	0.0	20
Q9JKP5	PF14608	52	70	4.408315789473684	18	G5C116	162	180	0.09715789473684212	18
Q9JKP5	PF14608	219	237	0.17742105263157898	18	G5C116	162	180	0.09715789473684212	18
Q9JIT1	PF00612	189	208	0.0425	19	G5C8R6	212	231	0.0	19
Q9JIT1	PF13445	294	340	1.998765957446809	46	G5C8R6	317	354	2.3177368421052638	37
Q9JIT1	PF13639	128	170	0.2272325581395349	42	G5C8R6	151	193	0.2244883720930232	42
Q61315	PF00514	512	549	4.309394736842107	37	G5BA32	513	550	4.310026315789473	37
Q61315	PF00514	646	686	1.0003414634146344	40	G5BA32	647	687	1.0001219512195123	40
Q61315	PF05923	1257	1277	0.0	20	G5BA32	1257	1277	0.0	20
Q61315	PF05923	1370	1391	0.05	21	G5BA32	1369	1390	0.0	21
Q61315	PF05923	1484	1507	0.0	23	G5BA32	1483	1506	0.0	23
Q61315	PF05923	1634	1657	0.0	23	G5BA32	1634	1657	0.0	23
Q61315	PF05923	1838	1862	0.0	24	G5BA32	1838	1862	0.0	24
Q61315	PF05923	1947	1964	0.0	17	G5BA32	1947	1963	0.0	16
Q61315	PF05923	2006	2028	0.0	22	G5BA32	2005	2027	0.0	22
Q61315	PF05924	1564	1585	0.0	21	G5BA32	1564	1585	0.0	21
Q61315	PF05924	1714	1734	0.0	20	G5BA32	1714	1734	0.0	20
Q61315	PF05924	2029	2050	0.0	21	G5BA32	2028	2049	0.0	21
Q61315	PF05937	2669	2844	0.08797159090909093	175	G5BA32	2666	2839	0.09021965317919076	173
Q61315	PF05956	2223	2568	0.0	345	G5BA32	2220	2564	0.0	344
Q61315	PF05972	1017	1031	0.0	14	G5BA32	1018	1032	0.0	14
Q61315	PF05972	1153	1167	0.0	14	G5BA32	1152	1166	0.0	14
Q61315	PF05972	1170	1184	0.0	14	G5BA32	1169	1183	0.0	14
Q61315	PF11414	128	203	0.8137368421052631	75	G5BA32	131	206	0.8139605263157895	75
Q61315	PF16629	729	1016	0.01281944444444445	287	G5BA32	730	1017	0.017378472222222222	287
Q61315	PF16630	1033	1132	0.0	99	G5BA32	1034	1133	0.0	99
Q61315	PF16633	1280	1366	0.0	86	G5BA32	1280	1365	0.011232558139534886	85
Q61315	PF16634	1659	1712	0.062129629629629625	53	G5BA32	1659	1712	0.0	53
Q61315	PF16635	1743	1836	0.023021276595744683	93	G5BA32	1743	1836	0.013297872340425532	93
Q61315	PF16636	1870	1944	0.0	74	G5BA32	1870	1944	0.0	74
Q61315	PF16689	3	54	0.0	51	G5BA32	4	55	0.0	51
Q61315	PF18797	390	463	1.5282027027027032	73	G5BA32	391	464	1.5284864864864864	73
Q62082	PF00036	66	90	1.5993600000000003	24	G5AXB3	70	94	4.965359999999999	24
O55236	PF00782	57	171	7.872365217391306	114	G5AZL9	58	172	7.873782608695653	114
O55236	PF01331	271	459	3.022089947089948	188	G5AZL9	272	460	3.0220476190476186	188
O55236	PF03919	463	557	4.3368631578947365	94	G5AZL9	464	558	4.896810526315792	94
Q8R4Z4	PF00178	35	114	0.5991249999999999	79	G5BGA9	36	115	0.5369249999999999	79
Q60604	PF00626	27	106	7.3777375	79	G5BCA2	28	107	9.1433	79
Q60604	PF00626	147	220	2.7785540540540543	73	G5BCA2	148	221	2.764608108108108	73
Q60604	PF00626	266	339	0.5784459459459459	73	G5BCA2	267	340	1.3984189189189191	73
Q60604	PF00626	407	482	15.845644736842106	75	G5BCA2	408	483	16.191342105263153	75
Q60604	PF00626	524	589	2.2620454545454542	65	G5BCA2	525	590	0.5681212121212122	65
Q60604	PF00626	627	702	7.245171052631581	75	G5BCA2	628	703	7.570776315789477	75
Q8BVN8	PF10211	75	250	0.38388068181818175	175	G5C6H0	45	212	0.5427738095238096	167
Q9D0C1	PF13639	227	269	0.0	42	G5BBM1	229	271	0.0	42
Q99K43	PF03999	36	592	0.6655798922800721	556	G5CAB1	35	608	0.5980174216027878	573
Q9D9Z5	PF10172	2	64	0.6937619047619047	62	G5B7V5	3	65	0.6937619047619047	62
Q8CBY0	PF02686	73	133	0.43590163934426224	60	G5B773	56	116	1.9361803278688527	60
Q8BG05	PF00076	36	94	4.552	58	G5BTZ8	101	159	4.560322033898307	58
Q8BG05	PF00076	127	189	10.169793650793649	62	G5BTZ8	192	254	10.137047619047618	62
Q9CR14	PF09765	7	74	0.016102941176470584	67	G5BKJ7	8	55	14.022520833333335	47
Q9CR14	PF11793	303	370	2.9365735294117647	67	G5BKJ7	266	333	2.9914852941176466	67
Q9CR14	PF18890	113	196	8.780428571428573	83	G5BKJ7	76	159	2.3576309523809518	83
Q9CR14	PF18891	199	294	2.576885416666667	95	G5BKJ7	162	257	0.00440625	95
A2AVJ5	PF08539	48	148	2.7415445544554435	100	G5B133	49	151	4.938165048543686	102
Q8CBC4	PF15281	644	707	22.828140624999985	63	G5BBE3	637	700	22.62625000000001	63
Q8K354	PF00106	6	146	2.1010283687943265	140	G5B2U6	140	275	2.4332647058823533	135
Q8K354	PF13561	229	240	0.0	11	G5B2U6	303	314	0.0	11
Q9CPU2	PF14813	37	103	16.36465671641791	66	G5B572	38	104	13.250388059701493	66
Q6P8J2	PF00583	25	143	11.78188235294118	118	G5B5D3	26	144	9.23108403361344	118
Q7TN08	PF15268	72	756	0.07614014598540146	684	G5BM66	43	720	0.2131432791728212	677
B5KM66	PF15191	3	82	0.4967874999999998	79	G5B2G1	2	81	0.4492999999999999	79
P47242	PF00292	5	127	0.367878048780488	122	G5C2Q3	6	128	0.3705609756097559	122
O08850	PF00615	63	178	0.7483017241379311	115	G5BPL3	64	179	0.16931034482758622	115
Q9CQ52	PF00089	27	261	2.0522042553191486	234	G5BI04	29	263	2.828514893617021	234
Q6NXZ1	PF15287	194	224	0.1267741935483871	30	G5AML7	229	258	0.023666666666666662	29
Q6NXZ1	PF15287	261	289	0.06689655172413791	28	G5AML7	296	323	0.06964285714285715	27
Q6NXZ1	PF15287	377	391	0.0	14	G5AML7	465	478	0.0	13
Q6NXZ1	PF15287	489	516	0.0	27	G5AML7	460	486	0.0	26
Q6NXZ1	PF15287	596	622	0.09685185185185186	26	G5AML7	579	604	0.0675	25
Q9QXA5	PF01423	5	68	0.090390625	63	G5B4D1	6	69	0.0909375	63
P24547	PF00478	28	114	2.431850574712644	86	G5BZV1	29	115	2.435045977011494	86
P24547	PF00571	115	162	2.1573125	47	G5BZV1	116	163	2.1580833333333334	47
P24547	PF00571	175	226	9.464615384615383	51	G5BZV1	176	227	9.395346153846152	51
Q7TPD1	PF02207	850	896	0.024787234042553192	46	G5ANB5	735	781	0.024787234042553192	46
Q7TPD1	PF05048	383	480	4.199908163265305	97	G5ANB5	268	365	4.198785714285714	97
Q7TPD1	PF12937	160	203	13.091909090909088	43	G5ANB5	45	88	13.191113636363633	43
Q7TPD1	PF13229	485	636	5.007618421052631	151	G5ANB5	370	521	5.0057434210526335	151
Q7TPD1	PF13229	666	821	2.3744551282051267	155	G5ANB5	551	706	2.3725	155
Q5PR68	PF14846	12	97	0.17513953488372094	85	G5BGY6	11	96	0.10994186046511628	85
Q80U70	PF09733	548	680	2.8070375939849628	132	G5B506	465	597	2.8334285714285725	132
Q9D7H3	PF01137	12	182	4.18911695906433	170	G5AYQ1	13	183	5.096152046783624	170
Q9D7H3	PF05189	183	284	6.672117647058827	101	G5AYQ1	184	285	7.445343137254902	101
O08677	PF00031	24	113	0.1464444444444445	89	G5BT86	25	114	4.047588888888888	89
O08677	PF00031	142	235	3.0574148936170213	93	G5BT86	144	236	6.020677419354839	92
O08677	PF00031	264	358	8.42137894736842	94	G5BT86	266	360	2.137568421052632	94
Q61704	PF00092	283	464	8.295054945054941	181	G5BUN3	284	465	8.186439560439558	181
Q61704	PF06668	682	869	11.145319148936169	187	G5BUN3	683	866	10.065217391304344	183
Q61704	PF08487	45	155	8.799189189189189	110	G5BUN3	46	156	5.715414414414414	110
Q9CWN7	PF10155	365	489	10.457608000000006	124	G5C8V4	369	493	10.457280000000004	124
Q6PER3	PF00307	15	116	1.223137254901961	101	G5BYY8	16	117	1.2223725490196071	101
Q6PER3	PF03271	218	256	19.66623076923077	38	G5BYY8	219	257	24.10510256410257	38
Q9QXT8	PF13499	164	237	1.5399459459459457	73	G5APT6	163	236	1.5275945945945937	73
Q9QXT8	PF13833	104	153	9.67316	49	G5APT6	103	152	11.60378	49
P97305	PF00554	432	591	1.1979500000000003	159	G5C687	435	594	1.199025	159
P97305	PF16179	601	698	1.1432755102040817	97	G5C687	604	701	3.113551020408164	97
Q8C8T8	PF10273	11	90	0.6629875000000001	79	G5BF15	12	91	0.0510125	79
Q9CWU9	PF00400	117	152	0.0	35	G5AME3	118	153	1.6088055555555558	35
Q7TNS7	PF00858	44	463	6.157545238095239	419	G5AKJ0	45	464	6.336240476190479	419
Q91YE3	PF13640	275	366	16.524032608695652	91	G5BQJ5	135	226	17.550619565217392	91
Q91WG2	PF03528	40	167	0.641546875	127	G5BRD8	1	128	0.6732265625000001	127
Q91WG2	PF09311	277	482	0.4064029126213592	205	G5BRD8	233	440	0.6038365384615386	207
A2A5R2	PF01369	649	833	7.711037837837838	184	G5B9N3	661	802	7.2168661971831005	141
A2A5R2	PF09324	1173	1254	5.262121951219512	81	G5B9N3	1142	1223	5.261414634146341	81
A2A5R2	PF12783	377	535	19.508383647798734	158	G5B9N3	389	547	17.464295597484266	158
A2A5R2	PF16213	22	197	2.1235625	175	G5B9N3	23	216	1.9197474226804128	193
Q9Z206	PF00621	178	353	2.5127670454545457	175	G5BPJ2	137	312	6.074460227272729	175
Q9Z206	PF16652	385	503	5.740554621848738	118	G5BPJ2	344	462	5.717310924369746	118
Q3UKU1	PF07303	530	631	5.81864705882353	101	G5BU27	468	569	5.031813725490196	101
Q3UKU1	PF10390	65	290	0.8551061946902662	225	G5BU27	1	226	0.8129734513274334	225
Q8BGX7	PF14950	313	389	2.5563506493506494	76	G5BHS4	16	92	8.869987012987009	76
Q8BGX7	PF14951	539	920	7.2229554973822045	381	G5BHS4	244	629	5.3610466321243555	385
P02463	PF01391	102	160	0.0	58	G5AZ48	1282	1346	0.0	64
P02463	PF01391	171	221	0.0	50	G5AZ48	146	196	0.0	50
P02463	PF01391	274	331	0.0	57	G5AZ48	249	306	0.13641379310344828	57
P02463	PF01391	481	531	0.0	50	G5AZ48	456	506	0.00792156862745098	50
P02463	PF01391	540	585	0.0	45	G5AZ48	515	559	0.0	44
P02463	PF01391	645	687	0.0	42	G5AZ48	1118	1160	0.0	42
P02463	PF01391	691	740	0.0	49	G5AZ48	1022	1079	0.0	57
P02463	PF01391	738	783	0.0	45	G5AZ48	757	801	0.0	44
P02463	PF01391	838	894	0.0	56	G5AZ48	857	913	0.0	56
P02463	PF01391	884	936	0.0	52	G5AZ48	903	955	0.0	52
P02463	PF01391	947	1004	0.0	57	G5AZ48	966	1023	0.0	57
P02463	PF01391	998	1054	0.0	56	G5AZ48	1017	1073	0.0	56
P02463	PF01391	1059	1115	0.0	56	G5AZ48	1078	1134	0.0	56
P02463	PF01391	1173	1229	0.0	56	G5AZ48	1249	1319	0.0	70
P02463	PF01391	1277	1331	0.0	54	G5AZ48	1291	1345	0.0	54
P02463	PF01391	1292	1342	0.0	50	G5AZ48	1306	1355	0.0	49
P02463	PF01391	1384	1419	0.0	35	G5AZ48	1398	1432	0.20045714285714286	34
P02463	PF01413	1457	1551	4.025599999999999	94	G5AZ48	1425	1519	4.030705263157893	94
P02463	PF01413	1555	1665	15.208378378378374	110	G5AZ48	1523	1633	15.046009009009008	110
Q8K297	PF01755	335	518	8.25192391304348	183	G5B7W2	256	419	8.513128048780487	163
Q8K297	PF13704	82	174	6.9969032258064505	92	G5B7W2	1	94	7.333787234042554	93
Q9Z275	PF00650	139	291	11.28750326797385	152	G5CA90	147	299	8.618882352941176	152
Q9Z275	PF03765	64	114	1.3114901960784315	50	G5CA90	72	122	1.6502352941176468	50
P21552	PF00110	43	348	5.37397385620915	305	G5B3R0	44	349	5.39292156862745	305
P33622	PF05778	21	89	5.025768115942028	68	G5BQH4	22	96	0.14909333333333338	74
Q6ZQ08	PF12842	1385	1532	0.6663378378378378	147	G5AW59	1150	1297	0.6667702702702702	147
Q6ZQ08	PF16415	1086	1309	3.5545446428571417	223	G5AW59	877	1074	3.4466919191919176	197
Q6ZQ08	PF16417	814	886	0.031876712328767126	72	G5AW59	727	798	0.0	71
Q6ZQ08	PF16418	499	655	4.033585987261146	156	G5AW59	411	567	4.036280254777069	156
Q8BGD7	PF08447	229	297	17.678840579710144	68	G5BWY0	230	298	19.593463768115942	68
Q3UFY4	PF06098	171	451	0.7785231316725981	280	G5BCM0	34	314	0.20169750889679708	280
P42669	PF04845	56	276	0.4012941176470587	220	G5BCQ6	81	301	0.4003438914027148	220
Q80V72	PF03770	224	438	4.941716279069769	214	G5AVL3	225	439	4.924041860465117	214
Q3TMW1	PF01576	316	507	0.00919270833333333	191	G5AUE9	224	448	0.007866666666666666	224
Q3TUU5	PF01738	77	199	2.387471544715446	122	G5B9M6	73	195	2.3823495934959347	122
Q5RL51	PF13679	424	544	10.192818181818176	120	G5AT23	413	533	10.933983471074386	120
Q5RL51	PF14497	282	330	12.568244897959184	48	G5AT23	271	319	14.22775510204082	48
Q6PAJ1	PF00168	911	1005	6.3824842105263135	94	G5B625	801	895	6.916631578947369	94
Q6PAJ1	PF00620	1066	1216	6.030523178807947	150	G5B625	956	1106	6.0273509933774845	150
Q6PAJ1	PF00621	501	687	1.0171871657754017	186	G5B625	391	577	0.8810213903743315	186
Q6PAJ1	PF19057	703	789	5.271701149425288	86	G5B625	593	679	5.299919540229885	86
Q8K402	PF00907	90	267	2.931241573033709	177	G5BZ16	99	275	2.3848983050847448	176
A2ALS5	PF02145	210	389	6.40660555555556	179	G5BI09	340	519	6.40332222222222	179
Q8CHK4	PF01853	287	470	5.950293478260871	183	G5B6J4	324	507	7.878516304347827	183
Q8CHK4	PF11717	7	64	8.10813793103448	57	G5B6J4	41	98	7.971344827586209	57
Q8CHK4	PF17772	228	282	1.7896727272727273	54	G5B6J4	265	319	1.785563636363637	54
Q8K363	PF00270	192	363	4.772750000000002	171	G5AKE5	201	372	3.7728372093023257	171
Q8K363	PF00271	405	508	8.964701923076921	103	G5AKE5	414	517	7.367038461538455	103
Q8K363	PF13959	550	608	0.9393220338983052	58	G5AKE5	559	617	0.9360169491525424	58
P97329	PF00225	68	504	5.423338672768882	436	G5BA39	70	506	4.362565217391306	436
Q99KR3	PF00753	27	198	0.2968255813953487	171	G5BGR7	28	199	0.38816860465116265	171
Q99KR3	PF17778	236	283	0.7175625	47	G5BGR7	237	284	0.08708333333333335	47
O35658	PF02330	82	274	2.088124352331607	192	G5BW80	86	279	1.0222680412371148	193
Q8VEA6	PF00093	32	94	0.3695079365079365	62	G5AS87	33	95	0.9879047619047621	62
Q8VEA6	PF00093	110	173	0.0275625	63	G5AS87	111	174	0.1308125	63
Q8VEA6	PF00093	247	309	0.4875238095238096	62	G5AS87	253	315	0.0	62
P70218	PF00069	16	272	5.692357976653698	256	G5AMB2	17	291	4.571407272727273	274
P70218	PF00780	511	800	7.003355172413793	289	G5AMB2	523	832	8.479490322580638	309
A2APB8	PF06886	541	588	0.0	47	G5BQZ9	459	506	0.0	47
A2APB8	PF06886	658	738	0.0	80	G5BQZ9	576	656	0.0	80
A2APB8	PF12214	365	488	0.0028064516129032253	123	G5BQZ9	282	405	0.0	123
Q9D0P5	PF00628	340	394	0.10089090909090907	54	G5B2Q0	342	396	0.15930909090909093	54
P97368	PF05920	282	289	0.1545	7	G5AV12	281	287	0.13242857142857142	6
P97368	PF16493	98	181	2.133059523809524	83	G5AV12	97	180	2.049142857142857	83
Q8BGB8	PF05019	38	258	5.056678733031674	220	G5ASF0	41	261	7.365972850678734	220
Q8K088	PF00096	325	346	2.3725909090909094	21	G5B6X5	327	348	1.5998636363636365	21
Q8K088	PF00096	352	374	0.028260869565217388	22	G5B6X5	354	376	0.02847826086956522	22
Q8K088	PF00651	22	124	3.594475728155337	102	G5B6X5	23	125	3.4369805825242725	102
Q8K088	PF12874	380	401	0.0	21	G5B6X5	382	403	0.0	21
Q61285	PF00005	496	637	0.02028169014084507	141	G5BHF8	495	636	0.03929577464788732	141
Q61285	PF06472	90	364	13.888549090909095	274	G5BHF8	90	364	13.791323636363632	274
Q9D6I3	PF00235	13	127	9.892486956521742	114	G5C385	14	82	16.68013043478261	68
P97429	PF00191	18	82	11.14252307692308	64	G5C6W2	18	82	1.2207384615384616	64
P97429	PF00191	89	154	1.587439393939394	65	G5C6W2	89	154	1.5876818181818182	65
P97429	PF00191	172	238	6.983089552238806	66	G5C6W2	172	238	11.028104477611942	66
P97429	PF00191	248	313	6.7186969696969685	65	G5C6W2	248	313	7.134939393939395	65
Q8C0L9	PF00686	16	69	3.5831296296296298	53	G5C214	1	53	5.067188679245284	52
Q8C0L9	PF03009	325	613	7.4944982698961935	288	G5C214	306	593	5.318163194444446	287
P08249	PF00056	78	167	9.543233333333333	89	G5BG62	78	193	12.212293103448275	115
P08249	PF02866	169	333	4.763775757575758	164	G5BG62	195	359	4.498606060606062	164
Q9CTY5	PF13833	443	494	16.143423076923074	51	G5B8E9	346	397	16.135596153846155	51
Q63870	PF00014	2878	2930	0.04330188679245283	52	G5AVL8	2769	2822	0.03037037037037038	53
Q63870	PF00041	234	317	8.331821428571429	83	G5AVL8	145	228	8.427476190476188	83
Q63870	PF00041	333	405	3.1617534246575336	72	G5AVL8	244	316	6.015972602739727	72
Q63870	PF00041	427	487	9.030262295081966	60	G5AVL8	338	398	11.88365573770492	60
Q63870	PF00041	688	759	0.5583055555555557	71	G5AVL8	599	670	1.2068472222222222	71
Q63870	PF00041	779	853	2.8806666666666665	74	G5AVL8	690	764	4.60112	74
Q63870	PF00041	872	945	7.760824324324325	73	G5AVL8	783	856	5.0571486486486465	73
Q63870	PF00041	960	1032	5.453054794520549	72	G5AVL8	871	943	6.286178082191781	72
Q63870	PF00092	89	205	8.903598290598293	116	G5AVL8	1	117	4.346641025641024	116
Q63870	PF00092	1054	1218	8.447963636363639	164	G5AVL8	965	1129	12.56730909090909	164
Q63870	PF01391	1254	1309	0.0	55	G5AVL8	2012	2066	0.0	54
Q63870	PF01391	1295	1351	0.0	56	G5AVL8	2478	2534	0.0	56
Q63870	PF01391	1452	1496	0.0	44	G5AVL8	1797	1839	0.0	42
Q63870	PF01391	1486	1533	0.0	47	G5AVL8	2373	2419	0.0	46
Q63870	PF01391	1645	1696	0.0	51	G5AVL8	1557	1607	0.0	50
Q63870	PF01391	1715	1771	0.0	56	G5AVL8	1630	1686	0.0	56
Q63870	PF01391	1874	1930	0.0	56	G5AVL8	1789	1845	0.0	56
Q63870	PF01391	1974	2014	0.0	40	G5AVL8	1889	1928	0.0	39
Q63870	PF01391	2024	2082	0.0	58	G5AVL8	1747	1807	0.0	60
Q63870	PF01391	2098	2156	0.0	58	G5AVL8	2006	2064	0.0	58
Q63870	PF01391	2149	2203	0.0	54	G5AVL8	2057	2110	0.0	53
Q63870	PF01391	2244	2304	0.03459016393442624	60	G5AVL8	2152	2212	0.032786885245901634	60
Q63870	PF01391	2314	2362	0.0	48	G5AVL8	2222	2270	0.0	48
Q63870	PF01391	2364	2421	0.0	57	G5AVL8	2272	2329	0.0	57
Q63870	PF01391	2397	2455	0.0	58	G5AVL8	2305	2363	0.0	58
Q63870	PF01391	2456	2511	0.0	55	G5AVL8	2364	2419	0.0	55
Q63870	PF01391	2517	2566	0.0	49	G5AVL8	2425	2473	0.0	48
Q63870	PF01391	2571	2622	0.0	51	G5AVL8	2473	2524	0.0	51
Q63870	PF01391	2613	2665	0.0	52	G5AVL8	2515	2567	0.0	52
Q63870	PF01391	2658	2709	0.0	51	G5AVL8	2560	2610	0.0	50
Q9D4V4	PF15333	30	242	0.056647887323943664	212	G5C3Y0	33	240	0.472576923076923	207
Q8BG48	PF00069	36	292	6.099937743190663	256	G5APK5	37	293	6.090420233463036	256
Q61033	PF11560	458	691	0.1647435897435898	233	G5B2K7	366	597	0.1207758620689656	231
Q61033	PF03020	109	148	0.0	39	G5B2K7	19	58	0.0	39
Q8BHS8	PF15290	216	509	0.11005102040816324	293	G5AVI9	210	495	0.09077272727272724	285
Q64338	PF00233	226	450	4.932768888888883	224	G5B2R9	197	421	4.926551111111113	224
Q64338	PF08499	81	141	3.446311475409836	60	G5B2R9	52	112	3.4427704918032784	60
Q8R367	PF00071	19	167	6.6831677852349	148	G5BV44	1	149	6.6137651006711415	148
Q9JK91	PF01119	215	333	7.218689075630254	118	G5BR58	216	334	7.236579831932771	118
Q9JK91	PF13589	28	130	2.935203883495142	102	G5BR58	29	131	3.2019126213592273	102
Q9JK91	PF16413	505	759	4.013792156862747	254	G5BR58	504	758	4.057562992125985	254
Q9JKK8	PF00454	2314	2554	3.063987551867218	240	G5AZ55	2323	2563	3.0300207468879683	240
Q9JKK8	PF02259	1766	2084	1.3419153605015663	318	G5AZ55	1775	2093	1.98903448275862	318
Q9JKK8	PF02260	2603	2634	0.6732812500000002	31	G5AZ55	2612	2643	0.6957096774193549	31
Q9JKK8	PF08064	1121	1221	11.055198019801981	100	G5AZ55	1124	1224	11.110019801980199	100
Q9JM05	PF02891	314	363	4.953379999999999	49	G5BZB7	461	510	4.93044	49
Q9JM05	PF14324	123	269	4.814020408163267	146	G5BZB7	226	416	2.1693717277486915	190
O08796	PF02816	137	316	2.8743444444444446	179	G5BV84	58	237	2.874566666666667	179
O08796	PF08238	526	560	0.0	34	G5BV84	447	481	0.0	34
O08796	PF08238	588	607	0.14614999999999995	19	G5BV84	509	528	0.145	19
O08796	PF08238	610	629	4.521300000000002	19	G5BV84	531	549	5.630789473684208	18
O08796	PF08238	671	694	0.0	23	G5BV84	867	889	0.25956521739130434	22
P08730	PF00038	94	405	0.09098717948717944	311	G5B0N0	83	394	0.6476826923076927	311
O35367	PF01462	42	70	0.0	28	G5BSJ4	42	70	6.896551724137931e-05	28
O35367	PF13516	281	297	0.017882352941176467	16	G5BSJ4	281	297	0.2257647058823529	16
O35367	PF13855	75	133	16.572762711864403	58	G5BSJ4	75	133	14.885779661016945	58
O35367	PF13855	142	204	0.0	62	G5BSJ4	142	204	0.0	62
Q8K015	PF09496	142	198	3.0757017543859653	56	G5CBJ7	145	201	8.60598245614035	56
Q9D3V5	PF15554	35	352	0.7990000000000004	317	G5BM63	78	388	1.16435691318328	310
Q9Z2C5	PF02893	36	142	0.4783551401869157	106	G5C9N9	17	123	0.2601028037383177	106
Q9Z2C5	PF06602	150	485	5.470985119047621	335	G5C9N9	131	463	4.491696696696698	332
Q8BZH4	PF03184	1155	1280	7.417611111111107	125	G5B8L9	1160	1285	6.186801587301588	125
Q8BZH4	PF03221	1021	1077	1.1288070175438596	56	G5B8L9	1026	1082	0.2349473684210527	56
Q9D0P8	PF00071	11	171	2.8598695652173918	160	G5BAW2	1	140	3.102707142857144	139
O08989	PF00071	63	175	7.072619469026548	112	G5BPK9	181	293	7.071823008849555	112
Q6NVE8	PF00400	510	539	0.3873	29	G5ARW7	508	537	0.3991	29
Q6NVE8	PF00400	600	634	1.3381142857142858	34	G5ARW7	598	632	1.3417428571428571	34
Q6NVE8	PF00400	640	677	13.706421052631582	37	G5ARW7	638	675	13.716263157894748	37
Q6NVE8	PF00400	791	815	30.91368	24	G5ARW7	789	813	31.708360000000006	24
Q60590	PF00061	42	146	9.606180952380953	104	G5B1Y7	24	127	14.379553398058254	103
Q9Z2D6	PF01429	95	158	5.301296875	63	G5C2R7	117	180	5.299703125	63
P70402	PF00041	77	161	0.12237647058823525	84	G5B368	88	172	5.9747999999999974	84
P70402	PF00041	274	349	6.501105263157897	75	G5B368	285	360	6.354710526315787	75
P70402	PF07679	191	265	4.4343866666666685	74	G5B368	202	276	4.892279999999999	74
P70402	PF07679	387	476	0.3352333333333333	89	G5B368	398	487	0.3501777777777778	89
Q8C0T5	PF02145	627	809	7.744065573770491	182	G5BQL1	243	425	7.747021857923497	182
Q8C0T5	PF11881	1482	1726	0.12490204081632655	244	G5BQL1	1157	1401	0.1271061224489796	244
Q3UNA4	PF02136	17	135	7.371100840336134	118	G5BSR2	45	163	5.774210084033611	118
O89032	PF00018	174	216	4.544767441860465	42	G5CAJ8	147	189	3.8961395348837207	42
O89032	PF00018	275	316	2.326952380952381	41	G5CAJ8	248	289	2.337523809523809	41
O89032	PF00018	461	497	6.472702702702702	36	G5CAJ8	431	467	6.457216216216216	36
O89032	PF00018	842	883	2.8168571428571427	41	G5CAJ8	815	856	3.910761904761904	41
O89032	PF00787	30	122	2.2807956989247318	92	G5CAJ8	7	99	1.0892258064516132	92
Q9CX56	PF10075	190	328	13.062359712230213	138	G5AMB7	123	261	12.527812949640296	138
Q8CGA4	PF15167	38	130	5.1792365591397855	92	G5BRM4	1	90	1.1916741573033711	89
P63002	PF03920	3	127	2.461423999999999	124	G5AKR1	25	148	2.541540322580645	123
Q8K3I9	PF15388	157	465	0.03655339805825244	308	G5BRZ0	14	323	0.03705806451612903	309
Q3UDE2	PF03133	343	626	6.417450704225352	283	G5BM83	483	766	9.200373239436626	283
Q9Z0E3	PF00628	300	342	0.0166046511627907	42	G5BG14	246	288	0.0166046511627907	42
Q9Z0E3	PF01342	204	246	0.5083720930232558	42	G5BG14	150	191	0.23119047619047625	41
Q9Z0E3	PF03172	58	102	24.93924444444444	44	G5BG14	4	48	10.220444444444443	44
Q9ERL7	PF00241	13	136	5.177935483870969	123	G5BJE3	18	141	5.70079838709677	123
Q8VDI7	PF00627	195	227	0.0	32	G5B6C1	150	182	0.0	32
Q8VDI7	PF00627	293	328	4.924833333333332	35	G5B6C1	244	279	4.889694444444444	35
Q1WG82	PF00320	196	230	0.0	34	G5B229	193	227	0.0	34
Q64702	PF00069	12	264	8.804790513833993	252	G5AKY5	275	527	9.797857707509882	252
Q64702	PF18190	553	657	5.1737714285714285	104	G5AKY5	844	948	4.451723809523811	104
Q64702	PF18409	659	736	0.34585897435897434	77	G5AKY5	950	1026	1.491064935064935	76
Q9D411	PF00069	24	292	7.767832713754648	268	G5B283	18	286	9.31109293680298	268
Q8BL86	PF00753	29	230	0.5278564356435644	201	G5BBF7	30	224	0.4948666666666669	194
Q3UR85	PF05224	393	538	8.925746575342457	145	G5AYF7	524	667	9.041083333333328	143
Q3UR85	PF13884	586	646	0.0	60	G5AYF7	715	775	1.266655737704918	60
Q3UR85	PF13887	666	701	4.580416666666666	35	G5AYF7	795	830	3.1855	35
Q3UR85	PF13888	1002	1136	6.6621703703703705	134	G5AYF7	1116	1237	1.5111311475409834	121
Q80YD1	PF00271	356	473	7.599211864406778	117	G5B182	359	476	6.219601694915253	117
Q80YD1	PF12513	624	670	18.764574468085105	46	G5B182	628	673	14.138586956521735	45
Q80YD1	PF18114	61	178	0.22246610169491526	117	G5B182	64	181	0.20856779661016944	117
Q80YD1	PF18147	557	597	0.9699024390243904	40	G5B182	561	601	0.9669024390243902	40
Q5SU73	PF15862	6	189	5.772782608695655	183	G5C5I9	7	191	6.611464864864867	184
Q61687	PF00176	1554	1872	5.792037617554857	318	G5C0I5	1556	1874	5.796739811912223	318
Q61687	PF00271	2004	2137	7.699514925373127	133	G5C0I5	2009	2142	7.02713432835821	133
Q61687	PF17981	156	211	0.03714285714285714	55	G5C0I5	151	206	0.8126607142857142	55
Q9Z1Y4	PF00412	282	337	9.880678571428572	55	G5AV50	277	332	10.45610714285714	55
Q9Z1Y4	PF00412	342	398	2.5374035087719298	56	G5AV50	337	393	2.5164912280701754	56
Q9Z1Y4	PF00412	402	464	0.067	62	G5AV50	397	459	0.06690476190476187	62
P12672	PF10579	0	79	5.2835125000000005	79	G5BPD0	1	80	5.4833750000000006	79
P12672	PF13639	362	402	0.0	40	G5BPD0	363	403	0.0	40
P12672	PF17874	139	317	2.125441340782123	178	G5BPD0	140	318	2.6150726256983243	178
Q64336	PF00907	205	392	3.294574468085105	187	G5BT33	206	407	4.065653465346536	201
Q64336	PF16176	417	483	0.11823880597014927	66	G5BT33	432	497	0.11909090909090912	65
P97401	PF01392	49	140	7.666152173913043	91	G5BLU2	1	92	8.372228260869566	91
P97401	PF01759	191	288	1.110255102040816	97	G5BLU2	143	240	0.9968673469387758	97
Q9CZD5	PF00707	154	234	0.39223456790123457	80	G5ATV2	158	238	1.6570617283950615	80
Q9CZD5	PF05198	76	142	0.0980597014925373	66	G5ATV2	80	146	0.04029850746268657	66
P43135	PF00104	199	385	11.007374331550801	186	G5AT97	57	243	11.213486631016039	186
Q8BQS4	PF10358	14	117	0.3379423076923077	103	G5BQU5	1	104	0.33110576923076923	103
Q3TTA7	PF02262	41	166	1.0886349206349204	125	G5BA59	42	167	1.0869444444444447	125
Q3TTA7	PF02761	170	253	1.7615714285714286	83	G5BA59	171	254	2.0962380952380952	83
Q3TTA7	PF02762	255	340	5.484558139534885	85	G5BA59	256	341	5.206348837209303	85
Q3TTA7	PF14447	372	419	0.08479166666666665	47	G5BA59	373	420	0.08479166666666665	47
Q9Z1D9	PF00096	326	348	0.0	22	G5AX95	324	346	0.0	22
Q9Z1D9	PF00096	354	376	0.0382608695652174	22	G5AX95	352	374	0.035869565217391305	22
Q9Z1D9	PF00096	382	404	0.0	22	G5AX95	380	402	0.0	22
Q9Z1D9	PF00096	437	459	0.0	22	G5AX95	324	346	0.0	22
Q9Z1D9	PF00096	465	487	1.2959130434782609	22	G5AX95	462	484	0.026086956521739132	22
Q9Z1D9	PF00096	493	515	0.0	22	G5AX95	490	512	0.0	22
Q9Z1D9	PF01352	140	161	0.0	21	G5AX95	129	150	0.10068181818181818	21
Q9Z1D9	PF02023	39	116	0.13594871794871788	77	G5AX95	39	115	0.11409090909090908	76
Q03347	PF00853	51	142	3.8382282608695655	91	G5AM15	28	118	3.910406593406593	90
Q03347	PF08504	360	450	0.06658241758241758	90	G5AM15	407	498	0.059384615384615376	91
Q8QZY9	PF00076	14	84	0.4372535211267606	70	G5BH25	15	85	0.3252816901408451	70
Q8QZY9	PF00076	101	171	11.879323943661973	70	G5BH25	102	172	11.976563380281695	70
P28667	PF02063	22	42	0.0	20	G5B5L6	79	99	0.0	20
P28667	PF02063	55	197	0.0	142	G5B5L6	112	254	0.0	142
Q5U5V2	PF01636	36	289	5.625665354330711	253	G5AUK4	37	290	6.431842519685037	253
Q99PI4	PF04571	0	106	0.7402429906542057	106	G5BCX5	17	123	1.382121495327103	106
Q99PI4	PF08235	588	813	3.610884955752216	225	G5BCX5	765	990	3.5067035398230098	225
Q99PI4	PF16876	434	527	0.3933297872340424	93	G5BCX5	611	704	2.8968085106382966	93
Q07409	PF13927	60	103	2.299522727272727	43	G5ALQ7	54	97	2.6346818181818183	43
Q07409	PF13927	226	300	0.0	74	G5ALQ7	220	294	0.028906666666666664	74
Q07409	PF13927	501	578	8.753051282051281	77	G5ALQ7	495	572	8.546756410256416	77
Q07409	PF00041	599	686	2.4991136363636364	87	G5ALQ7	593	680	0.315659090909091	87
Q07409	PF00041	804	890	1.3107011494252874	86	G5ALQ7	798	884	0.7167586206896551	86
Q07409	PF00041	905	985	0.7397530864197535	80	G5ALQ7	899	979	0.756925925925926	80
Q07409	PF07679	320	402	1.1421807228915657	82	G5ALQ7	314	396	1.1439879518072291	82
Q07409	PF07679	408	495	4.887034090909089	87	G5ALQ7	402	489	5.013988636363637	87
Q8VEA8	PF00071	9	169	3.7361118012422376	160	G5BX52	10	170	3.6111055900621096	160
Q9D6Z1	PF01798	173	404	0.3800172413793101	231	G5B4R9	174	405	0.3940431034482757	231
Q9D6Z1	PF08156	4	69	12.567121212121213	65	G5B4R9	5	70	11.270727272727274	65
Q6NZP1	PF00176	54	277	6.8205089285714315	223	G5AMN3	55	278	5.927000000000002	223
Q6NZP1	PF00271	330	434	5.173561904761903	104	G5AMN3	331	435	5.198390476190472	104
Q6NZP1	PF01844	1000	1039	0.08287499999999999	39	G5AMN3	1009	1048	0.08262499999999999	39
P24527	PF01433	239	439	6.614567164179107	200	G5C0S8	240	440	5.194054726368157	200
P24527	PF09127	495	607	2.282123893805309	112	G5C0S8	496	608	1.2008761061946904	112
P24527	PF17900	19	201	4.798907103825137	182	G5C0S8	20	202	5.378901639344262	182
Q5NCY3	PF00173	20	75	17.07475	55	G5B5E3	21	76	10.2375	55
Q8CDG1	PF02170	388	520	4.111428571428573	132	G5B9Q3	389	521	4.900729323308269	132
Q8CDG1	PF02171	666	954	7.783737024221457	288	G5B9Q3	667	955	7.9043425605536335	288
Q8CDG1	PF08699	336	382	4.2357872340425535	46	G5B9Q3	337	383	9.724489361702128	46
Q9QUS6	PF00041	409	490	8.246780487804878	81	G5C010	409	522	4.777614035087719	113
Q9QUS6	PF00622	560	672	7.375876106194687	112	G5C010	592	704	7.389070796460191	112
Q9QUS6	PF00643	192	230	2.458153846153846	38	G5C010	192	230	2.455307692307692	38
Q9QUS6	PF13445	29	76	0.03114583333333333	47	G5C010	29	76	0.0	47
Q9QUS6	PF18568	342	393	0.19042307692307692	51	G5C010	342	393	0.19063461538461532	51
Q80Y56	PF01363	151	257	0.007429906542056075	106	G5ANT3	153	259	4.661850467289719	106
Q80Y56	PF11464	456	497	2.259809523809524	41	G5ANT3	550	591	0.0	41
Q80Y56	PF11464	737	775	0.3079230769230769	38	G5ANT3	814	852	0.0548974358974359	38
Q80Y56	PF16601	547	735	0.0	188	G5ANT3	639	812	0.9806954022988508	173
Q8C190	PF02204	529	641	7.8889026548672545	112	G5APH7	532	644	7.935575221238936	112
Q80YE7	PF00069	95	274	6.26687777777778	179	G5ARM1	216	386	0.8767777777777771	170
Q80YE7	PF00531	1309	1394	6.7848953488372095	85	G5ARM1	1477	1562	6.884244186046513	85
Q80YE7	PF12796	439	507	0.9788985507246376	68	G5ARM1	551	619	0.9772608695652176	68
Q80YE7	PF12796	547	636	7.085444444444443	89	G5ARM1	669	758	4.577955555555556	89
Q80YE7	PF13637	389	430	1.6762619047619038	41	G5ARM1	501	542	2.7948809523809537	41
Q8BKT3	PF07842	456	669	2.0280887850467293	213	G5AKE0	463	677	4.196153488372094	214
O55087	PF00319	9	56	12.096916666666667	47	G5C5C1	10	57	12.1150625	47
Q00612	PF00479	34	209	7.886494318181814	175	G5BFL5	35	209	7.989839999999997	174
Q00612	PF02781	211	502	6.835520547945207	291	G5BFL5	211	502	6.946150684931508	291
Q6P7W2	PF02214	20	105	1.2694534883720934	85	G5C9X4	2	87	1.2674418604651163	85
Q7TPV2	PF13639	1143	1183	0.0	40	G5APD4	1148	1188	0.0	40
Q7TPV2	PF18738	421	558	5.1091159420289864	137	G5APD4	421	558	5.111557971014493	137
Q7TPV2	PF19179	228	335	2.451268518518518	107	G5APD4	228	335	3.3867962962962963	107
Q3V096	PF12796	63	155	1.656892473118279	92	G5APJ5	30	120	0.4948131868131868	90
Q3V096	PF12796	163	247	0.2463647058823528	84	G5APJ5	128	212	1.5835411764705885	84
Q3V096	PF13637	268	317	0.21704000000000004	49	G5APJ5	233	282	0.6407200000000001	49
Q0VBM2	PF07894	14	280	6.216101123595504	266	G5C2E5	15	280	6.153988721804513	265
Q8C9V1	PF00566	93	290	10.712055555555542	197	G5BSA9	96	274	11.910240223463695	178
Q9CQ62	PF13561	68	301	5.627064102564101	233	G5BBP0	19	252	6.06104700854701	233
Q80ZW0	PF00069	206	526	7.072227414330215	320	G5BEP6	112	432	7.064959501557633	320
Q9DC50	PF00755	19	436	3.8865430622009565	417	G5AJW8	20	436	4.399940047961632	416
Q9D3F7	PF07809	101	219	2.291924369747899	118	G5C2I2	101	219	2.2727815126050417	118
Q3V3I2	PF00503	13	342	7.370951515151519	329	G5BVU6	14	343	6.249687878787878	329
Q3TTI8	PF15046	79	301	1.304627802690583	222	G5AS17	1	216	2.2048604651162784	215
Q3TD16	PF13901	435	632	0.6527171717171716	197	G5C1E8	454	651	1.9259090909090903	197
Q9WVF7	PF00136	713	1144	1.9158356481481464	431	G5ANV9	729	1160	1.8774259259259236	431
Q9WVF7	PF03104	86	425	2.431958823529411	339	G5ANV9	87	426	2.9256911764705884	339
Q9WVF7	PF08490	1543	1923	4.653461942257219	380	G5ANV9	1560	1939	5.4877552631578945	379
Q3TCV3	PF14959	645	752	6.345481481481483	107	G5AJU6	614	721	7.378268518518519	107
Q3UUI3	PF03061	139	209	12.947169014084508	70	G5B8K4	116	187	7.0085000000000015	71
Q8VIJ8	PF03666	63	102	19.967550000000006	39	G5BXY6	100	139	17.263925000000008	39
Q8VIJ8	PF03666	111	415	11.284114754098356	304	G5BXY6	148	452	11.296196721311475	304
Q9JI33	PF00053	261	317	0.08449122807017544	56	G5C0T3	306	362	0.027438596491228068	56
Q9JI33	PF00053	331	382	0.0	51	G5C0T3	376	427	0.13330769230769232	51
Q9JI33	PF00053	394	445	2.1795384615384616	51	G5C0T3	439	490	2.8002115384615385	51
Q9JI33	PF00055	33	259	5.609392070484585	226	G5C0T3	34	304	5.245346863468635	270
Q9JI33	PF01759	517	619	0.10174757281553398	102	G5C0T3	562	664	0.3479611650485436	102
Q8CII2	PF07065	41	313	3.2461904761904794	272	G5BE24	72	344	3.0547216117216123	272
P33174	PF00225	97	336	5.119470833333332	239	G5BIY7	1	170	7.2338470588235255	169
Q810L3	PF00498	37	104	5.7685	67	G5ANV3	31	98	7.252676470588236	67
Q810L3	PF10283	631	654	0.0	23	G5ANV3	541	564	0.0	23
Q810L3	PF13923	302	340	0.5563333333333332	38	G5ANV3	295	333	0.4113333333333333	38
Q810L3	PF17979	468	509	0.059333333333333335	41	G5ANV3	459	499	0.0508780487804878	40
Q8BWG8	PF00339	18	173	4.6886346153846175	155	G5AS77	19	174	4.633692307692308	155
Q8BWG8	PF02752	193	354	3.75220987654321	161	G5AS77	194	355	3.75220987654321	161
Q91ZG2	PF00149	90	286	1.4835989847715736	196	G5BM85	91	287	1.4835989847715736	196
Q64249	PF00105	73	141	0.06434782608695652	68	G5B6W5	13	81	0.05508695652173914	68
Q64249	PF00104	301	467	10.02636526946108	166	G5B6W5	240	406	9.711808383233533	166
Q9JI75	PF02525	3	179	4.117915254237289	176	G5BKE9	8	181	4.220609195402302	173
Q8VEE1	PF00412	261	301	11.791048780487804	40	G5BXA0	248	288	12.116682926829268	40
Q8VEE1	PF00412	307	360	0.28824074074074074	53	G5BXA0	294	347	0.2887962962962963	53
Q8VEE1	PF06297	116	199	0.0	83	G5BXA0	103	186	0.0	83
A2AVA0	PF00008	1199	1223	0.0444	24	G5C092	1148	1172	0.0	24
A2AVA0	PF00008	1233	1261	0.0	28	G5C092	1144	1172	0.0	28
A2AVA0	PF00008	1347	1376	0.0	29	G5C092	1258	1287	0.0	29
A2AVA0	PF00008	1385	1415	0.0	30	G5C092	1296	1326	0.0	30
A2AVA0	PF00008	3501	3524	0.0	23	G5C092	1147	1172	0.0	25
A2AVA0	PF00084	384	433	0.058099999999999985	49	G5C092	2632	2679	0.03697916666666667	47
A2AVA0	PF00084	438	493	1.3225178571428573	55	G5C092	380	435	0.0	55
A2AVA0	PF00084	513	553	0.9118780487804878	40	G5C092	455	495	0.8525121951219513	40
A2AVA0	PF00084	1626	1683	0.4698275862068967	57	G5C092	1537	1594	0.4485344827586206	57
A2AVA0	PF00084	1688	1741	0.23914814814814814	53	G5C092	1599	1652	0.22166666666666668	53
A2AVA0	PF00084	1787	1840	7.446000000000002	53	G5C092	1698	1751	0.0	53
A2AVA0	PF00084	1845	1898	0.0	53	G5C092	1756	1809	0.013981481481481482	53
A2AVA0	PF00084	1903	1956	6.866999999999997	53	G5C092	1814	1867	5.474222222222222	53
A2AVA0	PF00084	1961	2014	0.8282592592592594	53	G5C092	1872	1925	0.4706111111111112	53
A2AVA0	PF00084	2019	2076	0.4592586206896551	57	G5C092	1930	1987	3.4756034482758618	57
A2AVA0	PF00084	2081	2134	0.7086666666666667	53	G5C092	1992	2045	0.7089259259259261	53
A2AVA0	PF00084	2144	2197	6.669648148148147	53	G5C092	2055	2108	1.2907777777777776	53
A2AVA0	PF00084	2202	2257	0.2525892857142857	55	G5C092	2113	2168	0.253125	55
A2AVA0	PF00084	2262	2316	0.3641636363636364	54	G5C092	2173	2227	0.4427090909090911	54
A2AVA0	PF00084	2342	2374	0.9098787878787876	32	G5C092	2253	2285	2.8801818181818177	32
A2AVA0	PF00084	2379	2433	1.0532727272727271	54	G5C092	2290	2344	0.10685454545454544	54
A2AVA0	PF00084	2438	2491	2.7685740740740736	53	G5C092	2349	2402	2.702796296296296	53
A2AVA0	PF00084	2496	2549	2.582351851851852	53	G5C092	2407	2460	0.028425925925925924	53
A2AVA0	PF00084	2554	2606	3.671641509433964	52	G5C092	2465	2517	15.71141509433962	52
A2AVA0	PF00084	2669	2708	3.6201250000000007	39	G5C092	2582	2621	20.7904	39
A2AVA0	PF00084	2713	2766	0.0	53	G5C092	2626	2679	0.03287037037037037	53
A2AVA0	PF00084	2771	2824	6.26212962962963	53	G5C092	2684	2737	6.613981481481483	53
A2AVA0	PF00084	2829	2882	0.0362962962962963	53	G5C092	2742	2795	0.0	53
A2AVA0	PF00084	2887	2940	0.06377777777777778	53	G5C092	2800	2853	0.1973148148148148	53
A2AVA0	PF00084	2945	2998	0.04148148148148148	53	G5C092	2858	2911	0.04074074074074074	53
A2AVA0	PF00084	3003	3050	0.034166666666666665	47	G5C092	2916	2962	0.0	46
A2AVA0	PF00084	3059	3112	0.8108703703703702	53	G5C092	2973	3026	0.7973518518518516	53
A2AVA0	PF00084	3117	3171	0.08590909090909091	54	G5C092	3031	3085	0.8916727272727273	54
A2AVA0	PF00084	3176	3227	0.011057692307692308	51	G5C092	3090	3141	0.07325000000000002	51
A2AVA0	PF00084	3236	3289	0.6836481481481479	53	G5C092	3150	3203	0.38790740740740737	53
A2AVA0	PF00084	3294	3347	0.08296296296296296	53	G5C092	3208	3261	2.694351851851852	53
A2AVA0	PF00084	3352	3406	0.013454545454545457	54	G5C092	3266	3320	0.013363636363636364	54
A2AVA0	PF00084	3411	3463	0.429264150943396	52	G5C092	3325	3377	0.034150943396226416	52
A2AVA0	PF00092	84	255	8.540546511627907	171	G5C092	86	257	8.740133720930238	171
A2AVA0	PF00354	1442	1618	5.038807909604516	176	G5C092	1353	1529	7.967785310734463	176
A2AVA0	PF02494	559	641	3.4137590361445778	82	G5C092	501	583	1.128457831325301	82
A2AVA0	PF02494	643	720	6.738141025641025	77	G5C092	585	662	5.93471794871795	77
A2AVA0	PF07645	1305	1336	0.0	31	G5C092	1216	1247	0.055	31
A2AVA0	PF07645	1743	1781	0.0	38	G5C092	1654	1692	0.0	38
A2AVA0	PF07699	310	360	0.0	50	G5C092	312	362	0.0	50
A2AVA0	PF07699	1003	1050	0.0	47	G5C092	945	992	0.0349375	47
A2AVA0	PF07699	1057	1104	0.0	47	G5C092	999	1046	0.0	47
A2AVA0	PF07699	1111	1158	0.16641666666666668	47	G5C092	1053	1100	0.168875	47
A2AVA0	PF12661	1276	1297	0.0	21	G5C092	1187	1208	0.0	21
A3KG59	PF01546	150	199	5.48772	49	G5AZM2	1	50	3.8504199999999993	49
A3KG59	PF07687	200	292	10.60613978494624	92	G5AZM2	51	143	6.2254516129032265	92
Q6PAC4	PF15449	0	1029	1.0531776699029118	1029	G5C2X9	1	1019	1.3622561334641805	1018
Q3TV65	PF01398	257	355	13.458424242424245	98	G5BZA4	253	351	7.851242424242423	98
Q3TV65	PF18755	72	156	7.779611764705884	84	G5BZA4	64	148	6.314552941176469	84
Q8R180	PF04137	76	451	4.4011170212766	375	G5BLP4	15	390	4.545175531914891	375
O70250	PF00300	5	127	4.28050406504065	122	G5ASR0	6	128	2.9346666666666663	122
O70250	PF00300	145	211	1.0384328358208954	66	G5ASR0	146	212	0.4752238805970149	66
O35648	PF13499	27	89	0.04204761904761905	62	G5BBF8	23	85	0.042238095238095234	62
O35648	PF13499	100	162	1.7943015873015873	62	G5BBF8	96	158	1.884809523809524	62
Q922Y0	PF00069	207	520	1.8300222929936312	313	G5BP23	212	525	1.6625764331210198	313
P21126	PF00240	15	72	0.3714655172413792	57	G5BFL3	1	58	0.20393103448275854	57
P21126	PF17840	95	140	0.3740434782608695	45	G5BFL3	81	125	0.324	44
Q8BP56	PF03632	286	493	7.04902884615384	207	G5C471	288	529	6.625491735537193	241
Q6PGH4	PF15258	33	152	2.318025	119	G5BDR2	34	154	2.30195867768595	120
Q8C739	PF14160	249	356	0.7048240740740739	107	G5BX38	251	358	0.7046203703703705	107
Q8C739	PF14161	13	116	0.011711538461538459	103	G5BX38	14	117	0.01275	103
Q8BHI4	PF00651	37	143	12.645831775700927	106	G5BA77	42	148	14.401130841121494	106
Q8BHI4	PF01344	538	581	1.8232500000000005	43	G5BA77	543	586	1.8227954545454543	43
Q8BHI4	PF07707	149	249	5.856792079207921	100	G5BA77	154	253	4.698009999999999	99
Q8BHI4	PF13964	387	437	1.063078431372549	50	G5BA77	392	442	1.0614705882352942	50
O55057	PF05351	17	148	0.9284318181818184	131	G5ASV0	1	132	0.9307307692307693	131
Q9Z2V4	PF00821	259	618	1.1400472222222218	359	G5AUM7	260	619	1.1877138888888892	359
Q9Z2V4	PF17297	28	255	1.60701754385965	227	G5AUM7	29	256	1.653662280701755	227
Q9D5U9	PF12130	531	664	1.2234029850746269	133	G5C7T5	388	521	1.246447761194029	133
Q8R1J3	PF00098	128	143	0.29868750000000005	15	G5BK71	129	144	0.14175	15
Q8R1J3	PF00098	184	199	0.07625	15	G5BK71	185	200	0.07593749999999999	15
Q99KR7	PF00160	58	202	2.7716620689655165	144	G5BRK1	55	199	2.4670896551724133	144
P55095	PF00123	52	79	2.064714285714285	27	G5AKB5	53	80	2.091821428571429	27
P55095	PF00123	97	123	20.76392592592593	26	G5AKB5	98	124	20.771148148148146	26
P55095	PF00123	145	171	16.432111111111116	26	G5AKB5	146	172	16.697925925925926	26
Q62465	PF13602	245	397	2.6508300653594774	152	G5BN93	120	319	1.46375	199
Q715T0	PF00085	22	102	6.451827160493827	80	G5B3V6	1	57	4.43178947368421	56
Q715T0	PF00334	156	230	9.042400000000002	74	G5B3V6	106	179	13.84598648648649	73
Q715T0	PF00334	312	447	3.2806691176470584	135	G5B3V6	252	350	0.11602020202020202	98
Q715T0	PF00334	447	580	8.074365671641791	133	G5B3V6	350	482	4.38263157894737	132
P59708	PF00076	20	86	7.4943134328358205	66	G5C384	19	85	8.978716417910448	66
Q8K4R9	PF03359	386	546	0.0	160	G5BF75	401	561	0.3348074534161492	160
Q91Z61	PF00071	19	164	5.021465753424657	145	G5BZC4	20	165	5.687876712328767	145
P47867	PF15467	19	470	3.2807942477876098	451	G5C9D9	18	469	2.7536718403547664	451
Q8BJ71	PF04097	215	802	10.004061224489798	587	G5BR77	216	803	9.788593537414958	587
Q9WTX2	PF00035	34	98	0.6788615384615384	64	G5B0U5	18	82	0.6762923076923077	64
Q9WTX2	PF00035	126	190	0.02623076923076923	64	G5B0U5	110	174	0.02615384615384616	64
Q9WTX2	PF16482	241	305	0.2728615384615385	64	G5B0U5	225	289	0.2585384615384617	64
P09813	PF04711	23	97	3.4355466666666667	74	G5BWH8	24	99	0.3811578947368422	75
Q8BGI5	PF07163	0	300	7.335767441860466	300	G5BWP0	262	557	8.579804054054051	295
Q91W40	PF13424	246	322	13.910870129870132	76	G5BKU2	260	336	13.896727272727272	76
Q91W40	PF13424	334	401	0.6038382352941174	67	G5BKU2	348	415	0.6102205882352939	67
Q69ZC8	PF12572	209	337	0.0	128	G5C910	223	351	0.007015503875968994	128
Q9CQD4	PF03357	35	169	0.15722222222222226	134	G5BQF0	1	135	0.2147851851851852	134
Q3TMH2	PF03577	90	229	2.5502928571428574	139	G5C939	90	231	1.557739436619718	141
Q3UZ01	PF00076	28	94	0.11135820895522387	66	G5AZM5	29	95	0.13880597014925375	66
Q3UZ01	PF00076	419	493	1.5359733333333332	74	G5AZM5	422	496	1.53584	74
Q922M7	PF15323	13	231	2.423949771689498	218	G5CB78	14	232	2.9787201834862387	218
Q8CHP6	PF00536	915	978	7.86096875	63	G5AXZ5	792	855	8.11608064516129	63
Q9EST4	PF09754	96	225	4.74290769230769	129	G5C081	20	149	6.4261692307692275	129
Q920Q2	PF16727	1164	1245	3.3039390243902447	81	G5BMS3	1168	1249	3.103451219512196	81
Q920Q2	PF00817	419	619	3.2523084577114423	200	G5BMS3	420	620	3.0707611940298505	200
Q920Q2	PF11799	699	826	0.1891640625	127	G5BMS3	700	826	0.02474015748031497	126
Q920Q2	PF14377	932	953	0.0	21	G5BMS3	933	954	0.0	21
Q920Q2	PF14377	1011	1040	0.0	29	G5BMS3	1012	1041	0.0254	29
Q920Q2	PF16589	45	128	9.68746428571428	83	G5BMS3	45	128	9.242869047619047	83
Q8K1K4	PF07778	118	515	13.027864321608037	397	G5C2S1	2	401	11.8079925	399
Q80YU0	PF00561	174	293	9.130525000000006	119	G5C8B6	40	159	15.590008333333335	119
Q9Z1N5	PF00270	69	234	9.91393373493976	165	G5C3D8	70	246	11.974666666666673	176
Q9Z1N5	PF00271	273	381	11.105082568807344	108	G5C3D8	285	393	11.110467889908257	108
Q9D6R2	PF00180	32	357	2.780515337423312	325	G5AUL0	33	358	2.861843558282209	325
Q8CI78	PF02582	226	403	6.494679775280902	177	G5C0E5	227	404	5.9716348314606735	177
O54834	PF00620	412	570	12.16308176100629	158	G5BRL5	239	397	12.079352201257866	158
P08121	PF00093	32	88	0.0	56	G5BZG7	34	90	0.0	56
P08121	PF01391	292	350	0.0	58	G5BZG7	268	326	0.0	58
P08121	PF01391	538	590	0.0	52	G5BZG7	700	752	0.0	52
P08121	PF01391	1075	1133	0.0	58	G5BZG7	903	961	0.0	58
P08121	PF01391	1135	1193	0.0	58	G5BZG7	963	1021	0.0	58
P08121	PF01410	1228	1462	2.199217021276596	234	G5BZG7	1057	1291	1.3281829787234043	234
Q8BMP6	PF00887	93	165	2.631246575342466	72	G5BAN8	4	76	1.2016438356164385	72
Q8BMP6	PF13897	393	523	1.3562748091603056	130	G5BAN8	304	434	1.4165725190839702	130
Q8C5R2	PF15385	438	468	0.5338387096774193	30	G5B6T6	439	469	0.5326451612903226	30
G3X9C2	PF04300	103	261	2.936314465408805	158	G5AM92	56	240	2.2276270270270264	184
P27664	PF00233	557	801	11.76776734693878	244	G5C3A0	558	802	11.767444897959194	244
P27664	PF01590	79	217	7.747294964028776	138	G5C3A0	80	218	6.174647482014388	138
P27664	PF01590	253	429	8.465474576271184	176	G5C3A0	254	430	9.033875706214694	176
O70176	PF00123	85	108	0.0	23	G5BTT1	1	24	0.3164583333333333	23
O70176	PF00123	130	154	1.3794399999999998	24	G5BTT1	46	70	1.7366	24
Q9CR80	PF08555	2	74	0.0	72	G5C2V6	3	74	0.0	71
Q9ERT9	PF05395	4	141	0.7200434782608693	137	G5BID0	5	142	0.7177536231884056	137
O88700	PF00270	678	845	3.3197440476190474	167	G5B1S9	661	828	3.1557321428571417	167
O88700	PF08072	376	415	0.015375000000000003	39	G5B1S9	370	409	0.0	39
O88700	PF16202	0	370	0.9597304582210244	370	G5B1S9	1	364	0.346054945054945	363
O88700	PF16204	429	654	0.03833185840707965	225	G5B1S9	423	637	0.3045488372093023	214
Q76MZ3	PF02985	282	312	0.0	30	G5B3C5	399	429	0.0	30
Q76MZ3	PF13646	174	259	0.023488372093023256	85	G5B3C5	291	376	0.023488372093023256	85
Q76MZ3	PF13646	365	466	4.633323529411765	101	G5B3C5	482	583	4.636490196078432	101
Q3UQN2	PF00611	24	87	0.0	63	G5B215	1	64	0.13428125	63
Q3UQN2	PF10291	542	806	2.5266264150943387	264	G5B215	452	716	2.104456603773585	264
Q02384	PF00125	60	167	8.034611111111111	107	G5BLM6	1	108	8.035499999999997	107
Q02384	PF00169	446	542	4.7206597938144315	96	G5BLM6	386	482	4.6558144329896916	96
Q02384	PF00617	781	960	12.374150000000007	179	G5BLM6	721	900	12.287727777777775	179
Q02384	PF00618	599	715	1.784205128205128	116	G5BLM6	539	655	3.202965811965813	116
Q02384	PF00621	209	385	0.8792824858757059	176	G5BLM6	149	325	0.7875197740112997	176
Q3UMR0	PF00023	564	591	0.0	27	G5BL34	567	593	0.06351851851851853	26
Q3UMR0	PF02204	325	363	0.09297435897435902	38	G5BL34	328	366	0.027846153846153847	38
Q3UMR0	PF12796	466	552	10.815804597701149	86	G5BL34	469	555	10.11645977011494	86
Q3UMR0	PF12796	779	869	7.561340659340661	90	G5BL34	782	872	6.222384615384617	90
Q3UMR0	PF13857	731	766	0.059277777777777776	35	G5BL34	734	769	0.04583333333333333	35
Q32M02	PF06268	20	132	1.47004424778761	112	G5BJ64	21	133	0.9404867256637168	112
Q32M02	PF06268	141	253	5.566159292035396	112	G5BJ64	142	254	5.2592477876106205	112
Q32M02	PF06268	265	370	3.6621603773584903	105	G5BJ64	266	370	3.4576761904761897	104
Q32M02	PF06268	389	491	0.2060970873786407	102	G5BJ64	417	519	0.226450980392157	102
Q3U0K8	PF10637	261	542	5.005393617021281	281	G5BMR8	262	541	4.551953571428572	279
Q3U0K8	PF13661	140	236	7.961721649484537	96	G5BMR8	141	237	7.593474226804126	96
Q8BZ09	PF00153	29	100	2.7017083333333343	71	G5C2Q4	1	72	1.8551111111111105	71
Q8BZ09	PF00153	112	196	12.298435294117649	84	G5C2Q4	84	168	12.531882352941176	84
Q8BZ09	PF00153	203	295	9.550559139784946	92	G5C2Q4	175	267	11.861559139784935	92
P15037	PF00178	362	441	1.5869499999999996	79	G5AXI5	365	444	1.5366625000000005	79
P15037	PF02198	87	168	7.1647926829268265	81	G5AXI5	88	169	7.309268292682924	81
Q99NF3	PF00581	173	254	6.307853658536586	81	G5BH73	163	244	6.266804878048783	81
Q8C0P0	PF00069	59	182	7.849137096774192	123	G5AUW5	124	247	7.943403225806452	123
Q8C0P0	PF00069	723	820	7.969867346938768	97	G5AUW5	800	859	0.9473333333333334	59
P09025	PF00046	149	205	0.01719298245614035	56	G5BIE3	150	206	0.01719298245614035	56
Q8R3T5	PF00957	156	203	0.17293750000000005	47	G5C1T6	77	123	0.17627659574468085	46
Q8R3T5	PF15277	80	131	4.00975	51	G5C1T6	1	52	4.004076923076924	51
Q9WVG6	PF06325	215	257	0.7773255813953488	42	G5C7C7	34	80	0.3062978723404255	46
Q61120	PF00017	378	449	0.9467361111111112	71	G5BJM3	376	447	0.9473333333333336	71
Q61120	PF00640	34	189	6.717493589743589	155	G5BJM3	35	187	6.013594771241829	152
Q923Z4	PF00010	103	154	16.435807692307698	51	G5BZJ1	108	159	17.044749999999997	51
Q9ESN9	PF16471	415	484	0.07102857142857144	69	G5BY69	410	479	0.07078571428571429	69
Q9ESN9	PF09744	28	183	1.7710961538461525	155	G5BY69	29	184	1.767647435897435	155
Q9ESN9	PF19056	965	1171	8.18487922705315	206	G5BY69	960	1195	6.7662796610169575	235
Q9CVB6	PF04045	56	282	8.051	226	G5AZJ5	57	297	8.33670539419087	240
Q8CIG0	PF00610	26	105	0.04625	79	G5BSQ7	27	106	0.007249999999999999	79
Q8BK63	PF00069	16	234	7.15624200913242	218	G5C3A3	17	263	6.338125506072875	246
P62696	PF00030	17	99	0.3173734939759036	82	G5BGN1	18	100	2.235686746987952	82
P62696	PF00030	107	189	0.24226506024096384	82	G5BGN1	108	190	0.22865060240963855	82
Q8VI84	PF03914	553	706	0.4920194805194805	153	G5AJU1	592	745	0.2794675324675325	153
Q8VI84	PF07540	212	306	10.299410526315793	94	G5AJU1	251	345	9.264115789473683	94
P70353	PF00125	22	104	8.584120481927709	82	G5AQK1	23	105	8.692168674698795	82
P54099	PF00476	742	1160	3.6035799522672978	418	G5CA92	740	1157	3.6810143540669817	417
P54099	PF18136	103	396	1.088632653061224	293	G5CA92	107	394	0.8416597222222226	287
Q9D0F1	PF03801	57	201	13.309489655172415	144	G5CAX6	58	202	12.726613793103446	144
Q9D0F1	PF18077	212	284	0.0	72	G5CAX6	213	285	0.18717808219178084	72
Q9D9V3	PF00378	77	302	4.4660265486725645	225	G5C4S3	62	287	4.163588495575222	225
P63075	PF00167	52	174	3.1494552845528454	122	G5B9P3	30	152	3.1590650406504066	122
Q6PCM1	PF02373	1156	1265	3.468754545454545	109	G5AQ12	1153	1265	3.3714955752212385	112
Q70IV5	PF00038	269	313	1.2578888888888888	44	G5ARY1	22	65	1.2165909090909093	43
Q8BMS4	PF13489	129	302	6.115390804597699	173	G5BJN9	71	244	5.9786954022988485	173
Q8BG41	PF00227	46	226	3.720453038674037	180	G5ASK1	47	227	3.839226519337015	180
O08688	PF00648	26	339	3.886073248407645	313	G5AW79	36	349	3.8229522292993616	313
O08688	PF01067	360	487	0.8606171874999988	127	G5AW79	370	497	1.6426796875000005	127
Q9QZM3	PF06875	53	210	1.1269683544303797	157	G5BSB1	119	276	1.2588291139240506	157
Q9CXP9	PF09810	70	190	8.215983471074379	120	G5AQK4	71	191	11.25984297520661	120
Q9CXP9	PF09810	287	354	6.5455	67	G5AQK4	288	355	6.825117647058824	67
P25799	PF16179	248	349	4.653107843137256	101	G5BXA4	349	450	4.6685588235294135	101
P25799	PF00554	41	239	5.437834170854272	198	G5BXA4	125	340	1.2664583333333337	215
P25799	PF00023	610	632	17.599782608695648	22	G5BXA4	680	701	23.00431818181818	21
P25799	PF00531	813	885	0.5203424657534247	72	G5BXA4	883	955	0.0466986301369863	72
P25799	PF12796	520	605	1.3709302325581398	85	G5BXA4	590	675	2.4647790697674434	85
P25799	PF12796	650	742	6.708580645161293	92	G5BXA4	720	812	6.7960215053763475	92
P61588	PF00071	24	192	5.045242603550297	168	G5B7S4	25	195	5.228906432748537	170
P42125	PF00378	87	284	3.403454545454544	197	G5AQD6	41	238	6.56474747474748	197
Q6A039	PF00566	408	631	15.11671875	223	G5B2S8	86	309	15.616580357142832	223
Q7TND5	PF04427	153	316	0.2138902439024389	163	G5C928	154	317	0.2134817073170732	163
Q9D783	PF00651	22	126	9.243761904761904	104	G5ALY1	23	126	10.527865384615383	103
Q9D783	PF01344	452	496	11.350422222222226	44	G5ALY1	461	505	11.362777777777776	44
Q9D783	PF01344	498	537	15.483875000000005	39	G5ALY1	507	546	15.475950000000005	39
Q9D783	PF01344	555	593	7.658076923076924	38	G5ALY1	564	602	7.303974358974358	38
Q9D783	PF07707	132	237	3.408688679245283	105	G5ALY1	132	237	3.320481132075472	105
P97825	PF17054	17	55	0.01641025641025641	38	G5BNC3	1	39	0.01641025641025641	38
Q9DCT2	PF00329	85	205	9.557289256198349	120	G5BPB2	147	267	13.12138016528925	120
Q9JLJ2	PF00171	27	482	3.3457697368421067	455	G5AQ32	52	507	2.696725877192981	455
P47915	PF01779	2	41	0.0	39	G5AXN2	57	96	0.0	39
Q9DCP9	PF11029	34	167	0.2899850746268656	133	G5ATY8	35	168	0.2656015037593985	133
Q64378	PF00254	46	134	1.1922022471910114	88	G5BEW8	47	137	5.192417582417581	90
Q64378	PF00254	159	246	6.473113636363633	87	G5BEW8	162	249	6.701181818181815	87
Q64378	PF00515	318	347	29.367733333333334	29	G5BEW8	321	350	26.05706666666667	29
Q64378	PF13181	352	383	0.0896875	31	G5BEW8	355	386	0.0	31
Q9CQB7	PF05347	6	67	3.5395161290322585	61	G5BV96	7	68	1.8554032258064517	61
Q6X6Z7	PF03148	98	419	0.968329192546584	321	G5BQZ8	99	419	1.0074531249999998	320
P61215	PF00194	45	298	4.145236220472437	253	G5C4L6	1	254	4.1197047244094485	253
Q5SW19	PF12807	768	947	1.1441444444444449	179	G5BCT5	827	1005	0.4216703910614525	178
Q5SW19	PF13236	355	575	6.876891402714934	220	G5BCT5	450	670	6.886339366515836	220
Q5SW19	PF13424	986	1047	0.194467741935484	61	G5BCT5	1032	1093	0.2032741935483871	61
Q5SW19	PF13424	1104	1178	2.0448666666666666	74	G5BCT5	1150	1224	1.611573333333333	74
Q5SW19	PF15044	65	138	0.012000000000000002	73	G5BCT5	163	236	0.01191891891891892	73
Q9DBF7	PF10197	10	46	0.0	36	G5BK65	11	47	0.0	36
Q9DBF7	PF12542	65	156	1.3902391304347823	91	G5BK65	66	157	1.394108695652174	91
Q8BL06	PF00443	31	330	7.813556666666665	299	G5C7G9	32	331	7.738629999999998	299
Q45KJ6	PF00098	125	140	0.0	15	G5AWD0	62	77	0.0	15
Q45KJ6	PF00098	146	163	0.0	17	G5AWD0	83	100	0.0	17
Q45KJ6	PF00313	64	98	0.05228571428571428	34	G5AWD0	1	35	0.051771428571428565	34
Q8BGB5	PF00412	40	95	1.1383214285714285	55	G5BDJ5	39	94	1.1428214285714284	55
Q8CHY6	PF16563	132	174	0.01172093023255814	42	G5AN43	145	187	0.01172093023255814	42
Q3U285	PF05225	278	307	0.1547	29	G5APQ8	230	259	0.2364	29
Q3U285	PF05225	524	568	1.4590666666666667	44	G5APQ8	476	520	1.4619111111111112	44
P28352	PF03372	64	307	6.439692622950817	243	G5B5Q8	66	309	6.571651639344263	243
Q8BFT6	PF13621	44	289	1.3439430894308948	245	G5C9A5	43	288	1.142483739837398	245
Q14AI6	PF00849	82	244	1.287085889570552	162	G5BX85	128	289	2.917	161
Q91XL2	PF00595	234	313	7.9323374999999965	79	G5ATV1	239	318	6.928362499999996	79
Q91XL2	PF00595	338	416	3.631886075949368	78	G5ATV1	343	421	1.6683544303797466	78
Q91XL2	PF00595	465	538	1.5354729729729732	73	G5ATV1	471	544	1.5349189189189183	73
Q91XL2	PF00595	600	678	7.194493670886077	78	G5ATV1	606	684	7.958037974683544	78
Q91XL2	PF13923	50	86	0.07310810810810811	36	G5ATV1	51	87	0.05837837837837837	36
P49442	PF00459	56	374	2.791009404388715	318	G5BGL0	57	377	3.313031152647978	320
Q9ERA6	PF01585	149	192	0.0	43	G5BGM5	149	192	0.0	43
Q9ERA6	PF07842	397	666	4.630548148148146	269	G5BGM5	397	666	5.3655518518518495	269
Q9ERA6	PF12457	18	108	0.4638351648351648	90	G5BGM5	18	108	0.4637252747252745	90
P32043	PF00046	155	211	0.0	56	G5BIE1	156	212	0.0	56
O54929	PF00400	145	181	10.365621621621619	36	G5AKT2	148	184	9.550567567567567	36
O54929	PF00400	186	224	10.188743589743588	38	G5AKT2	189	227	10.343358974358978	38
O54929	PF00400	230	266	3.680054054054055	36	G5AKT2	233	269	3.495135135135135	36
O54929	PF00400	291	319	2.9515517241379317	28	G5AKT2	294	322	2.9867241379310348	28
O54929	PF00400	337	359	0.456	22	G5AKT2	340	362	0.491086956521739	22
O54929	PF07525	367	400	4.931088235294119	33	G5AKT2	370	403	4.921029411764706	33
O54828	PF00610	32	102	1.6793802816901418	70	G5BLS5	57	127	6.5439014084507034	70
O54828	PF00615	299	412	0.3081578947368421	113	G5BLS5	317	430	0.2915964912280701	113
O54828	PF00631	224	279	0.18825000000000006	55	G5BLS5	242	297	0.1469821428571428	55
O54828	PF18148	105	203	7.584717171717173	98	G5BLS5	130	228	7.544888888888892	98
Q8R1C9	PF00640	118	254	2.5495255474452554	136	G5AR64	119	260	2.4900633802816907	141
Q9WVH4	PF00250	204	237	1.0014411764705882	33	G5BW41	17	50	1.0022058823529412	33
Q9WVH4	PF16675	431	509	0.014696202531645568	78	G5BW41	244	322	0.009974683544303795	78
Q9WVH4	PF16676	602	642	0.0	40	G5BW41	415	455	0.0	40
Q504N0	PF00246	126	402	1.4545090252707584	276	G5BH77	127	403	2.3300036101083013	276
Q504N0	PF02244	26	99	1.148837837837838	73	G5BH77	27	100	7.385540540540543	73
Q9QWZ1	PF02144	16	256	3.8007178423236514	240	G5BQ93	17	257	6.874253112033203	240
Q8K3X4	PF11261	9	49	0.7697560975609755	40	G5B685	10	49	0.7878000000000001	39
Q6P9P6	PF00225	22	357	3.630827380952379	335	G5B7A3	24	359	3.651083333333333	335
Q6P9P6	PF13931	914	1046	0.0	132	G5B7A3	916	1048	0.492812030075188	132
Q3U3E2	PF15388	240	522	1.7874063604240282	282	G5C1S4	1	284	1.8062147887323945	283
Q9D115	PF04419	0	36	1.479081081081081	36	G5AP02	1	37	2.3144864864864862	36
Q9D115	PF12874	38	60	5.314391304347825	22	G5AP02	39	61	3.9658260869565214	22
P80318	PF00118	32	523	2.8791402439024387	491	G5AR92	28	519	2.575591463414635	491
O35177	PF08824	402	557	2.83000641025641	155	G5BN55	434	588	3.9947290322580624	154
O35177	PF12026	619	826	5.331153846153846	207	G5BN55	651	858	5.329980769230769	207
O35177	PF14604	9	59	5.974941176470589	50	G5BN55	41	90	7.596580000000001	49
P10711	PF01096	260	298	6.772564102564102	38	G5B613	246	284	6.763871794871792	38
P10711	PF07500	137	247	0.2357747747747748	110	G5B613	117	233	0.22336752136752136	116
P10711	PF08711	26	75	0.0303	49	G5B613	6	55	0.0302	49
O35075	PF03643	19	282	5.055344696969698	263	G5AXI0	100	363	4.590083333333333	263
Q6R3M4	PF00817	32	209	2.6874999999999987	177	G5B2E1	33	210	1.4306179775280898	177
Q6R3M4	PF11798	222	254	0.0	32	G5B2E1	223	255	5.3639393939393925	32
Q6R3M4	PF11799	292	413	2.578139344262295	121	G5B2E1	293	414	8.971360655737705	121
Q7TQ48	PF00350	532	692	7.286167701863352	160	G5C0I8	582	742	7.0372546583850895	160
Q7TQ48	PF16880	495	526	0.0	31	G5C0I8	545	576	0.0	31
Q8CDG3	PF02338	213	353	1.5068297872340426	140	G5AQN9	211	351	1.507063829787234	140
P20722	PF00019	408	508	6.698851485148512	100	G5BAT6	461	561	6.6913069306930675	100
P20722	PF00688	218	358	10.893858156028363	140	G5BAT6	96	236	10.034021276595745	140
Q9QZ57	PF00011	69	148	4.756112499999999	79	G5C6Y4	68	147	4.355775	79
P13541	PF00063	88	766	6.0778011782032415	678	G5B5I5	89	767	6.101486008836522	678
P13541	PF01576	846	1923	0.4086001855287569	1077	G5B5I5	847	1924	0.4095500927643783	1077
P13541	PF02736	34	72	11.870153846153846	38	G5B5I5	35	73	11.828333333333333	38
P50481	PF00412	33	88	0.086875	55	G5B6B9	82	137	0.09117857142857144	55
P50481	PF00412	92	149	13.068034482758625	57	G5B6B9	141	198	13.033827586206893	57
P50481	PF00046	160	216	5.918070175438597	56	G5B6B9	209	265	5.898087719298244	56
Q924H2	PF09606	345	784	0.5294659090909088	439	G5C044	115	507	0.5981195928753181	392
Q9JJ93	PF14969	38	134	7.214948453608245	96	G5ASK4	39	135	0.8463608247422681	96
Q6IFT4	PF00620	376	522	9.602605442176868	146	G5BGW0	377	523	15.060564625850338	146
Q6IFT4	PF00788	197	274	1.1545384615384613	77	G5BGW0	198	275	1.2025769230769228	77
Q01065	PF00233	220	446	5.4620132158590256	226	G5BID1	221	447	5.553268722466961	226
Q01065	PF08499	75	135	3.611508196721312	60	G5BID1	76	136	3.609131147540984	60
Q9JL15	PF00337	16	148	6.035661654135338	132	G5APM5	38	170	5.8205037593984965	132
Q9JL15	PF00337	184	312	0.11309302325581395	128	G5APM5	238	361	3.208451612903226	123
Q9R0E1	PF03171	654	739	9.09782558139535	85	G5AXC0	742	827	8.822709302325583	85
P16675	PF00450	33	469	7.457249427917625	436	G5B7P7	34	471	5.794993150684928	437
P50608	PF01462	74	103	0.0	29	G5B364	77	106	0.0	29
P50608	PF13855	106	166	8.926442622950818	60	G5B364	109	169	8.925967213114754	60
P50608	PF13855	175	234	3.7751833333333336	59	G5B364	178	237	3.773983333333335	59
P50608	PF13855	244	304	0.0	60	G5B364	247	307	0.0	60
P41105	PF01778	4	119	2.8926034482758616	115	G5BVZ2	5	120	2.8470344827586205	115
P59016	PF00995	36	343	2.890844155844156	307	G5CAB0	37	343	3.116543973941368	306
Q8BZQ7	PF00888	521	724	8.421490196078429	203	G5BZF9	366	569	7.9988529411764695	203
Q8BZQ7	PF08672	771	831	6.5020491803278695	60	G5BZF9	608	668	2.9932459016393436	60
Q8BPN8	PF00400	2928	2964	0.0	36	G5C9E0	2991	3027	0.0	36
Q8BPN8	PF12234	1143	1374	5.740534482758624	231	G5C9E0	1195	1428	5.734970085470088	233
Q8BPN8	PF12234	1462	1901	8.157981818181822	439	G5C9E0	1516	1955	7.901015909090905	439
Q61286	PF00010	601	654	13.079555555555556	53	G5B124	553	606	13.080574074074073	53
Q9QW08	PF02114	0	243	4.355668032786887	243	G5C6C0	8	251	3.5037654320987666	243
P48964	PF00581	370	462	7.955408602150532	92	G5BTF8	325	417	6.864021505376347	92
P48964	PF06617	85	316	0.02246551724137931	231	G5BTF8	37	271	0.06844255319148937	234
P97950	PF00071	37	199	7.532000000000003	162	G5B2Q9	38	200	7.5225889570552145	162
Q3UHZ5	PF03250	5	85	3.1706172839506173	80	G5BZQ3	6	86	3.172123456790122	80
Q91ZR3	PF00170	220	267	0.20291666666666666	47	G5CAD6	135	182	0.2	47
Q8VC85	PF01423	11	74	7.23328125	63	G5B0A5	12	75	7.23328125	63
Q91YD3	PF06058	28	142	12.818217391304346	114	G5BUP1	9	123	12.815365217391307	114
Q91YD3	PF16741	559	599	9.361804878048778	40	G5BUP1	540	580	3.455487804878049	40
Q9CQ80	PF05871	9	144	7.99433088235294	135	G5CA01	10	145	7.991551470588236	135
Q8BJ64	PF00732	218	339	0.6260983606557378	121	G5BUP3	1	122	0.4185573770491803	121
Q8BJ64	PF05199	431	568	0.4633840579710145	137	G5BUP3	214	351	0.4538333333333334	137
Q9D638	PF04579	2	97	3.1214479166666664	95	G5B0P9	3	98	1.4106145833333332	95
Q9QVY8	PF15279	104	249	0.22119863013698632	145	G5B5R7	105	250	0.2323219178082192	145
Q3V1H1	PF15297	326	650	2.05358153846154	324	G5BUY3	330	665	2.818074404761907	335
G3UZ78	PF00648	204	293	0.12216666666666673	89	G5AND0	111	200	0.2363777777777778	89
Q9DC77	PF15355	0	83	0.006964285714285714	83	G5BK53	1	56	0.0	55
O89112	PF05147	55	398	14.259308139534873	343	G5BN40	56	399	12.724481049562685	343
Q8BKX7	PF00096	248	272	1.28312	24	G5C1N6	248	272	1.28188	24
Q8BKX7	PF00096	278	302	0.0	24	G5C1N6	278	302	0.0	24
Q8BKX7	PF00096	338	360	0.0	22	G5C1N6	338	360	0.0	22
Q4FZD7	PF00069	26	278	5.777584980237155	252	G5BW50	28	283	5.662390625000001	255
Q4FZD7	PF00659	422	480	7.115661016949152	58	G5BW50	431	489	0.13471186440677968	58
Q61062	PF00595	249	332	9.590261904761904	83	G5BTE2	248	331	8.276988095238092	83
Q61062	PF00610	424	493	0.8151428571428572	69	G5BTE2	423	492	0.8807428571428572	69
Q61062	PF00778	2	78	6.216857142857143	76	G5BTE2	3	79	6.989974025974027	76
Q61062	PF02377	91	244	0.19528571428571428	153	G5BTE2	92	243	0.3499473684210526	151
Q61062	PF12316	499	593	0.0	94	G5BTE2	498	579	0.0	81
Q3V4B5	PF07258	20	86	8.44494029850746	66	G5C5G6	1	67	11.645863636363636	66
Q8K298	PF00169	983	1102	4.041383333333333	119	G5BAY2	1009	1128	4.289241666666667	119
Q8K298	PF08174	796	891	8.305	95	G5BAY2	880	974	12.070073684210525	94
Q8K298	PF16018	140	226	0.22624137931034485	86	G5BAY2	120	210	0.13376923076923078	90
Q8K298	PF16018	423	478	0.0	55	G5BAY2	409	462	0.0	53
Q8BHL5	PF04727	307	485	2.417664804469273	178	G5B7Q7	308	487	2.2661611111111117	179
Q8BHL5	PF11841	114	283	17.137541176470588	169	G5B7Q7	115	284	17.120988235294117	169
Q8BHL5	PF16457	552	678	2.8091102362204725	126	G5B7Q7	554	680	2.8067795275590544	126
Q9Z2B2	PF00153	40	133	7.8312127659574475	93	G5AY35	38	131	7.892414893617022	93
Q9Z2B2	PF00153	139	224	14.951069767441867	85	G5AY35	137	252	10.952689655172415	115
Q9Z2B2	PF00153	234	322	12.333000000000002	88	G5AY35	262	350	12.314483146067415	88
P48540	PF00019	117	209	2.3707634408602147	92	G5BTT7	94	186	2.317376344086021	92
Q62187	PF13921	596	649	0.1129814814814815	53	G5AT45	716	769	0.1150925925925926	53
P14148	PF00327	111	161	4.076156862745098	50	G5B5T8	90	140	3.129352941176471	50
P14148	PF08079	36	106	0.0	70	G5B5T8	15	85	0.0	70
Q5H8C4	PF06650	2201	2446	8.280638211382117	245	G5BLA4	2109	2354	3.6257723577235783	245
Q5H8C4	PF09333	2939	3023	2.1478941176470583	84	G5BLA4	2847	2935	2.0680898876404483	88
Q5H8C4	PF16908	138	370	3.955210300429185	232	G5BLA4	38	270	6.037618025751074	232
Q5H8C4	PF16909	2756	2934	8.804067039106146	178	G5BLA4	2664	2842	9.154614525139662	178
Q5H8C4	PF16910	566	790	3.314999999999996	224	G5BLA4	469	693	3.1754755555555523	224
Q5H8C4	PF16910	1140	1237	23.83815306122449	97	G5BLA4	1046	1142	30.00469072164949	96
P62315	PF01423	4	68	0.1750153846153846	64	G5BTR9	1	65	0.2291230769230769	64
Q9D6I9	PF14854	40	158	0.4483361344537814	118	G5AX51	41	159	0.4801680672268907	118
P49586	PF01467	79	207	4.174604651162792	128	G5ALB6	44	172	4.177286821705425	128
Q99KE8	PF00096	172	192	0.0	20	G5AYZ1	108	128	0.0	20
Q99KE8	PF00096	228	250	0.0	22	G5AYZ1	164	186	0.0	22
Q99KE8	PF00096	327	347	0.0	20	G5AYZ1	108	128	0.0	20
Q99KE8	PF00096	355	377	0.0	22	G5AYZ1	136	158	0.0	22
Q99KE8	PF00096	383	405	0.0	22	G5AYZ1	164	186	0.0	22
Q99KE8	PF00096	411	433	0.4068695652173913	22	G5AYZ1	192	214	0.3353478260869565	22
Q99KE8	PF00096	493	514	0.0	21	G5AYZ1	274	295	0.0	21
Q99KE8	PF00096	520	543	0.0	23	G5AYZ1	301	324	0.0	23
Q99KE8	PF13909	200	223	0.0	23	G5AYZ1	136	159	0.0	23
Q9QYI3	PF00226	380	447	0.4813382352941177	67	G5B0L1	355	422	0.4776764705882354	67
Q9QYI3	PF13181	293	324	0.0	31	G5B0L1	268	299	0.0	31
Q9QYI3	PF13181	328	354	0.0	26	G5B0L1	303	329	0.0	26
Q9QYI3	PF13414	34	75	0.29504761904761906	41	G5B0L1	9	50	0.2839761904761905	41
Q9QYI3	PF13432	189	242	8.754796296296297	53	G5B0L1	164	217	8.728000000000002	53
Q9WV69	PF02209	369	404	0.0	35	G5B9P4	309	344	0.0	35
Q9WV69	PF16182	61	82	1.6733636363636364	21	G5B9P4	1	22	1.6739090909090912	21
Q9WV69	PF16182	97	368	1.0204191176470587	271	G5B9P4	37	308	0.9927720588235294	271
Q9WU56	PF01416	234	335	9.62864705882353	101	G5AWT0	235	336	9.615225490196076	101
Q6NZF1	PF15663	0	108	4.7158440366972485	108	G5BML5	1	109	5.274321100917431	108
Q3URY6	PF05804	435	562	11.6846171875	127	G5B4I6	442	569	11.124664062500004	127
Q9QYS9	PF16544	33	67	0.5626	34	G5B6X9	1	33	10.86760606060606	32
Q9QYS9	PF00013	96	132	0.12345945945945948	36	G5B6X9	62	98	0.0917837837837838	36
Q9QYS9	PF16551	311	336	0.9278076923076924	25	G5B6X9	277	301	0.7115416666666667	24
Q3UEI1	PF00233	387	628	4.954161157024795	241	G5B4D3	561	802	5.036954545454549	241
Q3UEI1	PF18100	153	269	0.3747008547008546	116	G5B4D3	347	480	0.6419402985074627	133
P23475	PF02037	570	604	0.0	34	G5BPQ1	571	605	0.0	34
P23475	PF02735	263	457	9.543056410256408	194	G5BPQ1	264	458	10.416948717948713	194
P23475	PF03730	470	554	0.006764705882352942	84	G5BPQ1	471	555	0.0998235294117647	84
P23475	PF03731	34	251	10.713279816513763	217	G5BPQ1	35	252	9.995674311926603	217
Q91VX2	PF12478	511	543	0.0	32	G5B049	510	542	0.0	32
Q8VDJ3	PF00013	153	211	0.2777627118644068	58	G5C3R6	154	212	0.5625593220338984	58
Q8VDJ3	PF00013	224	284	0.5363770491803279	60	G5C3R6	225	285	0.536049180327869	60
Q8VDJ3	PF00013	297	356	0.3998	59	G5C3R6	298	357	0.2659333333333333	59
Q8VDJ3	PF00013	367	424	0.052689655172413793	57	G5C3R6	368	425	0.027620689655172413	57
Q8VDJ3	PF00013	437	497	0.0	60	G5C3R6	438	498	0.0	60
Q8VDJ3	PF00013	511	570	0.00595	59	G5C3R6	512	571	0.003966666666666667	59
Q8VDJ3	PF00013	583	643	4.042475409836064	60	G5C3R6	584	644	4.160049180327868	60
Q8VDJ3	PF00013	655	716	0.0	61	G5C3R6	656	717	0.0	61
Q8VDJ3	PF00013	731	790	7.439583333333332	59	G5C3R6	732	791	7.444699999999999	59
Q8VDJ3	PF00013	804	864	0.010573770491803278	60	G5C3R6	805	865	0.028803278688524593	60
Q8VDJ3	PF00013	876	967	4.293956521739132	91	G5C3R6	877	965	0.8938988764044944	88
Q8VDJ3	PF00013	973	1032	0.7539833333333333	59	G5C3R6	971	1030	4.2499	59
Q8VDJ3	PF00013	1055	1117	0.9232698412698412	62	G5C3R6	1053	1115	0.5337301587301585	62
Q8VDJ3	PF00013	1130	1190	0.1148360655737705	60	G5C3R6	1128	1188	0.11491803278688525	60
Q8R060	PF09817	63	383	8.373816199376947	320	G5AN80	1	318	6.212213836477987	317
Q9CPS8	PF15127	0	99	5.2080400000000004	99	G5BGL2	1	89	0.0	88
Q3TJD7	PF00412	281	332	2.8125961538461537	51	G5BQ12	281	332	2.809153846153845	51
Q3TJD7	PF00412	340	395	0.0	55	G5BQ12	340	395	0.0	55
Q3TJD7	PF00412	399	453	4.168381818181818	54	G5BQ12	399	453	4.164036363636365	54
Q3TJD7	PF00595	7	79	0.1593424657534247	72	G5BQ12	8	80	0.360808219178082	72
Q99LB2	PF13561	42	273	6.528745689655174	231	G5B271	43	274	5.050762931034483	231
Q8K183	PF08543	93	272	9.143211111111107	179	G5BG23	223	401	8.251458100558656	178
O54775	PF00007	279	360	5.686243902439026	81	G5C6Q6	322	403	3.6725243902439035	81
O54775	PF00093	122	184	1.405968253968254	62	G5C6Q6	165	227	0.9118095238095238	62
O54775	PF00219	48	100	0.4706981132075472	52	G5C6Q6	91	143	0.4951698113207546	52
O54775	PF19035	215	258	0.023295454545454543	43	G5C6Q6	258	301	0.0	43
O35448	PF02089	60	282	4.881708520179372	222	G5C3I1	13	235	4.678932735426011	222
P70248	PF00063	18	676	4.348517450682845	658	G5B4L3	19	650	4.05859810126582	631
P70248	PF06017	716	913	3.8929393939393937	197	G5B4L3	690	887	3.168520202020204	197
P70248	PF14604	1048	1096	0.3603469387755102	48	G5B4L3	1021	1069	0.3307755102040816	48
Q9D0I6	PF00400	3	36	3.8591176470588247	33	G5C000	4	37	0.2204411764705882	33
Q9D0I6	PF00400	49	81	0.8439696969696969	32	G5C000	50	82	1.1493939393939396	32
Q9D0I6	PF00400	97	124	0.32728571428571435	27	G5C000	98	125	8.880785714285716	27
Q9D0I6	PF00400	141	166	3.781346153846155	25	G5C000	142	167	3.4140769230769226	25
Q9D0I6	PF00400	170	215	2.7374130434782606	45	G5C000	171	217	5.714744680851064	46
Q9D0I6	PF00400	231	263	2.642818181818181	32	G5C000	233	265	7.06648484848485	32
Q9D0I6	PF00400	271	306	3.326361111111111	35	G5C000	273	308	3.505638888888889	35
Q9D0I6	PF04564	401	473	0.0	72	G5C000	404	476	0.009444444444444445	72
Q9D0I6	PF07647	327	391	4.580076923076924	64	G5C000	330	394	4.645676923076924	64
Q8BNV1	PF13649	425	467	0.3986976744186047	42	G5CA27	447	488	0.5244047619047619	41
Q8CHR6	PF01180	533	837	2.025167213114753	304	G5B265	523	827	2.5021081967213097	304
Q8CHR6	PF07992	189	488	4.856723333333334	299	G5B265	179	478	4.008806666666668	299
Q8CHR6	PF14691	57	166	0.258	109	G5B265	47	156	0.2588363636363636	109
Q9DB20	PF00213	36	208	2.340040462427746	172	G5AM26	20	192	2.469988439306358	172
Q9CWK3	PF02213	283	331	0.0	48	G5BYM1	281	329	0.0	48
P48756	PF00123	43	70	14.780142857142858	27	G5C4N3	42	69	14.690357142857144	27
Q6PFR5	PF00076	120	188	13.35655072463768	68	G5BHC5	123	191	12.775898550724635	68
Q02357	PF00531	1399	1479	8.527654320987656	80	G5C636	1416	1496	5.2597777777777805	80
Q02357	PF00791	910	1007	4.3805204081632665	97	G5C636	932	1029	3.4538877551020426	97
Q02357	PF12796	13	102	0.4785333333333335	89	G5C636	9	98	0.4892777777777778	89
Q02357	PF12796	105	163	4.9399661016949175	58	G5C636	101	159	4.929898305084746	58
Q02357	PF12796	170	229	1.8711166666666668	59	G5C636	166	225	2.530566666666666	59
Q02357	PF12796	232	296	0.5559846153846156	64	G5C636	228	292	0.5546461538461541	64
Q02357	PF12796	298	362	0.09115384615384617	64	G5C636	294	358	0.11599999999999999	64
Q02357	PF12796	365	428	0.1421875	63	G5C636	387	450	0.1418125	63
Q02357	PF12796	433	493	0.06724590163934427	60	G5C636	455	515	0.012163934426229508	60
Q02357	PF12796	498	559	1.2022419354838705	61	G5C636	520	581	1.0698709677419354	61
Q02357	PF12796	562	624	0.2458412698412698	62	G5C636	584	646	0.2452063492063492	62
Q02357	PF12796	634	725	5.415326086956524	91	G5C636	656	747	5.431478260869566	91
Q02357	PF13637	730	769	13.926675	39	G5C636	752	791	13.943900000000005	39
Q02357	PF17809	1231	1359	3.0839224806201546	128	G5C636	1253	1381	3.2673410852713176	128
B9EJR8	PF13646	167	264	1.241867346938775	97	G5AZ15	24	121	2.404428571428572	97
Q8BVU5	PF00293	198	325	1.137796875	127	G5BSU8	192	319	0.6761328124999998	127
Q9D7B6	PF00441	260	410	1.4662715231788075	150	G5B2N6	225	375	1.330867549668875	150
Q9D7B6	PF02770	154	248	7.95153684210526	94	G5B2N6	119	213	7.941357894736841	94
Q9D7B6	PF02771	39	150	0.9867499999999998	111	G5B2N6	4	115	4.893544642857143	111
P54103	PF00226	113	157	2.8700666666666668	44	G5BI51	1	45	2.871355555555556	44
P54103	PF00249	451	505	0.5790727272727273	54	G5BI51	378	432	0.5793636363636364	54
P54103	PF00249	552	597	0.0	45	G5BI51	479	524	0.002239130434782609	45
P54103	PF16717	338	426	0.00797752808988764	88	G5BI51	226	353	9.395734374999996	127
Q7TMV3	PF06743	430	497	9.483411764705883	67	G5B4T2	433	500	6.599455882352941	67
Q7TMV3	PF08368	510	600	0.2701098901098901	90	G5B4T2	513	603	0.04593406593406594	90
Q7TMV3	PF08373	696	755	0.13965	59	G5B4T2	699	758	1.86875	59
Q8VCC1	PF00106	5	197	3.1101347150259078	192	G5AKC7	6	198	3.25382383419689	192
Q80WC7	PF01412	39	144	5.529999999999998	105	G5BW18	40	145	6.330235849056599	105
Q4JK59	PF12851	1202	1818	1.3062285251215553	616	G5AKN3	1252	1850	0.8879282136894829	598
O70326	PF03045	71	179	0.6869174311926607	108	G5BWE1	72	180	0.6869357798165139	108
Q9JIM3	PF00176	156	457	7.508367549668871	301	G5BK40	468	774	7.926397394136808	306
Q9JIM3	PF00271	506	618	13.228389380530976	112	G5BK40	823	938	12.845482758620689	115
Q9JIM3	PF14773	1107	1130	0.0	23	G5BK40	1431	1454	0.0	23
Q8CEE0	PF06657	349	419	0.00852112676056338	70	G5ANX5	322	393	0.008402777777777778	71
Q8CEE0	PF14073	67	243	0.0593954802259887	176	G5ANX5	41	216	0.07060795454545453	175
Q8BK35	PF07767	46	255	0.06593333333333333	209	G5AV19	96	300	0.1950585365853659	204
Q64442	PF00107	182	311	8.809899999999994	129	G5BF71	183	311	12.323356589147284	128
Q64442	PF08240	31	141	2.168981981981982	110	G5BF71	32	142	2.166	110
Q91XM9	PF00018	541	597	0.12329824561403505	56	G5BUR2	500	556	0.11299999999999998	56
Q91XM9	PF00595	97	180	0.8280238095238095	83	G5BUR2	116	199	0.8299404761904761	83
Q91XM9	PF00595	193	275	4.558746987951807	82	G5BUR2	117	199	0.8399397590361445	82
Q91XM9	PF00595	421	495	12.77222666666666	74	G5BUR2	380	454	13.57284	74
Q91XM9	PF00625	661	837	4.454129943502827	176	G5BUR2	711	887	4.457757062146894	176
Q91XM9	PF10600	277	344	0.4058676470588236	67	G5BUR2	259	326	0.4068823529411765	67
Q91XM9	PF10608	55	96	0.12964285714285714	41	G5BUR2	79	115	0.14743243243243245	36
P14873	PF00414	1890	1906	0.1863529411764706	16	G5B212	1820	1836	0.17294117647058824	16
P14873	PF00414	1907	1923	0.0	16	G5B212	1837	1853	0.0	16
P14873	PF00414	1941	1957	0.0	16	G5B212	1870	1886	0.0	16
P14873	PF00414	1958	1974	0.0	16	G5B212	1887	1903	0.0	16
P14873	PF00414	2027	2042	0.0	15	G5B212	1956	1971	0.0	15
P14873	PF00414	2043	2059	0.0	16	G5B212	1972	1988	0.0	16
P26638	PF00587	258	443	2.2829354838709683	185	G5BQV7	259	468	2.0521809523809518	209
P26638	PF02403	1	106	0.1239245283018868	105	G5BQV7	2	107	0.022226415094339626	105
P70460	PF00568	3	108	4.997056603773584	105	G5AUW8	3	108	5.074943396226414	105
P70460	PF08776	335	371	0.0	36	G5AUW8	340	376	0.0	36
Q3UTQ8	PF00069	13	296	3.8880422535211263	283	G5BDT6	14	300	3.847404181184668	286
Q9ERE3	PF00787	41	113	0.2735479452054795	72	G5AQN5	36	107	0.2721388888888889	71
Q9ERE3	PF00069	163	418	5.42541796875	255	G5AQN5	132	387	5.338449218749997	255
Q9ERE3	PF00433	439	486	1.1212708333333332	47	G5AQN5	408	455	1.1158958333333333	47
Q6PD28	PF01603	61	465	10.23046913580247	404	G5B6N2	62	466	10.230464197530868	404
Q5QGU6	PF13695	52	162	5.2334504504504515	110	G5ANP5	52	161	1.001290909090909	109
G3XA57	PF00168	13	121	9.157357798165137	108	G5BVV9	14	122	9.168100917431188	108
G3XA57	PF09457	451	498	0.0	47	G5BVV9	451	498	0.0	47
Q9WU12	PF07192	4	69	0.02621212121212121	65	G5C216	1	66	0.02606060606060606	65
O70477	PF05920	276	315	2.2799	39	G5B2V1	277	316	2.2799	39
O70477	PF16493	79	162	0.06613095238095239	83	G5B2V1	80	163	0.06613095238095239	83
Q3USZ8	PF12260	205	404	5.825695	199	G5B249	206	405	5.424184999999998	199
Q61183	PF01909	87	173	2.609712643678163	86	G5B4A1	85	172	2.603147727272728	87
Q61183	PF04926	365	433	8.764565217391304	68	G5B4A1	364	432	8.984405797101447	68
Q61183	PF04928	20	86	0.17070149253731345	66	G5B4A1	18	84	0.3228358208955224	66
Q07417	PF00441	257	405	0.1487114093959732	148	G5AWX3	259	407	0.1560201342281879	148
Q07417	PF02770	150	245	4.477093750000001	95	G5AWX3	152	247	4.565583333333332	95
Q07417	PF02771	35	146	1.3287678571428576	111	G5AWX3	37	148	1.2072678571428574	111
Q3UCV8	PF16218	79	343	6.7478452830188695	264	G5AZ99	77	341	7.6907999999999985	264
Q8BJ25	PF05485	23	81	3.073372881355932	58	G5C556	15	73	5.3213898305084735	58
Q8BRM2	PF04949	137	274	0.4132101449275364	137	G5BUS2	155	292	0.25178985507246376	137
Q8VDQ1	PF00107	167	281	0.6583565217391308	114	G5C1N7	247	361	0.6571999999999999	114
Q8VDQ1	PF16884	12	116	2.714390476190476	104	G5C1N7	92	196	4.529876190476192	104
Q9CW03	PF02463	5	528	2.722551526717555	523	G5BKC1	1	524	2.7119503816793884	523
Q9CW03	PF06470	529	641	2.0058672566371682	112	G5BKC1	525	637	2.005955752212389	112
Q8BM88	PF00112	98	302	6.982882926829267	204	G5BLV7	63	266	7.721857142857147	203
E9PYI1	PF00096	362	384	0.0	22	G5AMD5	335	357	0.0	22
E9PYI1	PF00096	390	412	0.0	22	G5AMD5	363	385	0.0	22
E9PYI1	PF00096	418	440	0.0	22	G5AMD5	391	413	0.0	22
E9PYI1	PF00096	446	468	0.0	22	G5AMD5	419	441	0.0	22
E9PYI1	PF00096	502	524	0.0	22	G5AMD5	475	497	0.0	22
E9PYI1	PF00096	530	552	0.0	22	G5AMD5	503	525	0.0	22
E9PYI1	PF00096	558	580	0.03217391304347827	22	G5AMD5	531	553	0.03739130434782608	22
E9PYI1	PF00096	586	608	0.0	22	G5AMD5	559	581	0.0	22
E9PYI1	PF00096	614	636	0.0	22	G5AMD5	587	609	0.0	22
E9PYI1	PF00096	642	664	0.0	22	G5AMD5	615	637	0.0	22
E9PYI1	PF01352	33	73	1.3962926829268292	40	G5AMD5	3	43	1.1046829268292684	40
E9PYI1	PF01352	125	162	12.921684210526314	37	G5AMD5	94	131	12.14292105263158	37
Q8BWU8	PF00202	30	431	3.932606965174128	401	G5AQL4	31	432	4.1044328358208935	401
Q5SWW4	PF06333	1756	2159	4.4560643564356415	403	G5C8A1	1739	2142	4.635732673267324	403
Q5SWW4	PF18296	1365	1720	5.606289325842693	355	G5C8A1	1348	1703	4.890592696629216	355
Q9R001	PF00090	571	620	0.0575	49	G5C6W7	574	623	0.0	49
Q9R001	PF01421	267	475	7.181794258373207	208	G5C6W7	270	478	5.913244019138758	208
Q9R001	PF01562	84	170	5.55544827586207	86	G5C6W7	86	171	4.771953488372093	85
Q9R001	PF05986	732	851	6.498641666666668	119	G5C6W7	735	854	6.497008333333333	119
Q9R001	PF17771	486	553	3.3839705882352944	67	G5C6W7	489	556	3.3740441176470584	67
Q9R001	PF19030	878	929	0.02826923076923077	51	G5C6W7	881	932	0.019098039215686275	51
Q99J39	PF05292	191	454	6.921238636363635	263	G5BFX6	60	323	7.78053030303031	263
Q99J39	PF17408	132	188	0.2603859649122807	56	G5BFX6	1	57	0.0	56
P70660	PF00010	93	142	13.1295	49	G5BQ28	91	140	15.0108	49
Q9DCH6	PF01428	163	200	0.1086842105263158	37	G5BEY1	149	186	0.10865789473684208	37
Q9DCH6	PF01754	11	34	0.0295	23	G5BEY1	12	35	0.0295	23
Q7TN29	PF01412	14	125	7.081758928571428	111	G5CBJ2	15	126	6.927517857142857	111
A2RSJ4	PF12624	48	93	0.8489347826086954	45	G5BBI0	1	46	0.7296521739130436	45
Q0KL01	PF00789	254	328	8.206893333333333	74	G5B703	305	379	8.166466666666665	74
Q0KL01	PF08059	145	219	0.30590666666666666	74	G5B703	196	270	0.00932	74
Q9D0I8	PF00466	20	118	10.10548484848485	98	G5BZL8	21	119	10.112959595959591	98
Q9D0I8	PF17777	124	193	7.6841285714285705	69	G5BZL8	125	194	7.690471428571428	69
Q922B6	PF00400	310	347	16.006842105263168	37	G5BY44	387	424	15.999368421052624	37
Q922B6	PF00400	353	388	24.741111111111113	35	G5BY44	430	465	24.719499999999996	35
Q922B6	PF00400	513	552	19.64605	39	G5BY44	590	629	19.644675	39
Q922B6	PF00400	558	590	2.871454545454545	32	G5BY44	635	666	2.94234375	31
Q922B6	PF13445	54	78	0.6077999999999998	24	G5BY44	131	155	0.60572	24
Q9CS74	PF07093	13	596	2.998142123287672	583	G5C7G1	14	597	3.699402397260273	583
Q9Z0J4	PF00175	1245	1357	4.3769203539823	112	G5AKS9	1082	1194	4.377203539823012	112
Q9Z0J4	PF00258	756	929	5.144149425287358	173	G5AKS9	593	766	4.860258620689658	173
Q9Z0J4	PF00667	985	1213	4.566602620087337	228	G5AKS9	822	1050	4.5447816593886445	228
Q9Z0J4	PF02898	350	711	1.7386160220994482	361	G5AKS9	185	548	1.8909725274725264	363
Q9CPZ8	PF08583	18	86	5.824246376811592	68	G5B980	13	81	6.737985507246377	68
Q9Z2X8	PF01344	320	357	0.6656052631578948	37	G5BUH0	321	358	0.6678157894736841	37
Q9Z2X8	PF01344	360	409	11.85996	49	G5BUH0	361	410	11.8706	49
Q9Z2X8	PF01344	411	455	3.1445111111111097	44	G5BUH0	412	456	3.1531111111111096	44
Q9Z2X8	PF01344	458	503	8.82621739130435	45	G5BUH0	459	504	8.838282608695652	45
Q9Z2X8	PF01344	506	550	1.7480888888888892	44	G5BUH0	507	551	1.7525999999999995	44
Q9Z2X8	PF01344	553	596	3.4111136363636367	43	G5BUH0	554	597	3.4243863636363643	43
Q9Z2X8	PF00651	66	177	0.6997053571428572	111	G5BUH0	67	178	0.6524017857142856	111
Q9Z2X8	PF07707	184	284	1.0947623762376228	100	G5BUH0	185	285	2.6599702970297034	100
Q9D2C9	PF12251	197	400	5.689558823529412	203	G5B728	97	300	7.021759803921569	203
Q923M0	PF12796	76	162	0.012528735632183909	86	G5C5R9	77	163	0.047137931034482765	86
Q923M0	PF12796	218	293	1.2118815789473687	75	G5C5R9	219	294	0.2979605263157894	75
Q62384	PF03367	48	205	3.0202151898734173	157	G5BQH1	49	206	3.796632911392403	157
Q62384	PF03367	257	414	2.875145569620253	157	G5BQH1	257	414	4.092753164556964	157
P28028	PF00130	218	263	13.193173913043475	45	G5B573	189	234	13.19171739130435	45
P28028	PF02196	140	208	0.07855072463768115	68	G5B573	111	179	0.07811594202898553	68
P28028	PF07714	494	743	8.382384000000002	249	G5B573	412	660	8.754550200803216	248
Q9JJN6	PF06384	0	77	4.722051282051282	77	G5C536	7	84	3.5575	77
Q9Z1N6	PF01392	23	129	2.4828317757009346	106	G5B3V5	24	130	2.4844953271028043	106
Q9Z1N6	PF01759	191	286	1.85884375	95	G5B3V5	192	287	1.8550208333333336	95
Q8VC70	PF00076	59	119	0.08508196721311474	60	G5BB69	58	118	0.08459016393442624	60
Q8VC70	PF00076	138	202	0.02141538461538461	64	G5BB69	137	201	0.018784615384615386	64
Q5ND52	PF00588	209	397	3.707814814814815	188	G5BVK1	210	404	3.1903025641025637	194
D3YZI9	PF13843	119	485	9.300376021798362	366	G5BQI3	6	372	9.520779291553133	366
Q99P31	PF08609	42	136	0.2074315789473684	94	G5BW00	44	137	0.2103085106382979	93
P58462	PF00250	492	567	4.127276315789475	75	G5AVQ0	474	549	4.1335263157894735	75
P58462	PF16159	329	397	0.0	68	G5AVQ0	311	379	0.0	68
O35473	PF04000	13	95	10.573060240963857	82	G5BNU9	14	96	12.83836144578313	82
Q920N2	PF03099	467	480	7.125571428571429	13	G5AXH7	462	474	0.4617499999999999	12
Q920N2	PF09825	309	421	5.876017699115046	112	G5AXH7	304	416	3.3317079646017698	112
Q6NXH3	PF15337	375	470	0.048510416666666674	95	G5AU82	396	491	0.04828124999999999	95
Q60864	PF00515	229	257	0.0	28	G5B6F6	230	258	0.08410344827586208	28
Q60864	PF13181	428	459	0.0	31	G5B6F6	429	460	0.0	31
Q60864	PF13414	10	51	0.0	41	G5B6F6	11	52	0.0	41
Q60864	PF13414	366	405	0.024875	39	G5B6F6	367	406	0.03835	39
Q60864	PF13424	261	327	0.05665671641791047	66	G5B6F6	262	328	3.567074626865672	66
Q60864	PF17830	130	183	13.761222222222226	53	G5B6F6	131	184	14.700129629629627	53
Q60864	PF17830	482	535	0.08548148148148148	53	G5B6F6	483	536	1.0865	53
Q61657	PF00010	0	49	0.25681999999999994	49	G5C566	26	75	0.2383	49
Q91VL8	PF08914	128	191	8.855515624999997	63	G5B5Y7	131	194	8.816515625	63
Q91VL8	PF16589	17	99	2.3526144578313253	82	G5B5Y7	18	99	2.2650487804878043	81
E9Q4N7	PF01388	1063	1147	13.341611764705885	84	G5B2S6	299	383	13.407682352941176	84
E9Q4N7	PF12031	1934	2189	3.8894609374999978	255	G5B2S6	1168	1423	3.910015624999999	255
Q6S7F2	PF02319	143	211	0.8160724637681159	68	G5C9I5	143	211	0.8127681159420288	68
Q6S7F2	PF02319	283	367	23.260870588235296	84	G5C9I5	283	367	23.245905882352943	84
Q9D733	PF00100	222	471	4.527548	249	G5C2G6	220	469	5.8906040000000015	249
Q8K126	PF00472	290	399	0.07802727272727275	109	G5BUT5	291	400	0.23833636363636365	109
Q8K126	PF03462	83	282	0.570475	199	G5BUT5	84	283	1.06616	199
Q6S5L9	PF00017	522	592	0.4905070422535212	70	G5CA41	315	385	0.19721126760563384	70
Q6S5L9	PF00640	196	346	3.9148145695364263	150	G5CA41	1	151	3.278251655629139	150
Q6TDP3	PF00651	80	122	1.3938604651162794	42	G5ATR9	31	72	1.289571428571428	41
Q6TDP3	PF01344	341	373	13.169999999999998	32	G5ATR9	257	288	4.420499999999999	31
Q6TDP3	PF01344	394	419	0.045038461538461534	25	G5ATR9	75	100	0.0	25
Q6TDP3	PF01344	422	467	1.2340869565217392	45	G5ATR9	103	148	1.2174347826086955	45
Q6TDP3	PF01344	469	513	0.2141333333333333	44	G5ATR9	150	194	0.21651111111111115	44
Q6TDP3	PF01344	516	561	1.3891521739130437	45	G5ATR9	197	242	1.3690869565217392	45
Q6TDP3	PF01344	563	607	5.014333333333332	44	G5ATR9	244	288	5.0014666666666665	44
Q61025	PF14931	9	127	0.777764705882353	118	G5BVN4	51	169	0.7849411764705883	118
P28653	PF01462	62	88	0.0	26	G5B4W9	62	88	0.0	26
P28653	PF13855	93	150	11.39896551724138	57	G5B4W9	93	150	11.399000000000001	57
P28653	PF13855	160	216	0.010263157894736842	56	G5B4W9	160	216	0.010263157894736842	56
P28653	PF13855	230	289	0.0	59	G5B4W9	230	289	0.0	59
A2A5K6	PF13909	1074	1098	0.0	24	G5B7Q0	1058	1082	0.0	24
A2A5K6	PF13912	562	585	0.0	23	G5B7Q0	557	580	0.0	23
A2A5K6	PF13912	1018	1040	0.0	22	G5B7Q0	1002	1024	0.0	22
Q7SIG6	PF00169	309	397	2.3883483146067417	88	G5BEK6	342	430	2.379550561797753	88
Q7SIG6	PF01412	424	540	0.4640512820512821	116	G5BEK6	457	598	2.871112676056337	141
Q7SIG6	PF12796	591	675	0.007647058823529412	84	G5BEK6	649	733	0.01387058823529412	84
Q7SIG6	PF14604	902	952	0.6664117647058823	50	G5BEK6	942	992	0.7782941176470588	50
Q7SIG6	PF16746	42	265	0.5704910714285715	223	G5BEK6	78	301	0.606602678571428	223
Q62188	PF01979	63	451	3.5834473007712075	388	G5BTH0	64	452	3.5829665809768643	388
Q6ZPQ6	PF02121	0	249	0.10678	249	G5AWS2	112	392	0.08261565836298937	280
Q6ZPQ6	PF02862	700	896	1.4860913705583756	196	G5AWS2	841	1086	1.2090731707317066	245
Q66GT5	PF00782	72	183	6.140160714285716	111	G5BPD2	16	127	6.276153153153156	111
Q8BVL3	PF00787	30	102	0.05209589041095889	72	G5BZ07	31	103	0.04580821917808218	72
Q8BVL3	PF18116	269	383	2.4516434782608694	114	G5BZ07	270	384	2.4552260869565217	114
A2AS55	PF00023	104	133	0.0	29	G5BP98	101	130	0.0	29
A2AS55	PF12796	140	226	2.526149425287356	86	G5BP98	137	223	9.232149425287355	86
A2AS55	PF13637	37	90	7.266203703703702	53	G5BP98	34	87	9.409851851851853	53
A2AS55	PF13637	274	326	0.2999245283018868	52	G5BP98	271	323	0.4196792452830189	52
Q9D3E6	PF08514	160	267	11.17680555555556	107	G5C836	208	315	11.181361111111109	107
Q9D287	PF05700	11	214	0.5517107843137254	203	G5ATE6	12	215	0.5512107843137254	203
Q91YE5	PF00439	1785	1864	2.1508125	79	G5BB68	1794	1873	2.1561250000000003	79
Q91YE5	PF00628	1664	1710	6.925085106382978	46	G5BB68	1673	1719	8.775191489361701	46
Q91YE5	PF01429	539	609	0.011915492957746479	70	G5BB68	531	601	0.011915492957746479	70
Q91YE5	PF02791	840	900	0.2265901639344264	60	G5BB68	833	893	0.21618032786885244	60
Q91YE5	PF15612	942	983	17.66052380952382	41	G5BB68	935	976	17.378666666666668	41
Q91YE5	PF15613	1419	1458	2.6069500000000003	39	G5BB68	1428	1467	0.6412	39
Q9DB28	PF01900	6	114	10.39083486238532	108	G5AWW9	7	115	14.770220183486234	108
P97760	PF01000	49	176	0.227734375	127	G5AUE7	50	177	0.227734375	127
P97760	PF01193	19	48	0.2596333333333333	29	G5AUE7	20	49	0.22136666666666666	29
Q9D1C2	PF14645	0	115	0.6020258620689655	115	G5AYT4	1	116	0.40018103448275866	115
P07758	PF00079	48	409	8.870408839779007	361	G5B496	52	412	9.476590027700835	360
Q9ESV0	PF00270	216	510	4.1299152542372894	294	G5AXJ2	216	511	3.8236520270270264	295
Q9ESV0	PF00271	574	680	7.546242990654208	106	G5AXJ2	575	681	7.483626168224299	106
Q8BXR6	PF04710	38	444	1.1341474201474204	406	G5BWY2	39	473	0.6890990783410145	434
P63239	PF12177	715	750	0.4574166666666668	35	G5BU25	718	753	1.2968611111111112	35
P63239	PF00082	157	441	6.605192982456143	284	G5BU25	158	442	6.573666666666668	284
P63239	PF01483	503	590	3.203011363636364	87	G5BU25	504	591	1.5432613636363641	87
P63239	PF16470	33	109	0.0	76	G5BU25	34	110	0.3921428571428571	76
Q3UH68	PF00307	76	116	10.222609756097562	40	G5ANE6	11	50	12.4962	39
Q3UH68	PF00412	986	1047	1.9960806451612907	61	G5ANE6	1345	1406	1.9524516129032257	61
Q3UH68	PF15949	312	417	0.0	105	G5ANE6	644	749	0.0	105
Q3UX43	PF11904	258	515	2.9287635658914715	257	G5C4T7	160	417	2.9513875968992234	257
Q3UX43	PF12796	116	198	1.4081204819277116	82	G5C4T7	18	100	1.4071566265060242	82
Q9JHJ0	PF03250	4	138	0.9374370370370368	134	G5C9D6	5	138	0.2626940298507463	133
Q9QXA7	PF00643	177	215	4.6052820512820505	38	G5B136	176	214	4.658743589743589	38
Q91XW8	PF00254	50	139	1.4105555555555551	89	G5BG72	23	112	1.4232888888888893	89
Q8BGR6	PF00025	31	155	7.695752000000001	124	G5C6Y5	32	135	8.837500000000002	103
Q8C0R0	PF00443	340	702	0.4116942148760331	362	G5AZI7	280	637	0.3119720670391061	357
Q8C0R0	PF02809	703	718	6.393125	15	G5AZI7	638	653	2.7766874999999995	15
Q8C0R0	PF02809	806	821	0.0	15	G5AZI7	741	756	0.0	15
Q8C0R0	PF02809	828	843	0.0	15	G5AZI7	763	778	0.0	15
Q8C0R0	PF16674	0	104	1.7261619047619057	104	G5AZI7	1	105	2.3283523809523805	104
P24270	PF00199	60	409	4.4072200000000015	349	G5AXV0	1	350	4.096065714285714	349
P24270	PF06628	435	495	0.20804918032786884	60	G5AXV0	376	436	0.4598852459016394	60
Q9CQ10	PF03357	17	186	3.2427588235294147	169	G5AQ11	94	263	3.297288235294116	169
Q9CQN3	PF15184	0	73	14.182108108108109	73	G5BNI6	1	74	14.477342465753427	73
H3BJG9	PF00021	32	110	2.3375316455696207	78	G5AWG3	29	108	0.1018875	79
Q99MZ3	PF00010	661	715	3.174690909090909	54	G5BG77	651	705	4.948545454545455	54
Q6ZQK0	PF12717	950	1123	14.779982758620674	173	G5C0E0	412	585	18.131321839080464	173
P24529	PF00351	164	493	3.4306787878787874	329	G5C2F1	165	488	3.928802469135801	323
P24529	PF12549	1	25	0.0	24	G5C2F1	2	26	0.0	24
P24529	PF12549	30	48	0.0	18	G5C2F1	31	49	0.0	18
Q8BZT2	PF00097	11	51	0.0	40	G5C839	12	52	0.0	40
Q8BZT2	PF07653	128	180	0.009735849056603772	52	G5C839	129	181	0.012905660377358493	52
Q8BZT2	PF14604	193	247	9.2228	54	G5C839	194	248	9.144618181818187	54
Q8BZT2	PF14604	388	437	1.6597	49	G5C839	390	439	0.8900800000000001	49
P16125	PF00056	22	160	13.64223741007194	138	G5BEG2	23	161	14.22364748201439	138
P16125	PF02866	164	329	1.1979819277108434	165	G5BEG2	165	330	1.1969036144578318	165
P01831	PF00047	67	111	1.6165111111111112	44	G5BHP8	1	44	5.117636363636365	43
P46737	PF01398	12	105	3.5167872340425514	93	G5B9D8	13	105	4.095967741935488	92
P46737	PF18110	202	282	0.02462962962962963	80	G5B9D8	167	247	0.02462962962962963	80
Q52KR3	PF02833	210	347	8.41716666666667	137	G5BLA3	172	355	6.6800815217391305	183
Q52KR3	PF12496	2782	2898	0.5514957264957265	116	G5BLA3	2800	2916	0.5917179487179487	116
Q52KR3	PF13716	2901	3037	14.994773722627745	136	G5BLA3	2919	3055	14.610788321167878	136
Q91W90	PF00085	74	149	0.0575	75	G5BAT7	68	143	0.0582763157894737	75
Q91W90	PF00085	178	276	3.2168787878787883	98	G5BAT7	172	269	3.351234693877552	97
Q91W90	PF00085	308	408	4.174475247524751	100	G5BAT7	305	453	1.6984697986577184	148
Q8BPI1	PF08190	42	106	0.04890769230769231	64	G5BW67	43	106	0.062546875	63
Q8BPI1	PF18201	254	351	2.6944183673469397	97	G5BW67	124	221	2.6868673469387754	97
Q8CAM5	PF00071	58	218	10.134515527950308	160	G5B624	59	219	10.409496894409935	160
Q6ZQ88	PF01593	311	825	4.759568932038833	514	G5BHZ4	142	656	4.760462135922328	514
Q6ZQ88	PF04433	185	218	14.181205882352947	33	G5BHZ4	109	141	14.258636363636365	32
Q8K1N2	PF00169	1141	1236	10.830052083333333	95	G5B1E4	1141	1236	10.917760416666667	95
Q6P8Y7	PF00787	34	102	3.8093188405797114	68	G5ANZ9	35	102	5.4005882352941175	67
Q6P8Y7	PF18116	269	379	9.75524324324324	110	G5ANZ9	270	380	6.230081081081077	110
Q09M05	PF00246	761	806	0.7198695652173911	45	G5BF17	554	598	0.7536136363636365	44
Q09M05	PF18027	595	728	4.7240447761194035	133	G5BF17	388	521	6.510798507462686	133
Q80V91	PF13923	163	201	0.0	38	G5BEC7	108	146	0.0	38
Q80V91	PF18102	210	343	5.282261194029852	133	G5BEC7	155	288	5.289410447761191	133
Q3TVP5	PF16218	84	351	5.208977611940296	267	G5AZ98	40	307	5.809805970149256	267
Q62406	PF00069	313	514	4.427970297029704	201	G5C2R6	29	241	1.198455399061033	212
O08580	PF00104	225	393	7.882905325443783	168	G5B6P9	232	400	8.038100591715974	168
O08580	PF00105	77	145	0.2281159420289855	68	G5B6P9	78	146	0.18257971014492755	68
Q9CQA6	PF06747	44	75	0.18262500000000004	31	G5C7H6	44	75	3.00571875	31
Q8BIW9	PF00004	365	443	5.108822784810125	78	G5BXU7	369	447	6.115164556962027	78
Q61398	PF00431	35	144	4.8771	109	G5BC00	37	146	6.7695	109
Q61398	PF00431	157	268	5.702214285714286	111	G5BC00	184	295	7.236366071428572	111
Q61398	PF01759	353	455	15.508854368932042	102	G5BC00	381	483	15.823990291262144	102
Q61152	PF00102	55	288	11.128282051282053	233	G5B9W7	56	289	7.467217948717947	233
Q6PGN3	PF00069	392	649	7.65256589147287	257	G5C1K0	374	631	7.587027131782942	257
Q6PGN3	PF03607	89	151	4.959761904761903	62	G5C1K0	53	115	3.4294126984126985	62
Q6PGN3	PF03607	213	271	0.4557627118644068	58	G5C1K0	178	236	0.4540677966101695	58
Q8BL97	PF00076	41	105	0.8146461538461541	64	G5CA70	13	77	0.8109999999999998	64
Q99K41	PF00386	872	1007	5.943816176470588	135	G5BYZ1	873	1008	6.569794117647057	135
Q99K41	PF01391	826	865	0.0	39	G5BYZ1	827	866	0.0	39
Q99K41	PF07546	56	127	4.321875	71	G5BYZ1	57	128	4.465333333333336	71
Q60806	PF00069	71	314	6.0327049180327865	243	G5ARV2	12	255	5.689077868852457	243
Q60806	PF00659	455	513	7.420406779661017	58	G5ARV2	412	470	7.458796610169491	58
Q60806	PF00659	552	620	13.917043478260865	68	G5ARV2	509	577	11.15672463768116	68
Q6PD31	PF04849	94	351	0.7636317829457365	257	G5ALX4	116	448	0.1362942942942943	332
Q6PD31	PF12448	410	579	0.04124705882352941	169	G5ALX4	509	678	0.1294764705882353	169
Q8CDM4	PF15818	26	1060	1.0739062801932369	1034	G5C8K7	27	1044	0.4877072691552062	1017
Q7TSI1	PF02759	48	179	3.2753030303030304	131	G5BIZ3	50	181	2.8816590909090904	131
Q7TSI1	PF13901	863	1064	0.6581732673267322	201	G5BIZ3	848	1049	0.4169752475247527	201
O35680	PF00164	47	135	0.06602247191011237	88	G5AM98	48	136	0.2257303370786517	88
Q8BS90	PF15280	7	202	0.02445918367346938	195	G5C9E3	129	324	0.02583163265306121	195
Q80UG8	PF03133	649	936	3.825694444444444	287	G5AKL8	652	938	4.113770034843205	286
Q9DC33	PF00505	101	168	0.030441176470588232	67	G5AL83	103	170	0.030514705882352937	67
Q5SW45	PF07162	315	495	3.958121546961325	180	G5BJT3	311	491	1.7314585635359112	180
O08710	PF00086	45	91	0.09902127659574468	46	G5C6Q5	45	91	0.05240425531914895	46
O08710	PF00086	96	160	0.8632615384615384	64	G5C6Q5	96	160	0.009000000000000001	64
O08710	PF00086	181	248	5.1670735294117645	67	G5C6Q5	181	248	3.050014705882353	67
O08710	PF00086	312	358	0.03872340425531914	46	G5C6Q5	312	359	0.0	47
O08710	PF00086	608	657	0.0	49	G5C6Q5	604	653	0.0	49
O08710	PF00086	661	725	0.0	64	G5C6Q5	657	721	0.0	64
O08710	PF00086	753	776	0.03625	23	G5C6Q5	749	772	0.09895833333333333	23
O08710	PF00086	896	921	0.04057692307692308	25	G5C6Q5	892	917	0.04057692307692308	25
O08710	PF00086	1024	1073	0.005220000000000001	49	G5C6Q5	1017	1066	0.30864	49
O08710	PF00086	1164	1210	1.3962978723404256	46	G5C6Q5	1157	1203	0.782872340425532	46
O08710	PF00135	2197	2716	6.5587711538461555	519	G5C6Q5	2196	2715	6.614471153846155	519
O08710	PF07699	1463	1508	0.0	45	G5C6Q5	1461	1506	0.0876304347826087	45
Q8VID5	PF00270	30	199	9.863776470588236	169	G5BNA8	31	200	8.223694117647058	169
Q8VID5	PF00271	259	353	8.10523157894737	94	G5BNA8	259	353	8.106894736842102	94
Q8VID5	PF06959	635	810	2.4086420454545454	175	G5BNA8	635	817	0.05131147540983607	182
Q8VID5	PF16124	366	435	5.994914285714286	69	G5BNA8	366	435	6.052214285714286	69
Q61292	PF00053	285	338	0.04024074074074074	53	G5BZV5	286	339	0.02857407407407408	53
Q61292	PF00053	349	404	1.7741071428571429	55	G5BZV5	350	405	1.6783571428571429	55
Q61292	PF00053	412	469	1.2408620689655168	57	G5BZV5	413	470	0.2654827586206897	57
Q61292	PF00053	472	518	0.0	46	G5BZV5	473	519	0.0	46
Q61292	PF00053	524	563	0.0	39	G5BZV5	525	564	0.0	39
Q61292	PF00053	783	828	0.0	45	G5BZV5	786	831	1.6224782608695656	45
Q61292	PF00053	831	874	0.0	43	G5BZV5	834	877	0.0	43
Q61292	PF00053	877	924	0.06083333333333332	47	G5BZV5	880	927	0.06020833333333332	47
Q61292	PF00053	927	983	0.0	56	G5BZV5	930	986	0.0	56
Q61292	PF00053	986	1035	0.0	49	G5BZV5	989	1038	0.0	49
Q61292	PF00053	1038	1092	0.10272727272727272	54	G5BZV5	1041	1095	0.045727272727272734	54
Q61292	PF00053	1095	1136	0.0	41	G5BZV5	1098	1139	0.0	41
Q61292	PF00053	1143	1183	0.0	40	G5BZV5	1146	1186	0.0	40
Q61292	PF00055	49	283	3.4096553191489365	234	G5BZV5	50	284	3.929621276595744	234
P52332	PF07714	583	842	4.324734615384618	259	G5BSN6	747	1006	4.332680769230771	259
P52332	PF07714	877	1145	1.1625092936802974	268	G5BSN6	1075	1343	1.1912936802973983	268
P52332	PF17887	283	420	2.3356884057971024	137	G5BSN6	452	583	2.030643939393939	131
P52332	PF18377	146	273	3.1578203125	127	G5BSN6	315	444	3.0929076923076932	129
P52332	PF18379	39	127	5.4682134831460685	88	G5BSN6	155	296	6.66735915492958	141
Q7M6U3	PF07714	282	494	9.71942723004695	212	G5AXZ0	291	503	6.653690140845067	212
Q7M6U3	PF12796	26	115	9.057833333333337	89	G5AXZ0	27	116	18.073988888888884	89
Q99KR8	PF01120	27	358	7.633771084337341	331	G5BL57	31	362	5.624478915662649	331
Q99KR8	PF16757	369	456	10.516079545454547	87	G5BL57	373	460	8.313329545454547	87
Q3ULM6	PF15499	213	485	4.213641025641024	272	G5B267	225	496	3.9108860294117647	271
Q3ULM6	PF15509	557	1086	0.17824339622641505	529	G5B267	570	1093	0.34732251908396955	523
Q7TT79	PF12258	223	596	0.5483368983957221	373	G5BC96	226	603	0.2267486772486772	377
Q7TT79	PF12738	14	80	14.693761194029848	66	G5BC96	12	78	14.637701492537316	66
Q7TT79	PF16589	740	804	4.1269230769230765	64	G5BC96	772	835	4.145390624999999	63
Q9DAW6	PF00400	239	257	0.3890526315789473	18	G5BQK9	135	152	0.18438888888888888	17
Q9DAW6	PF00400	273	307	9.787657142857142	34	G5BQK9	77	111	0.0	34
Q9DAW6	PF00400	313	349	0.057216216216216226	36	G5BQK9	117	153	0.0897027027027027	36
Q9DAW6	PF00400	398	433	4.472333333333332	35	G5BQK9	160	194	0.5248285714285714	34
Q9DAW6	PF00400	440	475	0.4741666666666668	35	G5BQK9	118	152	0.09482857142857144	34
Q9DAW6	PF00400	482	517	0.27111111111111114	35	G5BQK9	117	152	0.09219444444444444	35
Q91WM2	PF13242	275	321	0.4502553191489364	46	G5BT22	283	329	0.29651063829787233	46
Q91WM2	PF13344	48	151	5.198211538461537	103	G5BT22	55	158	4.919730769230768	103
Q64291	PF00038	117	429	0.05608626198083067	312	G5AX65	120	434	0.26068888888888897	314
Q6P3Y9	PF00560	163	185	0.0	22	G5BYU3	165	187	0.0	22
Q6P3Y9	PF13855	69	128	0.08908333333333332	59	G5BYU3	71	130	0.0	59
Q6P3Y9	PF13855	209	270	0.0	61	G5BYU3	211	272	0.0	61
Q6P3Y9	PF13855	350	412	0.07817460317460315	62	G5BYU3	352	414	0.6767936507936511	62
Q6P3Y9	PF13855	422	457	0.0	35	G5BYU3	424	459	0.0	35
Q6P3Y9	PF13855	493	546	0.025925925925925932	53	G5BYU3	495	548	0.0	53
Q9QZ47	PF00992	75	210	0.005147058823529413	135	G5C2F6	82	217	0.0050367647058823534	135
Q8BUK6	PF05622	183	707	1.2456266666666669	524	G5BUV4	184	708	1.2499885714285717	524
Q8BUK6	PF19047	10	160	3.6250066225165565	150	G5BUV4	11	161	4.286708609271524	150
Q9CQA5	PF10018	85	197	2.5944690265486727	112	G5BTQ5	41	153	2.097699115044248	112
O70493	PF00787	59	146	0.05247727272727274	87	G5BW34	60	148	0.051449438202247184	88
Q8BUN5	PF03165	30	130	0.03257425742574258	100	G5C5G2	21	115	0.03468421052631579	94
Q8BUN5	PF03166	230	400	2.3539298245614044	170	G5C5G2	215	385	2.0544035087719297	170
Q9CX99	PF00017	59	134	2.9131447368421037	75	G5BKM6	60	135	2.923276315789473	75
Q9CX99	PF00018	3	49	2.321936170212766	46	G5BKM6	4	50	1.9369574468085105	46
Q9CX99	PF07653	162	214	0.0	52	G5BKM6	163	215	0.0	52
Q9Z0W3	PF11715	28	542	5.196972815533983	514	G5BPB6	29	543	5.768355339805827	514
Q8R0F8	PF01557	21	221	2.9644626865671633	200	G5BY62	16	216	2.627134328358207	200
O88597	PF15285	102	126	0.0	24	G5C9Z7	103	153	0.0	50
O88597	PF04111	261	442	2.9701538461538464	181	G5C9Z7	288	469	2.979318681318682	181
O88597	PF17675	132	258	0.0	126	G5C9Z7	159	285	0.0	126
P31938	PF00069	67	360	3.0028197278911573	293	G5AN82	68	361	2.9937448979591834	293
Q0VEE6	PF00096	615	637	0.0	22	G5AX07	651	673	0.0	22
Q0VEE6	PF12874	483	502	0.0	19	G5AX07	519	538	0.0	19
Q0VEE6	PF16622	354	382	0.0	28	G5AX07	388	416	0.0	28
Q0VEE6	PF16624	390	482	0.0	92	G5AX07	424	518	0.0	94
Q8CEL2	PF16092	15	266	9.089261904761901	251	G5CBC0	16	267	12.063019841269842	251
Q8CFP6	PF00071	17	178	10.254166666666666	161	G5CBJ5	18	179	10.998975308641972	161
Q8CFP6	PF00226	217	268	1.7777884615384616	51	G5CBJ5	218	269	1.6375000000000002	51
Q80YE4	PF07714	253	392	6.0197285714285735	139	G5BJ58	556	695	5.9516500000000025	139
O35690	PF00046	98	154	0.7311052631578948	56	G5ALP3	99	155	0.7354210526315791	56
Q8C7U1	PF06818	359	423	0.0	64	G5BCC3	530	594	0.0	64
Q8C7U1	PF06818	451	517	0.0	66	G5BCC3	622	688	0.0	66
Q9CQI3	PF00241	13	136	5.003088709677421	123	G5BF83	14	137	5.860701612903223	123
Q9Z1B7	PF00069	40	307	2.42476865671642	267	G5BEW1	1	268	3.4293059701492514	267
Q8BUL5	PF00651	33	139	6.640719626168225	106	G5BHB9	34	140	7.493616822429902	106
Q8BUL5	PF01344	373	415	3.572627906976744	42	G5BHB9	374	416	3.5688372093023264	42
Q8BUL5	PF01344	419	466	5.3535208333333335	47	G5BHB9	420	467	5.349520833333332	47
Q8BUL5	PF01344	470	514	8.343577777777776	44	G5BHB9	471	515	8.255377777777777	44
Q8BUL5	PF07707	145	247	0.8446699029126215	102	G5BHB9	146	248	0.8338932038834952	102
Q3UHU5	PF11365	493	586	0.02170212765957447	93	G5C058	206	299	0.009734042553191491	93
Q3UHU5	PF11365	623	711	0.0	88	G5C058	336	421	0.0014069767441860464	85
Q3UHU5	PF14818	1219	1342	0.009233870967741935	123	G5C058	912	1034	0.005853658536585366	122
P30280	PF00134	24	149	8.026277777777779	125	G5AS06	25	150	8.021793650793652	125
P30280	PF02984	152	264	2.456920353982301	112	G5AS06	153	265	2.4820088495575243	112
P50586	PF01167	256	499	3.61802868852459	243	G5B1Q1	323	566	3.610483606557377	243
P50586	PF16322	28	235	0.5382451923076923	207	G5B1Q1	96	302	0.5391884057971015	206
P50136	PF00676	102	401	4.887866666666667	299	G5AZS5	141	440	4.876896666666668	299
Q8VC34	PF04181	80	150	0.02349295774647888	70	G5AZX0	61	131	0.3025774647887324	70
Q8BHB9	PF13410	480	565	0.038197674418604666	85	G5AM16	438	523	0.05034883720930234	85
Q9CQP3	PF16860	4	48	0.0	44	G5B003	44	88	0.0	44
P30658	PF00385	37	60	3.553875	23	G5AKP7	1	24	3.5440416666666668	23
P30658	PF17218	478	509	18.3665	31	G5AKP7	447	478	18.59428125	31
P46718	PF01753	134	170	0.0	36	G5C7S1	42	78	0.0	36
P46718	PF04194	187	337	3.7385960264900655	150	G5C7S1	94	237	3.869798611111111	143
A2AIG8	PF00155	98	464	6.546419618528607	366	G5AS44	99	464	5.608674863387978	365
Q5DTM8	PF13920	917	959	10.033651162790695	42	G5ANC6	920	962	10.030976744186047	42
O55203	PF01803	78	178	7.55922772277228	100	G5B324	170	270	7.5252376237623775	100
O55203	PF01803	181	231	6.967176470588236	50	G5B324	273	323	6.92943137254902	50
O55203	PF17916	297	325	0.395	28	G5B324	389	417	0.3879310344827586	28
P21956	PF00008	27	56	0.16029999999999994	29	G5CA86	28	58	0.07858064516129032	30
P21956	PF00008	67	105	1.40525641025641	38	G5CA86	69	107	0.0	38
P21956	PF00754	162	299	0.7702101449275364	137	G5CA86	127	265	1.3503525179856113	138
P21956	PF00754	323	459	0.2868175182481751	136	G5CA86	289	429	0.2479290780141844	140
Q6PDG5	PF00249	598	641	1.566454545454545	43	G5BB84	562	605	1.5634545454545452	43
Q6PDG5	PF04433	426	511	4.309918604651162	85	G5BB84	390	475	4.306697674418606	85
Q6PDG5	PF16495	863	944	7.487158536585365	81	G5BB84	827	908	7.451353658536585	81
Q6PDG5	PF16496	37	419	1.2446866840731068	382	G5BB84	1	383	1.243485639686684	382
Q6PDG5	PF16498	683	748	1.0636060606060609	65	G5BB84	647	712	0.0	65
Q9D1G1	PF00071	9	169	4.605701863354036	160	G5BWX1	10	170	4.43542857142857	160
Q3ULB5	PF00069	411	658	3.621786290322581	247	G5BLY3	411	658	2.496080645161291	247
Q3ULB5	PF00786	10	62	0.0	52	G5BLY3	11	63	0.0	52
F7BJB9	PF07496	408	450	0.0	42	G5B2U3	365	407	0.0	42
F7BJB9	PF13589	31	138	1.4635462962962948	107	G5B2U3	31	138	3.399416666666668	107
F7BJB9	PF17942	295	381	9.017632183908043	86	G5B2U3	252	338	5.7651839080459775	86
Q0VG49	PF15031	28	152	8.289152	124	G5C5F8	29	153	6.623639999999999	124
O35400	PF00685	56	300	10.348848979591834	244	G5B888	37	281	7.199918367346935	244
Q9DB15	PF00542	132	199	0.3046176470588235	67	G5BJ72	145	212	0.3033088235294117	67
Q9DB15	PF16320	63	107	0.38788888888888895	44	G5BJ72	77	120	0.3961363636363636	43
Q8BV13	PF01399	62	153	7.5968152173913035	91	G5ASX8	63	154	7.1707065217391275	91
Q8BV13	PF18392	165	213	0.9640000000000001	48	G5ASX8	166	213	0.971625	47
Q64705	PF00010	235	289	0.5857090909090908	54	G5BXJ5	122	176	0.6060181818181819	54
Q64GA5	PF01735	44	244	6.532059701492537	200	G5B899	43	242	5.968209999999999	199
O35261	PF02319	171	234	0.265890625	63	G5B7E3	49	112	0.269078125	63
O35261	PF16421	250	343	8.063585106382979	93	G5B7E3	128	225	7.208704081632653	97
P32921	PF00458	15	67	0.038962264150943386	52	G5B4B4	53	105	0.03943396226415094	52
P32921	PF00579	155	441	4.307080139372822	286	G5B4B4	193	479	4.3055540069686415	286
Q9D1G2	PF04275	13	122	1.7232909090909088	109	G5BDD7	14	123	2.0024727272727265	109
Q91WD7	PF00225	16	354	4.816032448377582	338	G5BA64	17	355	4.861926253687313	338
Q9D7V2	PF01476	91	115	0.01784	24	G5C9D8	1	25	0.0	24
Q8BWR8	PF02185	38	101	0.662109375	63	G5BXH7	16	79	0.6569375000000001	63
Q8BWR8	PF03097	111	511	9.875438902743149	400	G5BXH7	89	490	8.930263681592043	401
O54751	PF00046	39	95	0.3448421052631579	56	G5AV21	40	96	0.3458070175438596	56
O54751	PF03529	163	248	0.040755813953488366	85	G5AV21	164	249	0.031162790697674414	85
Q6NVF9	PF00076	82	151	13.448757142857144	69	G5BBG5	87	156	12.379257142857142	69
P49717	PF00493	445	667	8.044264573991027	222	G5BHS6	448	670	8.200022421524661	222
P49717	PF14551	161	262	0.16568627450980386	101	G5BHS6	164	265	0.0	101
P49717	PF17207	269	395	8.275858267716535	126	G5BHS6	272	398	8.278897637795279	126
P49717	PF17855	684	766	1.1718072289156622	82	G5BHS6	687	769	1.140795180722891	82
Q99P88	PF03177	804	1176	4.9966246648793575	372	G5BTT4	803	1175	4.823954423592495	372
Q99P88	PF08801	78	507	7.810644186046512	429	G5BTT4	79	508	8.048858139534882	429
P51175	PF01593	11	470	5.001506521739133	459	G5BWI3	12	471	6.168063043478261	459
Q6S5J6	PF00373	518	639	15.220819672131151	121	G5C9K1	519	640	15.337303278688527	121
Q6S5J6	PF13857	339	394	5.958267857142856	55	G5C9K1	340	395	4.854392857142857	55
Q6S5J6	PF16705	21	196	2.8790795454545464	175	G5C9K1	22	197	2.888107954545455	175
Q8JZM7	PF05179	357	519	5.125656441717792	162	G5ASG2	360	522	5.119073619631898	162
Q8JZM7	PF16050	0	296	4.469777777777777	296	G5ASG2	1	297	5.041033670033673	296
G5E870	PF00632	1669	2024	5.696022471910112	355	G5ASW7	1686	2041	5.443076056338032	355
G5E870	PF02825	767	830	0.052031250000000015	63	G5ASW7	810	846	0.03908108108108108	36
Q9R088	PF01712	57	262	3.4005339805825225	205	G5BDG5	52	257	5.165786407766992	205
P10639	PF00085	9	101	2.5484731182795706	92	G5C094	1	93	1.7527204301075268	92
Q8K0C1	PF03810	44	106	0.10634920634920636	62	G5AQF2	45	107	0.2045079365079365	62
Q8K0C1	PF08389	116	261	2.593972602739726	145	G5AQF2	117	262	2.5271917808219184	145
Q8K0C1	PF18773	401	440	2.7186	39	G5AQF2	402	441	2.722725	39
Q8K0C1	PF18786	583	626	15.372568181818178	43	G5AQF2	584	627	15.369000000000002	43
Q8K0C1	PF18786	630	671	17.389095238095233	41	G5AQF2	631	672	17.38402380952381	41
Q8K0C1	PF18806	825	898	16.633716216216214	73	G5AQF2	826	899	17.143905405405413	73
Q8BWT5	PF00501	296	765	7.408402127659568	469	G5C7V1	308	777	7.653110638297872	469
Q8BWT5	PF00501	942	1415	6.27962869198312	473	G5C7V1	954	1428	6.852128421052635	474
Q8BWT5	PF06464	30	50	0.0	20	G5C7V1	1	21	0.0	20
Q8BWA8	PF00018	725	766	0.0	41	G5BRU4	710	751	0.02083333333333333	41
Q8BWA8	PF00621	381	557	1.3692146892655368	176	G5BRU4	374	550	1.1875254237288138	176
Q6NXY1	PF00566	465	610	11.243390410958902	145	G5AY84	466	611	14.790246575342465	145
Q9CPP7	PF00561	80	222	6.624678321678322	142	G5BT05	81	222	6.798295774647888	141
Q9Z1T6	PF00118	609	853	10.5582	244	G5B6E9	610	854	10.930293877551012	244
Q9Z1T6	PF00610	367	436	3.681042857142856	69	G5B6E9	368	437	3.6785285714285694	69
Q9Z1T6	PF01363	153	214	0.04080645161290323	61	G5B6E9	154	215	0.08275806451612902	61
Q9Z1T6	PF01504	1856	2025	1.2181823529411762	169	G5B6E9	1857	2026	1.216982352941176	169
Q9Z1T6	PF01504	2027	2081	19.119018181818177	54	G5B6E9	2028	2082	19.31676363636364	54
P97793	PF00629	269	428	1.06928125	159	G5C2X6	43	202	1.06449375	159
P97793	PF00629	483	637	9.16207096774194	154	G5C2X6	257	412	8.126519230769235	155
P97793	PF07714	1120	1385	3.5027631578947367	265	G5C2X6	895	1160	3.5015225563909773	265
P97793	PF12810	735	963	5.153484716157206	228	G5C2X6	510	738	5.041759825327511	228
Q61024	PF00733	234	382	3.5539328859060406	148	G5BLD6	235	383	4.880825503355706	148
Q61024	PF13537	48	163	9.971060344827588	115	G5BLD6	49	164	11.006681034482755	115
Q9JJ26	PF00643	442	480	14.544615384615383	38	G5B1I0	403	441	10.56076923076923	38
Q9JJ26	PF02758	7	83	8.692675324675323	76	G5B1I0	8	84	3.5105454545454537	76
Q9DB40	PF11571	228	309	0.2999878048780487	81	G5AT48	229	310	0.2999878048780487	81
P01582	PF00340	159	268	5.8591	109	G5B005	160	270	5.324809090909089	110
P01582	PF02394	0	109	0.05249090909090909	109	G5B005	1	108	2.2211111111111115	107
Q6P9Q4	PF02181	652	1018	5.911237057220707	366	G5C655	596	962	6.142648501362401	366
Q6P9Q4	PF18382	66	114	0.0	48	G5C655	42	90	0.0	48
B2RRE4	PF13909	161	183	0.07847826086956522	22	G5B2Y5	166	188	0.07913043478260869	22
Q9Z1Q9	PF00043	125	197	3.9038356164383576	72	G5C3G3	41	113	3.8735753424657537	72
Q9Z1Q9	PF00133	307	937	4.820808240887478	630	G5C3G3	224	819	5.208161073825504	595
Q9Z1Q9	PF08264	982	1129	3.1338243243243267	147	G5C3G3	864	1011	3.1773243243243243	147
P25206	PF00493	281	504	5.705553571428572	223	G5BC79	282	505	5.711928571428571	223
P25206	PF14551	17	94	5.090833333333332	77	G5BC79	18	95	5.105743589743591	77
P25206	PF17207	113	243	5.391770992366411	130	G5BC79	114	244	2.767244274809162	130
P25206	PF17855	566	649	1.1404999999999998	83	G5BC79	567	650	1.485	83
Q8C7V3	PF00400	112	149	0.0	37	G5AMI9	113	150	0.0	37
Q8C7V3	PF00400	155	192	0.3152631578947368	37	G5AMI9	156	193	0.2159473684210526	37
Q8C7V3	PF00400	203	232	0.8298000000000001	29	G5AMI9	204	233	0.4014333333333333	29
Q8C7V3	PF00400	237	274	1.2532894736842106	37	G5AMI9	238	275	1.2484736842105262	37
Q8C7V3	PF09384	342	489	4.883864864864868	147	G5AMI9	343	490	5.151891891891894	147
Q6PAM0	PF04739	201	269	8.695710144927537	68	G5BA05	203	271	8.693318840579712	68
Q6PAM0	PF16561	76	159	3.6996071428571433	83	G5BA05	78	161	3.6987738095238085	83
Q80T23	PF00168	445	550	4.3916037735849045	105	G5BMQ3	446	551	0.4663207547169812	105
Q80T23	PF00168	609	716	1.6051944444444446	107	G5BMQ3	610	717	0.8270833333333336	107
Q80T23	PF02318	12	121	3.5663	109	G5BMQ3	13	122	3.0037181818181806	109
Q8CIX8	PF00120	236	559	6.28951851851852	323	G5BZQ7	267	590	5.149200617283951	323
Q9DAG4	PF15217	11	119	2.6957522935779816	108	G5AQW9	27	134	0.015532710280373828	107
Q9D6N5	PF00808	11	73	1.122492063492064	62	G5BWV8	1	63	1.1098571428571429	62
Q8VDS7	PF06657	255	326	0.010694444444444444	71	G5B4I3	314	385	0.03395833333333333	71
Q8VDS7	PF14073	49	214	0.12148795180722888	165	G5B4I3	54	219	0.3494096385542168	165
B1AQJ2	PF00443	122	419	5.359023489932887	297	G5AVF4	125	422	5.9187751677852365	297
Q5U458	PF00226	24	78	2.1425454545454543	54	G5C555	1	55	2.1331818181818183	54
Q5U458	PF11875	409	548	4.9551000000000025	139	G5C555	386	524	5.027381294964031	138
Q9EQJ9	PF00397	297	326	12.130166666666668	29	G5ATD2	190	219	12.148100000000005	29
Q9EQJ9	PF00397	343	372	0.2475333333333333	29	G5ATD2	236	265	0.24870000000000006	29
Q9EQJ9	PF00595	415	479	5.594384615384613	64	G5ATD2	308	372	5.617061538461539	64
Q9EQJ9	PF00595	732	808	3.724883116883117	76	G5ATD2	624	700	3.737	76
Q9EQJ9	PF00595	852	934	16.830445783132532	82	G5ATD2	746	828	17.92951807228916	82
Q9EQJ9	PF00595	1023	1099	6.20694805194805	76	G5ATD2	917	993	6.222454545454546	76
Q9EQJ9	PF00625	142	192	0.04847058823529412	50	G5ATD2	36	86	0.048705882352941175	50
Q9CY25	PF05859	7	139	4.5941127819548875	132	G5BW77	8	140	8.998443609022557	132
B2RY50	PF00514	615	652	0.17026315789473687	37	G5C145	550	587	0.17092105263157895	37
B2RY50	PF13646	917	1017	0.40393069306930696	100	G5C145	852	952	0.4934554455445545	100
Q9QZB6	PF00104	434	606	8.47184971098266	172	G5AZ32	378	550	8.51556647398844	172
Q9QZB6	PF00105	291	359	0.17613043478260873	68	G5AZ32	235	303	0.17718840579710146	68
P21278	PF00503	45	347	8.364825082508245	302	G5AKR3	14	316	8.225412541254126	302
Q8BK67	PF00415	165	214	6.317899999999997	49	G5BZN0	73	122	10.484659999999996	49
Q8BK67	PF00415	218	265	1.0816666666666663	47	G5BZN0	126	173	1.093520833333333	47
Q8BK67	PF00415	269	342	5.731108108108108	73	G5BZN0	177	250	5.726675675675676	73
Q8BK67	PF00415	347	396	0.7990999999999998	49	G5BZN0	255	304	0.7617400000000002	49
Q9DAI4	PF00651	22	124	13.842737864077664	102	G5BLH8	23	125	8.956951456310678	102
Q58A65	PF09744	23	106	6.555702380952384	83	G5C4L2	24	106	6.7008433734939805	82
Q58A65	PF16471	404	473	0.024142857142857143	69	G5C4L2	426	495	0.024142857142857143	69
Q58A65	PF19056	954	1172	6.54009132420091	218	G5C4L2	977	1218	5.952123966942147	241
P48759	PF00354	182	376	6.182651282051277	194	G5BVQ7	175	369	10.704830769230773	194
Q8BLM0	PF00096	269	293	0.0	24	G5BT20	274	298	0.0	24
Q8BLM0	PF00096	299	323	0.0	24	G5BT20	304	328	0.0	24
Q8BLM0	PF00096	329	351	0.0	22	G5BT20	334	356	0.0	22
P19091	PF00104	674	857	9.9802445652174	183	G5AV30	544	727	10.000375000000002	183
P19091	PF00105	537	604	0.04919117647058824	67	G5AV30	407	474	0.03947058823529411	67
P19091	PF02166	186	441	0.06351953125	255	G5AV30	55	311	0.025143968871595337	256
P08607	PF00084	57	110	0.024259259259259258	53	G5BP10	56	108	7.102490566037736	52
P08607	PF00084	119	175	3.3156666666666665	56	G5BP10	118	175	0.6515	57
P08607	PF00084	180	239	1.4358833333333334	59	G5BP10	180	240	2.9476557377049173	60
P08607	PF00084	244	297	0.6287962962962962	53	G5BP10	245	297	0.2449056603773585	52
P08607	PF00084	302	354	8.680754716981133	52	G5BP10	304	357	7.9039629629629635	53
P08607	PF00084	358	412	0.0581818181818182	54	G5BP10	361	415	0.21509090909090914	54
P08607	PF18453	415	462	0.6532708333333331	47	G5BP10	418	464	0.06739130434782609	46
A2AM29	PF03366	64	107	0.3720227272727273	43	G5B2H5	1	44	0.37793181818181815	43
A2AM29	PF17793	503	563	0.9631639344262294	60	G5B2H5	404	464	0.977377049180328	60
Q8R5F3	PF01661	34	134	8.13219801980198	100	G5BNG9	35	136	8.076049019607844	101
P08103	PF00017	141	223	0.4256987951807228	82	G5BR07	121	243	0.2593902439024389	122
P08103	PF00018	81	127	6.985872340425527	46	G5BR07	61	107	5.548127659574464	46
P08103	PF07714	259	507	5.4567269076305225	248	G5BR07	279	527	6.204104417670678	248
Q3URU2	PF00096	377	399	0.0	22	G5CAU2	371	393	0.0	22
Q3URU2	PF00096	852	871	0.0	19	G5CAU2	783	802	0.0	19
Q3URU2	PF00096	1090	1112	0.0	22	G5CAU2	898	920	0.0	22
Q3URU2	PF00096	1147	1168	0.06704545454545452	21	G5CAU2	955	976	0.26495454545454544	21
Q3URU2	PF00096	1209	1230	0.0	21	G5CAU2	438	459	0.0	21
Q3URU2	PF13912	519	541	0.0	22	G5CAU2	437	459	0.0	22
Q3URU2	PF13912	1486	1509	0.01691666666666667	23	G5CAU2	1263	1286	0.5367916666666667	23
Q80Y50	PF01833	541	620	1.2227125	79	G5BW94	545	624	1.1225625000000004	79
Q80Y50	PF03859	38	152	7.208260869565217	114	G5BW94	39	148	7.347672727272728	109
Q9DCD6	PF02991	12	115	17.368432692307696	103	G5B5A5	13	116	17.368432692307696	103
Q8BGV7	PF02214	64	132	6.044159420289855	68	G5BYN2	1	69	6.0957101449275335	68
Q9CXS4	PF04828	147	220	0.4400135135135135	73	G5BEV3	142	215	0.4425270270270269	73
Q9D2X5	PF10345	29	575	11.73780621572212	546	G5AN42	24	576	12.68662025316456	552
Q9JLY0	PF00017	381	457	1.5071818181818182	76	G5BQP7	384	460	1.5021038961038962	76
Q9JLY0	PF07525	494	528	0.0	34	G5BQP7	497	531	0.0	34
Q9JJP2	PF00870	109	299	5.606748691099478	190	G5CBI6	118	308	5.607513089005237	190
Q9JJP2	PF07647	479	542	4.49165625	63	G5CBI6	488	551	4.492453125000001	63
Q9JJP2	PF07710	336	374	0.5031282051282051	38	G5CBI6	345	383	0.4550769230769231	38
Q920M7	PF00168	195	304	5.43629090909091	109	G5AY28	244	353	5.428454545454545	109
Q920M7	PF00168	331	425	6.3973157894736845	94	G5AY28	380	474	6.395926315789473	94
Q8BXQ8	PF15242	0	306	1.5261237785016293	306	G5BA43	1	307	1.5225765472312704	306
P23798	PF13923	16	55	0.4384500000000001	39	G5BK62	143	182	0.3964000000000001	39
P23798	PF16207	163	227	0.7965846153846153	64	G5BK62	284	348	0.8070153846153844	64
Q61711	PF05432	16	320	0.3607180327868852	304	G5BSU4	17	316	0.16619666666666666	299
Q8BTK5	PF00856	243	294	3.867692307692308	51	G5BCU9	244	295	9.557576923076924	51
Q8BTK5	PF01753	295	334	0.0072000000000000015	39	G5BCU9	296	335	0.011225	39
Q9CQJ8	PF05347	13	72	0.22283333333333336	59	G5AY95	14	73	0.21713333333333326	59
Q99PM9	PF00485	33	215	7.580551912568303	182	G5AQ34	7	189	8.088295081967216	182
Q3TX08	PF00642	600	623	0.0	23	G5BYV5	602	624	0.0	22
Q3TX08	PF02005	61	498	2.708892694063925	437	G5BYV5	25	464	2.5532204545454533	439
A3KFM7	PF00176	473	749	7.251877256317696	276	G5BCX2	531	807	6.6646787003610175	276
A3KFM7	PF00271	783	895	6.664141592920352	112	G5BCX2	841	953	6.654991150442479	112
A3KFM7	PF00385	291	351	2.8874754098360653	60	G5BCX2	349	409	2.8655081967213114	60
A3KFM7	PF00385	374	426	0.11716981132075473	52	G5BCX2	432	484	0.11716981132075473	52
O35640	PF00191	33	89	8.287912280701754	56	G5ATS2	1	57	9.022824561403509	56
O35640	PF00191	96	161	7.3415606060606065	65	G5ATS2	64	129	8.564712121212121	65
O35640	PF00191	180	245	8.339954545454546	65	G5ATS2	148	213	9.112030303030306	65
O35640	PF00191	256	321	1.2793636363636365	65	G5ATS2	224	289	0.8317424242424242	65
P17257	PF11652	88	161	0.0	73	G5BU90	88	161	0.009863013698630137	73
Q80TM6	PF01424	170	217	2.104895833333333	47	G5BED8	171	218	2.105729166666667	47
Q80TM6	PF12752	251	300	0.0	49	G5BED8	252	301	0.0	49
Q8QZY2	PF05161	401	513	2.6267079646017706	112	G5AXM5	402	514	1.7867522123893806	112
Q8QZY2	PF13660	36	287	5.944432539682538	251	G5AXM5	37	288	6.296075396825397	251
Q8BT88	PF15486	6	161	0.015916666666666666	155	G5ARW8	9	164	0.6608205128205128	155
P32848	PF13499	42	101	0.2696500000000001	59	G5BAW1	43	101	1.5948275862068964	58
Q3TPX4	PF07393	89	705	5.138884927066455	616	G5ANI5	78	699	4.803062700964625	621
O35984	PF00046	244	303	0.04893333333333335	59	G5C3I6	370	429	0.048916666666666685	59
O35984	PF03792	60	242	3.964180327868852	182	G5C3I6	1	168	2.143571428571428	167
P47713	PF00168	18	118	5.286712871287127	100	G5C6B8	19	119	5.286653465346533	100
P47713	PF01735	189	672	4.790644628099174	483	G5C6B8	190	674	4.827251546391751	484
Q99NB1	PF00501	108	547	4.820834090909097	439	G5BJV6	94	533	5.926086363636367	439
Q99NB1	PF13193	556	634	9.523848101265823	78	G5BJV6	542	620	9.528050632911397	78
Q99NB1	PF16177	50	106	0.8403157894736847	56	G5BJV6	36	92	0.8803157894736842	56
Q7TNL3	PF00069	79	325	10.327303643724699	246	G5C6G1	89	335	10.373744939271255	246
Q8K1L6	PF15366	47	75	0.0	28	G5BJF9	35	63	0.0	28
Q9R1S0	PF07162	10	173	11.0535243902439	163	G5BKM4	11	174	10.598091463414637	163
Q8VCA8	PF03577	95	198	3.0859615384615378	103	G5BY23	96	199	7.1132500000000025	103
Q0VB07	PF01510	76	211	4.154242647058822	135	G5AYL3	77	213	8.202189781021895	136
Q0VB07	PF01510	232	358	3.9369763779527567	126	G5AYL3	234	360	9.166999999999994	126
Q60992	PF00017	662	736	0.9105466666666666	74	G5B8I3	607	681	0.9232266666666668	74
Q60992	PF00130	513	561	0.3973673469387757	48	G5B8I3	458	506	0.3993673469387753	48
Q60992	PF00169	401	500	13.922089999999999	99	G5B8I3	339	445	14.96469158878505	106
Q60992	PF00621	196	368	3.01142774566474	172	G5B8I3	134	306	2.7519537572254347	172
Q60992	PF07653	580	639	0.30289999999999995	59	G5B8I3	525	584	0.3082833333333334	59
Q60992	PF07653	814	854	0.17453658536585367	40	G5B8I3	759	798	0.183948717948718	39
Q60992	PF11971	68	102	0.01874285714285714	34	G5B8I3	1	35	0.0	34
Q9R1P4	PF00227	28	214	3.3932941176470592	186	G5BUE2	29	215	3.410032085561497	186
Q9R1P4	PF10584	5	27	0.0	22	G5BUE2	6	28	0.0	22
O88346	PF00992	68	204	0.033890510948905106	136	G5BW08	49	185	0.03372262773722628	136
O88346	PF00992	179	250	1.268875	71	G5BW08	160	231	1.2644027777777778	71
Q6PB51	PF15810	138	276	0.006474820143884891	138	G5APY4	99	237	0.006485507246376812	138
Q60795	PF03131	460	550	0.2756593406593407	90	G5BTZ9	638	728	0.6059230769230768	90
P56542	PF03265	21	348	3.70622256097561	327	G5BYW5	22	350	4.23085410334346	328
Q6NZR2	PF13837	144	197	0.0	53	G5C4A0	1	54	0.0	53
Q9Z2D1	PF02893	74	184	0.2617387387387387	110	G5ANX4	75	185	0.24298198198198195	110
Q9Z2D1	PF06602	191	527	4.822433234421365	336	G5ANX4	192	528	4.965127596439171	336
Q9CWR0	PF00621	202	372	5.285865497076023	170	G5BEC6	203	373	5.060871345029239	170
Q9CUU3	PF18581	9	81	10.0308904109589	72	G5BDX9	10	95	0.177906976744186	85
Q9CUU3	PF18584	292	344	4.266132075471698	52	G5BDX9	148	190	5.1930930232558135	42
Q3UYI6	PF19036	10	136	13.06228346456693	126	G5B8Q8	11	137	14.733755905511803	126
Q3UYI6	PF19037	175	267	9.215795698924731	92	G5B8Q8	176	268	8.382806451612902	92
Q3UYI6	PF19038	306	411	10.228981132075472	105	G5B8Q8	307	412	8.541632075471696	105
P46414	PF02234	30	78	0.0	48	G5BYF6	31	79	0.0	48
P99026	PF00227	49	236	1.7660638297872349	187	G5B8M0	50	237	1.4787606382978715	187
Q8BYU6	PF05609	27	500	6.63089873417722	473	G5AYM0	17	462	5.9474843049327335	445
P97929	PF09103	2590	2715	4.213126984126984	125	G5B7X6	2533	2658	5.3047301587301625	125
P97929	PF09104	3004	3101	5.80101020408163	97	G5B7X6	2848	2946	8.690535353535353	98
P97929	PF09121	2751	2792	4.37554761904762	41	G5B7X6	2694	2735	1.199380952380952	41
P97929	PF09169	2402	2523	1.3311147540983608	121	G5B7X6	2402	2522	0.1257107438016529	120
P97929	PF00634	981	1013	0.05030303030303029	32	G5B7X6	1001	1033	0.0	32
P97929	PF00634	1192	1224	0.02651515151515152	32	G5B7X6	1214	1246	0.0	32
P97929	PF00634	1398	1422	0.21296	24	G5B7X6	1461	1485	0.01952	24
P97929	PF00634	1491	1521	0.14693548387096772	30	G5B7X6	1457	1487	0.03935483870967742	30
P97929	PF00634	1624	1653	0.2301	29	G5B7X6	1600	1628	0.3203448275862068	28
P97929	PF00634	1927	1956	0.2469	29	G5B7X6	1931	1960	4.1338	29
P97929	PF00634	2005	2035	1.7508064516129032	30	G5B7X6	2006	2036	0.0	30
G5E872	PF01433	296	481	7.400741935483867	185	G5C3Q5	71	256	7.340860215053767	185
G5E872	PF09127	554	667	4.239956140350877	113	G5C3Q5	329	442	3.740780701754389	113
G5E872	PF17900	226	252	8.628444444444446	26	G5C3Q5	1	27	11.794074074074073	26
Q922Q4	PF03807	2	97	7.9766249999999985	95	G5BAP6	3	98	7.899041666666666	95
Q922Q4	PF14748	163	267	2.2582	104	G5BAP6	164	268	2.257190476190476	104
Q566J8	PF03109	197	312	2.1362241379310345	115	G5C9X2	211	326	1.7616206896551725	115
Q3UK37	PF14970	40	219	6.602205555555559	179	G5AWK3	42	222	4.8420220994475125	180
Q3UK37	PF14971	257	417	0.6899627329192547	160	G5AWK3	300	457	0.8277025316455697	157
P23772	PF00320	262	295	0.0	33	G5BQJ9	264	297	0.0	33
P23772	PF00320	316	348	0.0	32	G5BQJ9	318	350	0.0	32
Q3U2K5	PF02373	175	291	2.7506581196581186	116	G5BIN5	161	277	2.595666666666664	116
Q3U2K5	PF02375	15	49	1.9383714285714289	34	G5BIN5	1	35	0.12257142857142855	34
E9PYH6	PF00076	100	164	0.1973384615384616	64	G5BYD3	101	165	0.1979384615384616	64
E9PYH6	PF00856	1588	1692	0.30431428571428565	104	G5BYD3	1375	1479	0.2959142857142857	104
E9PYH6	PF11764	1490	1521	0.0	31	G5BYD3	1277	1308	0.0	31
Q9D0T2	PF00782	33	165	10.938428571428574	132	G5BWG4	8	140	10.718774436090223	132
P97428	PF00615	63	177	0.14011304347826084	114	G5BE41	64	178	0.21750434782608696	114
Q9ERK4	PF03378	526	961	9.202509174311928	435	G5B9N4	527	962	9.179307339449538	435
Q9ERK4	PF03810	28	100	9.241671232876717	72	G5B9N4	29	101	9.239452054794524	72
Q9ERK4	PF08506	155	524	8.4673972972973	369	G5B9N4	156	525	8.451664864864865	369
Q9WV60	PF00069	55	339	2.624066666666665	284	G5AU96	56	386	2.263842900302114	330
Q9DCN1	PF00293	328	430	8.697116504854371	102	G5B9C4	329	431	7.954699029126212	102
Q9DCN1	PF09296	147	276	14.118238461538462	129	G5B9C4	148	277	13.869384615384615	129
Q9DCN1	PF09297	279	301	0.0	22	G5B9C4	280	302	0.0	22
Q9DCN1	PF12796	17	99	9.41040963855422	82	G5B9C4	18	100	9.320445783132529	82
Q9WUL7	PF00025	3	167	8.139387878787879	164	G5CAI0	3	166	8.247049079754596	163
Q9CX62	PF15342	145	199	0.5917454545454544	54	G5BZX4	146	197	0.0	51
P31750	PF00069	150	407	2.135492248062015	257	G5AWI7	291	548	2.2072131782945736	257
P31750	PF00169	9	105	2.292752577319588	96	G5AWI7	121	246	1.73602380952381	125
P31750	PF00433	428	473	0.11593478260869565	45	G5AWI7	569	614	0.11521739130434785	45
Q60722	PF00010	567	620	13.079740740740741	53	G5B156	515	568	13.087240740740741	53
Q9DBU3	PF01163	264	460	4.0789441624365494	196	G5BTR1	265	461	4.095380710659897	196
Q8R0X2	PF00888	144	297	2.6977792207792204	153	G5BVV6	88	241	2.6908571428571437	153
P08680	PF09029	5	98	2.422904255319149	93	G5B8F5	6	99	1.028404255319149	93
P08680	PF00155	189	535	3.4095994236311267	346	G5B8F5	189	535	3.8479971181556185	346
Q8C0M9	PF01112	71	309	0.5886820083682008	238	G5AYH0	37	275	0.8590502092050208	238
O08908	PF00017	323	398	0.924684210526316	75	G5B4D6	317	372	0.8391071428571426	55
O08908	PF00017	615	689	3.1506399999999988	74	G5B4D6	589	663	3.1311199999999992	74
O08908	PF00620	124	255	2.475022727272728	131	G5B4D6	125	270	0.15769863013698635	145
O08908	PF16454	422	588	3.314718562874252	166	G5B4D6	396	562	3.3145449101796407	166
Q9D489	PF00010	204	250	0.21712765957446808	46	G5B3M6	279	325	1.0177446808510635	46
Q99LN9	PF13646	48	117	1.8533285714285717	69	G5BZC9	49	118	0.12200000000000005	69
Q99LN9	PF13646	194	277	1.0599761904761908	83	G5BZC9	195	278	0.9233809523809514	83
Q9DAG9	PF13771	57	144	7.180249999999997	87	G5BUM0	45	132	6.040556818181818	87
Q62445	PF00096	644	668	0.0	24	G5C8J8	604	628	0.0	24
Q62445	PF00096	674	698	5.906479999999998	24	G5C8J8	634	658	5.1469999999999985	24
Q62445	PF13894	704	726	0.0	22	G5C8J8	664	686	0.0	22
Q9D8P4	PF01196	27	125	0.12274747474747474	98	G5BBQ1	28	126	0.12274747474747474	98
G5E8B9	PF00096	565	587	1.4456521739130437	22	G5C019	568	590	1.6539130434782607	22
G5E8B9	PF00096	703	725	0.0	22	G5C019	706	728	0.0	22
G5E8B9	PF00096	818	842	0.0406	24	G5C019	821	845	0.0406	24
G5E8B9	PF00096	855	876	0.0	21	G5C019	858	879	0.0	21
G5E8B9	PF00096	910	933	0.0	23	G5C019	913	936	0.0	23
G5E8B9	PF00651	203	305	4.551135922330097	102	G5C019	204	306	4.472582524271845	102
G5E8B9	PF13912	593	616	0.0	23	G5C019	596	619	0.0	23
G5E8B9	PF13912	647	669	2.582260869565217	22	G5C019	650	672	2.0999130434782605	22
G5E8B9	PF13912	732	755	0.11616666666666667	23	G5C019	735	758	0.09225	23
G5E8B9	PF17921	67	120	0.0	53	G5C019	68	121	0.0	53
O55123	PF00045	294	336	1.2081627906976742	42	G5BUC3	296	338	1.3613488372093023	42
O55123	PF00045	338	381	7.669318181818181	43	G5BUC3	340	382	11.010976744186046	42
O55123	PF00045	386	432	8.396021276595746	46	G5BUC3	388	434	0.2996808510638298	46
O55123	PF00045	435	472	17.275710526315788	37	G5BUC3	437	474	14.058473684210524	37
O55123	PF00413	107	263	4.302471337579619	156	G5BUC3	108	264	6.302700636942678	156
O55123	PF01471	29	86	0.0	57	G5BUC3	30	87	0.015603448275862072	57
Q9WVS8	PF00069	54	346	5.026433447098979	292	G5BKM3	55	347	5.022143344709897	292
O88907	PF02891	330	378	0.4113469387755102	48	G5C6S3	275	323	0.4122448979591836	48
O88907	PF14324	135	233	2.7668181818181807	98	G5C6S3	125	222	3.3567346938775517	97
Q9DB76	PF03665	2	190	5.7836666666666625	188	G5B295	3	191	3.257518518518521	188
Q80ST9	PF15619	102	294	0.030751295336787582	192	G5BC10	101	293	0.031284974093264244	192
Q3UG20	PF00628	119	164	0.10206521739130434	45	G5BI42	119	164	0.10506521739130437	45
Q3UG20	PF00856	270	444	5.0789657142857125	174	G5BI42	270	444	5.182199999999999	174
Q9D7X8	PF13772	77	159	13.016614457831324	82	G5BRM8	98	180	11.953072289156625	82
Q8R316	PF00505	436	500	9.237476923076922	64	G5C2D3	360	424	9.251969230769232	64
Q8R316	PF08517	245	338	0.29110638297872343	93	G5C2D3	171	264	0.29244680851063826	93
Q9JHW9	PF00171	39	502	5.0025581896551685	463	G5ARZ0	30	529	3.803897999999999	499
O88667	PF00071	92	251	7.7812937500000015	159	G5BDH6	56	215	7.883231249999996	159
Q02105	PF00386	121	242	9.068409836065573	121	G5BHZ7	117	243	7.893496062992126	126
Q02105	PF01391	31	76	0.0	45	G5BHZ7	27	72	0.0	45
Q02105	PF01391	65	103	0.0	38	G5BHZ7	61	98	0.0	37
O70194	PF05091	3	520	0.9025115830115834	517	G5BAW4	4	512	0.9191925343811398	508
Q3UFM5	PF02847	649	728	13.492325	79	G5C8R8	1081	1158	8.835794871794869	77
Q3UFM5	PF02854	356	552	10.632086294416256	196	G5C8R8	788	984	11.076228426395934	196
Q3UJP5	PF14996	63	208	0.0326986301369863	145	G5C4B2	64	208	0.14418055555555553	144
Q9WU79	PF01619	128	572	2.1567730337078657	444	G5CA32	130	574	1.7767999999999986	444
Q8R418	PF00636	1312	1570	4.922714285714283	258	G5B488	1313	1588	4.617344202898553	275
Q8R418	PF00636	1695	1817	2.41820325203252	122	G5B488	1715	1837	2.438943089430893	122
Q8R418	PF00271	441	553	9.744008849557526	112	G5B488	442	554	8.825566371681418	112
Q8R418	PF02170	902	1063	0.08839506172839509	161	G5B488	903	1064	0.08928395061728392	161
Q8R418	PF03368	629	717	6.42523595505618	88	G5B488	630	718	6.4217528089887645	88
Q8R418	PF04851	31	206	13.23261363636364	175	G5B488	32	207	10.695704545454547	175
Q60838	PF00778	12	89	5.655961538461537	77	G5B5A3	13	90	6.022551282051282	77
Q60838	PF00610	435	504	0.8276428571428571	69	G5B5A3	436	505	0.8993142857142858	69
Q60838	PF00595	267	341	9.768493333333328	74	G5B5A3	268	342	8.689919999999997	74
Q60838	PF02377	119	262	0.2329444444444445	143	G5B5A3	120	263	0.43375	143
Q60838	PF12316	514	725	0.458320754716981	211	G5B5A3	515	726	1.0552547169811322	211
Q91YJ5	PF00009	182	339	9.049632911392402	157	G5B8W5	183	340	8.693601265822785	157
Q91YJ5	PF11987	509	605	2.4975670103092784	96	G5B8W5	510	607	2.2869183673469395	97
P28574	PF00010	23	73	0.048627450980392166	50	G5BD09	24	74	0.048627450980392166	50
Q9CXX0	PF15311	211	291	0.0	80	G5AXW1	198	285	0.0	87
Q91ZB0	PF02816	1898	2097	0.5403149999999999	199	G5AYY0	1918	2117	0.575855	199
Q91ZB0	PF07679	14	103	1.6568000000000012	89	G5AYY0	15	104	1.1110777777777778	89
Q91ZB0	PF07679	1775	1846	4.501875	71	G5AYY0	1795	1866	6.278805555555558	71
Q04998	PF00019	318	422	3.4690857142857143	104	G5B6U9	318	422	3.4648000000000003	104
Q04998	PF00688	53	291	2.7176820083682025	238	G5B6U9	54	291	2.7228193277310933	237
Q8VEG6	PF03372	193	528	7.039101190476187	335	G5B4I2	197	532	6.965877976190473	335
Q8VEG6	PF13855	56	113	0.25862068965517243	57	G5B4I2	83	140	0.2593448275862069	57
A2ADA5	PF01416	25	120	1.9298541666666669	95	G5ATQ6	5	100	0.052312500000000005	95
A2ADA5	PF01416	167	284	8.052186440677964	117	G5ATQ6	147	264	5.593059322033898	117
Q9Z0E2	PF00093	52	124	0.15784931506849315	72	G5BTB7	128	200	2.048602739726027	72
Q9Z0E2	PF00093	700	757	0.04601724137931034	57	G5BTB7	738	795	0.0	57
Q9Z0E2	PF00093	786	844	0.0	58	G5BTB7	825	883	0.0	58
Q9Z0E2	PF07452	402	514	7.033610619469028	112	G5BTB7	439	551	4.2874690265486715	112
Q9Z0E2	PF07452	533	640	0.9887962962962962	107	G5BTB7	570	677	3.5376203703703712	107
Q9ERV1	PF00097	237	290	0.06837037037037037	53	G5BJW3	237	290	0.059462962962962974	53
Q9ERV1	PF00642	35	54	0.0	19	G5BJW3	36	53	0.0	17
Q9ERV1	PF00642	168	189	0.4486363636363636	21	G5BJW3	168	189	0.4493181818181818	21
Q9ERV1	PF14608	325	347	0.0	22	G5BJW3	325	347	0.0	22
Q9ERV1	PF18044	5	26	0.0	21	G5BJW3	6	27	0.0	21
Q9CWP8	PF04081	46	90	1.9831111111111104	44	G5BSB2	47	91	0.20188888888888887	44
P28474	PF00107	201	327	9.333244094488192	126	G5AYP9	202	328	9.013968503937004	126
P28474	PF08240	32	152	0.9132479338842976	120	G5AYP9	33	153	1.464338842975207	120
O08582	PF00009	161	382	7.113779279279282	221	G5AYT7	111	332	7.0251846846846835	221
C0HKD9	PF06991	189	398	0.06739047619047618	209	G5BM57	190	399	0.06249047619047619	209
O08750	PF06529	129	460	0.34650602409638553	331	G5C2H2	130	462	0.36260960960960975	332
O08750	PF07716	71	122	0.18038461538461534	51	G5C2H2	72	123	0.18	51
P70436	PF00046	116	172	0.00982456140350877	56	G5C4Q0	130	186	0.00982456140350877	56
P62331	PF00025	1	171	7.643719298245616	170	G5BLM4	2	172	7.644538011695907	170
Q9WU00	PF10491	74	282	2.239535885167464	208	G5BH83	103	311	2.2437464114832544	208
P97443	PF00856	17	50	14.781441176470587	33	G5AQ05	13	46	15.097852941176471	33
P97443	PF01753	51	89	0.3413076923076924	38	G5AQ05	47	85	0.1814102564102564	38
P12242	PF00153	12	103	0.6251956521739128	91	G5BQF5	13	104	1.638478260869565	91
P12242	PF00153	111	204	6.118085106382981	93	G5BQF5	112	205	6.0316702127659525	93
P12242	PF00153	213	298	18.998151162790688	85	G5BQF5	214	299	20.640744186046508	85
Q9D6Y7	PF01625	65	217	2.2853006535947715	152	G5AMH0	2	171	1.1633176470588231	169
B2RXM4	PF05891	65	276	9.015202830188679	211	G5BUS1	66	277	8.3153679245283	211
Q3KNI6	PF18201	114	209	2.0952500000000005	95	G5BZD9	182	277	2.0544791666666664	95
O70492	PF00787	57	146	0.05044444444444445	89	G5B6T1	58	147	0.05044444444444445	89
Q9QZQ0	PF00989	180	232	3.350075471698113	52	G5BG42	42	96	0.0	54
Q9QZQ0	PF08447	347	434	8.65453409090909	87	G5BG42	243	330	9.72393181818182	87
Q9CWY9	PF14766	8	46	0.0	38	G5BW81	9	47	0.0	38
Q9CWY9	PF14767	59	125	0.01201492537313433	66	G5BW81	60	126	1.2180746268656717	66
Q9CWY9	PF14768	135	215	0.9437530864197528	80	G5BW81	136	216	4.787753086419753	80
Q80X44	PF00096	294	314	0.03357142857142857	20	G5BGE0	298	318	0.03380952380952381	20
Q80X44	PF00096	320	342	0.0	22	G5BGE0	324	346	0.0	22
Q80X44	PF00096	348	370	0.03565217391304347	22	G5BGE0	352	374	0.02869565217391305	22
Q80X44	PF00096	376	398	0.0	22	G5BGE0	380	402	0.0	22
Q80X44	PF00096	432	454	0.0	22	G5BGE0	436	458	0.0	22
Q80X44	PF00096	488	510	0.0	22	G5BGE0	492	514	0.0	22
Q80X44	PF00651	26	131	8.689933962264151	105	G5BGE0	28	133	12.316235849056607	105
Q8BUY8	PF04826	582	821	10.814879166666666	239	G5AMR2	591	830	6.7279375	239
Q8CC12	PF15296	789	867	0.31298734177215193	78	G5BM35	530	606	0.5456363636363637	76
Q6P1E1	PF02891	744	792	0.0	48	G5BRK0	718	766	0.0	48
Q6P1E1	PF18028	7	105	1.1899595959595959	98	G5BRK0	8	106	1.1913131313131309	98
Q922M5	PF10497	332	430	0.2817171717171717	98	G5AMI4	419	517	0.26879797979797976	98
O35602	PF00046	136	192	0.9159122807017542	56	G5AYY7	137	193	0.9437368421052632	56
P06745	PF00342	64	545	7.811943983402492	481	G5BXL7	1	482	8.646908713692941	481
Q8C6C9	PF05612	66	310	4.771285714285716	244	G5C4S1	44	258	7.867423255813953	214
Q61792	PF00412	4	58	0.0	54	G5BK68	5	59	0.0	54
Q61792	PF00880	66	93	0.0	27	G5BK68	67	94	0.0	27
Q61792	PF00880	102	129	0.0	27	G5BK68	103	130	0.0	27
Q61792	PF14604	210	260	0.3776470588235295	50	G5BK68	180	230	0.382	50
P35546	PF00028	172	260	2.6779213483146065	88	G5BD17	114	201	3.4527500000000004	87
P35546	PF07714	725	1005	5.0161174377224205	280	G5BD17	667	947	5.020124555160144	280
P35546	PF17756	59	153	16.556905263157894	94	G5BD17	2	95	14.966989361702133	93
P35546	PF17812	265	379	10.582191304347829	114	G5BD17	206	321	1.9720431034482755	115
P35546	PF17813	409	508	6.8423300000000005	99	G5BD17	350	449	5.2003	99
Q9CQD7	PF00021	125	184	1.2897833333333335	59	G5AZN7	126	185	0.2606333333333333	59
Q9CQD7	PF02988	27	107	5.471950617283951	80	G5AZN7	29	108	5.9437	79
Q6ZWZ2	PF00179	12	151	7.004342857142858	139	G5B048	13	152	7.004342857142858	139
Q9D1H9	PF00147	40	254	1.3286558139534888	214	G5BKM2	39	253	1.4209023255813955	214
Q9DAE8	PF14953	36	262	8.393933920704846	226	G5BAM4	1	227	6.819380530973449	226
Q8BMA6	PF16969	73	595	4.642472275334608	522	G5AQV9	70	592	4.674395793499047	522
Q80U59	PF15376	1080	1302	0.0	222	G5B2Z5	334	558	0.0	224
P17751	PF00121	86	294	5.46812918660287	208	G5CAR5	25	233	5.473799043062204	208
Q8VD12	PF12874	74	97	0.0	23	G5BID4	72	95	0.0	23
Q8VD12	PF12874	200	224	0.22768000000000002	24	G5BID4	198	222	0.18484	24
Q8VD12	PF12874	260	284	0.0	24	G5BID4	258	282	0.0	24
Q03526	PF00017	244	327	4.877738095238094	83	G5BKX3	239	323	4.825000000000004	84
Q03526	PF00018	182	228	6.343744680851064	46	G5BKX3	177	223	5.375914893617022	46
Q03526	PF00169	6	113	16.290416666666673	107	G5BKX3	7	108	11.01670588235294	101
Q03526	PF00779	124	152	0.0	28	G5BKX3	119	147	0.09375862068965518	28
Q03526	PF07714	367	616	3.5448560000000007	249	G5BKX3	363	612	3.5380840000000044	249
Q924A0	PF00505	326	393	4.650279411764704	67	G5BKD4	332	399	4.627558823529414	67
Q924A0	PF08347	0	235	0.02086864406779661	235	G5BKD4	1	241	0.5126597510373442	240
Q8CI08	PF15301	130	580	0.04522172949002217	450	G5B8D4	3	454	0.04606430155210643	451
Q8BVN4	PF02536	106	301	0.9956530612244894	195	G5C3R3	132	327	4.988846938775514	195
Q9Z2G9	PF13460	24	138	0.8051565217391294	114	G5AR23	46	160	0.7638086956521741	114
Q9D2H8	PF00041	184	265	10.057317073170733	81	G5B755	187	268	12.137085365853656	81
Q8BQM4	PF13513	52	105	0.0	53	G5C245	53	106	0.0	53
Q9WVA3	PF00400	15	42	8.310535714285718	27	G5AKH0	16	43	8.313428571428574	27
Q9WVA3	PF00400	93	123	0.8354193548387098	30	G5AKH0	94	124	0.8360000000000001	30
Q9WVA3	PF00400	221	261	0.5418536585365854	40	G5AKH0	222	262	0.5420975609756098	40
O70372	PF00078	815	897	1.5812409638554217	82	G5BPI2	481	563	2.2285301204819263	82
O70372	PF12009	450	573	9.968435483870962	123	G5BPI2	55	185	11.445900763358777	130
Q5F2E8	PF00069	27	279	2.3070988142292492	252	G5BVJ8	28	280	2.307885375494071	252
Q9R0Q7	PF04969	5	78	0.14601351351351352	73	G5BB66	5	78	0.14618918918918924	73
G5E8Z2	PF05236	604	844	4.638336099585062	240	G5BJS2	577	817	4.8698755186722025	240
G5E8Z2	PF07531	256	345	0.6293111111111109	89	G5BJS2	224	313	4.195455555555556	89
Q8BVY0	PF00687	48	257	4.433295238095238	209	G5B4G4	45	254	4.348219047619047	209
P15314	PF00605	6	110	1.144990476190476	104	G5ASP5	7	111	1.1453142857142855	104
Q99J45	PF07714	105	320	2.6975370370370397	215	G5BZ10	106	329	2.6372276785714317	223
Q9D0E1	PF00076	72	141	0.05427142857142858	69	G5B4L7	74	143	0.0542	69
Q9D0E1	PF00076	204	272	18.922666666666668	68	G5B4L7	206	274	13.119913043478265	68
Q9D0E1	PF00076	653	720	0.1013676470588235	67	G5B4L7	642	709	0.0996911764705882	67
Q9D0E1	PF11532	39	68	0.0	29	G5B4L7	41	70	0.0	29
Q8BH60	PF00595	290	367	4.0392179487179485	77	G5BBJ9	261	338	4.139935897435898	77
Q6ZQK5	PF00169	267	359	0.1111290322580645	92	G5ALE0	252	344	0.14618279569892473	92
Q6ZQK5	PF01412	400	514	1.563278260869565	114	G5ALE0	385	499	1.5639391304347827	114
Q6ZQK5	PF12796	601	695	1.9465052631578952	94	G5ALE0	594	688	1.948178947368422	94
Q6ZQK5	PF16746	16	237	3.1537477477477487	221	G5ALE0	1	222	4.641432432432433	221
Q06770	PF00079	37	395	8.001596100278555	358	G5AXJ8	42	403	8.52911049723757	361
Q99K90	PF02845	10	37	0.0	27	G5BMC5	11	37	0.0	26
Q8BHS3	PF00076	233	297	4.7763846153846155	64	G5B720	234	298	3.7902307692307695	64
Q9JM76	PF04062	0	172	8.7306416184971	172	G5AWM4	1	173	8.730855491329471	172
P02535	PF00038	144	454	0.22948874598070734	310	G5AX66	125	435	0.2154726688102893	310
Q9CQ90	PF10217	13	101	0.008426966292134831	88	G5AVG5	14	102	0.007887640449438202	88
P52624	PF01048	55	303	3.7542530120481934	248	G5B3U4	56	305	5.197287999999999	249
O70400	PF00412	257	307	10.66394117647059	50	G5C149	260	310	10.664254901960783	50
O70400	PF00595	5	80	0.8447499999999999	75	G5C149	6	81	1.3172105263157898	75
O70400	PF15936	135	229	2.0383263157894738	94	G5C149	138	232	2.026621052631579	94
Q62381	PF00431	348	428	4.679753086419751	80	G5BD30	349	427	7.668924050632907	78
Q62381	PF00431	461	570	1.0535818181818184	109	G5BD30	423	532	0.8942272727272726	109
Q62381	PF00431	617	726	1.9964181818181823	109	G5BD30	579	688	0.23295454545454544	109
Q62381	PF00431	773	881	4.373779816513761	108	G5BD30	735	820	0.029186046511627907	85
Q62381	PF00431	886	999	0.5981666666666671	113	G5BD30	825	938	0.6724824561403508	113
Q62381	PF01400	155	346	5.183651041666668	191	G5BD30	156	347	6.096723958333333	191
Q62381	PF14670	581	613	0.0	32	G5BD30	543	575	0.0	32
Q62381	PF14670	733	768	0.06861111111111111	35	G5BD30	695	730	0.06888888888888889	35
Q9WUU6	PF00104	124	311	6.470255319148935	187	G5AV25	133	320	6.867340425531915	187
Q9WUU6	PF00105	10	77	0.04608823529411765	67	G5AV25	59	125	0.03511940298507462	66
O88866	PF00069	65	319	1.4943568627450992	254	G5BEA3	66	320	1.4936980392156876	254
P58389	PF03095	25	315	11.469491408934712	290	G5ASC4	56	346	9.889432989690713	290
Q9QXV1	PF00385	22	59	2.0138157894736843	37	G5AKP4	1	38	2.046315789473684	37
Q9QXV1	PF17218	321	353	17.167121212121213	32	G5AKP4	323	355	17.209333333333333	32
Q9JJW0	PF02466	25	104	17.790625000000006	79	G5BPU3	26	104	16.74815189873418	78
Q9D9J2	PF15400	127	263	0.0	136	G5BAV7	94	230	0.04651094890510951	136
Q9D684	PF00788	796	883	5.827136363636362	87	G5CBB7	800	887	5.845625000000001	87
Q9D684	PF02204	659	760	11.990176470588233	101	G5CBB7	663	764	11.983127450980387	101
Q8BVD5	PF00595	141	215	0.2674933333333334	74	G5BI27	166	240	3.5454800000000013	74
Q8BVD5	PF00625	381	559	4.444972067039107	178	G5BI27	406	584	4.365435754189944	178
Q8BVD5	PF02828	15	66	0.5214423076923076	51	G5BI27	40	91	0.5152884615384615	51
Q8BVD5	PF02828	83	123	0.7802439024390243	40	G5BI27	108	148	0.7774390243902439	40
Q8BVD5	PF07653	231	294	6.040796874999999	63	G5BI27	256	319	0.62753125	63
Q9WU01	PF00013	61	120	0.0	59	G5C5L5	32	91	0.0	59
Q9WU01	PF16274	30	56	0.09911111111111112	26	G5C5L5	1	27	0.09866666666666668	26
Q9WU01	PF16568	266	320	0.0	54	G5C5L5	237	291	0.0	54
Q8VDM1	PF01585	312	353	0.0280952380952381	41	G5C8C1	310	351	0.02833333333333334	41
Q8VDM1	PF18044	176	197	0.0	21	G5C8C1	174	195	0.007590909090909091	21
Q3UBZ5	PF02854	8	202	9.764107692307693	194	G5BNB8	30	224	11.58424102564103	194
Q64299	PF00007	258	342	0.8689529411764705	84	G5C9R6	160	244	1.0668235294117645	84
Q64299	PF00093	103	166	0.05640625000000001	63	G5C9R6	8	71	0.019125	63
Q64299	PF19035	202	245	0.0	43	G5C9R6	104	147	0.0	43
Q8K0L9	PF00096	577	599	0.0	22	G5AL40	504	526	0.0	22
Q8K0L9	PF00096	605	627	0.0	22	G5AL40	532	554	0.0	22
Q8K0L9	PF00096	633	655	0.0	22	G5AL40	560	582	0.0	22
Q8K0L9	PF00096	661	683	0.0	22	G5AL40	588	610	0.0	22
Q8K0L9	PF00096	714	736	0.5644347826086956	22	G5AL40	641	663	0.4485217391304348	22
Q8K0L9	PF00651	93	195	3.513582524271844	102	G5AL40	21	123	3.5106407766990286	102
Q8BMC1	PF03179	2	106	0.5828571428571429	104	G5B3C3	3	107	0.8781238095238095	104
Q3UQ44	PF00307	44	154	6.168063063063063	110	G5ATK8	18	128	6.79954954954955	110
Q3UQ44	PF00612	691	709	0.07	18	G5ATK8	976	994	0.06973684210526318	18
Q3UQ44	PF00612	721	739	0.055578947368421054	18	G5ATK8	1006	1024	0.04368421052631579	18
Q3UQ44	PF00616	937	1149	1.2065305164319249	212	G5ATK8	1223	1435	0.8081220657276996	212
Q3UQ44	PF03836	1366	1496	0.8588625954198473	130	G5ATK8	1652	1782	0.8552442748091602	130
P21661	PF00082	156	424	3.5200334572490686	268	G5CB99	65	333	3.505070631970262	268
P21661	PF01483	502	588	3.7998390804597717	86	G5CB99	411	497	3.958793103448275	86
P21661	PF16470	92	107	0.0	15	G5CB99	1	16	0.0	15
Q3UHJ0	PF00069	47	306	8.133561538461544	259	G5BNZ4	48	307	8.26099615384616	259
Q9D937	PF17719	13	96	4.256571428571428	83	G5AYI0	22	103	4.104121951219511	81
Q9ES52	PF00017	7	88	5.693146341463412	81	G5BXG5	5	121	4.2557094017093995	116
Q9ES52	PF03372	521	703	2.231721311475411	182	G5BXG5	728	910	2.2188469945355207	182
P70297	PF00018	215	260	2.3175869565217395	45	G5BFE2	263	308	2.3220869565217392	45
P70297	PF00790	6	138	1.2727669172932332	132	G5BFE2	54	186	1.2775263157894738	132
P70297	PF02809	171	186	0.0	15	G5BFE2	219	234	0.0	15
O35613	PF03344	61	150	6.4947666666666715	89	G5BB44	57	145	6.601483146067415	88
Q8BSA9	PF02676	85	188	3.686653846153845	103	G5AQ89	17	119	0.6916893203883495	102
Q6Q6R3	PF00412	4	58	0.22452727272727274	54	G5BNM1	58	112	0.18125454545454547	54
Q9D920	PF10158	60	190	0.5731755725190838	130	G5BYG0	61	191	0.2733129770992365	130
Q6ZQJ5	PF08696	80	281	3.577064356435644	201	G5B7Z7	79	280	3.2296336633663376	201
Q6ZQJ5	PF13086	626	724	8.282666666666666	98	G5B7Z7	626	723	12.431510204081633	97
Q6ZQJ5	PF13086	730	797	3.395941176470589	67	G5B7Z7	730	797	8.44675	67
Q6ZQJ5	PF13087	828	1017	8.762036842105262	189	G5B7Z7	798	956	4.347106918238993	158
Q8K0X8	PF07763	57	295	2.5961255230125526	238	G5APE7	58	296	2.596	238
Q9CX63	PF17736	24	116	3.9035806451612896	92	G5AVE4	6	98	7.971881720430112	92
Q9CX63	PF17736	120	203	0.0	83	G5AVE4	102	184	0.0935180722891566	82
O54836	PF12171	244	270	0.028888888888888888	26	G5C1G4	245	271	0.028888888888888888	26
O54836	PF12874	70	93	0.0	23	G5C1G4	71	94	0.0	23
O54836	PF12874	148	171	0.0	23	G5C1G4	148	171	0.0	23
Q8C0M8	PF00400	531	569	0.28905128205128194	38	G5B058	517	555	0.2891794871794871	38
Q8BP78	PF09725	103	219	0.007418803418803419	116	G5BE85	104	220	0.023085470085470086	116
P58043	PF04636	43	478	4.766467889908255	435	G5AP87	14	449	4.620394495412842	435
Q9DAS9	PF00631	12	71	0.0124	59	G5BSQ4	13	72	0.0	59
P13864	PF00145	1142	1594	2.1526247240618086	452	G5B344	1145	1577	1.7956720554272505	432
P13864	PF01426	757	882	5.779357142857143	125	G5B344	758	884	5.836181102362205	126
P13864	PF01426	935	1101	0.5098323353293412	166	G5B344	937	1104	0.7617559523809526	167
P13864	PF02008	648	693	0.0	45	G5B344	649	694	0.0	45
P13864	PF12047	405	538	12.050970149253725	133	G5B344	402	535	11.180223880597017	133
P13864	PF06464	18	105	0.0	87	G5B344	19	106	0.0	87
Q8VDG6	PF07714	231	381	11.31786092715232	150	G5BUQ0	1	151	8.867754966887418	150
Q9DCG9	PF03966	1	111	0.2881171171171171	110	G5B6P8	2	112	0.05432432432432432	110
E9Q3S4	PF00069	1044	1306	4.35277566539924	262	G5AMN1	993	1255	6.132585551330802	262
P40645	PF00505	619	687	5.521507246376811	68	G5ANG7	473	541	5.503304347826088	68
Q5SUV1	PF04055	43	160	1.4604999999999997	117	G5C4J9	42	159	1.1122796610169479	117
Q5SUV1	PF06969	357	412	0.5000535714285713	55	G5C4J9	354	409	2.1470535714285712	55
P49429	PF00903	18	121	9.399298076923076	103	G5AWN8	19	122	8.823721153846154	103
P49429	PF00903	180	334	2.563496774193548	154	G5AWN8	181	334	1.18001948051948	153
Q3UZW7	PF10294	132	296	11.32578181818182	164	G5B2M7	133	296	12.38421951219512	163
Q3UZW7	PF14904	7	98	5.975065217391305	91	G5B2M7	8	99	2.6499891304347827	91
P30415	PF00160	10	174	7.5997454545454515	164	G5ALX9	11	175	7.604703030303033	164
Q2NKI2	PF00046	100	156	0.011929824561403507	56	G5BVX4	101	157	0.012192982456140351	56
P34928	PF04691	26	86	0.0	60	G5CBM5	27	87	0.22598360655737704	60
Q8C790	PF14753	21	212	0.1974010416666666	191	G5B105	1	192	0.1858802083333333	191
Q91YX0	PF12736	17	234	0.3040733944954127	217	G5AUU6	18	236	0.375785388127854	218
Q91YX0	PF12736	267	519	2.09199604743083	252	G5AUU6	269	517	4.758795180722894	248
Q6P1G2	PF02008	579	623	0.0	44	G5AWN2	689	733	0.0	44
Q6P1G2	PF13621	110	285	1.4321818181818184	175	G5AWN2	186	361	1.4307443181818182	175
Q6P1G2	PF16866	628	694	2.611029850746268	66	G5AWN2	813	879	2.6086268656716425	66
Q6P1G2	PF17811	315	339	25.04468	24	G5AWN2	453	477	27.67956	24
Q8BU30	PF00133	92	571	4.524658333333332	479	G5BZI0	12	522	5.187796477495106	510
Q8BU30	PF08264	692	847	14.131397435897428	155	G5BZI0	587	742	14.178102564102554	155
Q9DBC3	PF01585	86	127	0.014095238095238096	41	G5B9G4	193	234	0.020928571428571432	41
Q9DBC3	PF01728	231	446	9.494027777777776	215	G5B9G4	338	553	9.38762037037037	215
Q61481	PF00233	217	437	5.743221719457017	220	G5BIQ5	198	418	5.5580814479637946	220
Q61481	PF08499	72	132	0.2869836065573771	60	G5BIQ5	53	113	0.2870819672131147	60
Q91VY6	PF00595	77	160	0.5286428571428572	83	G5BQP4	78	161	1.6274285714285708	83
Q9CPP0	PF03066	67	137	0.5551971830985913	70	G5CAG1	1	71	0.16602816901408451	70
P17710	PF00349	77	274	6.693065656565657	197	G5B184	159	356	4.778252525252525	197
P17710	PF00349	525	722	4.544636363636365	197	G5B184	607	804	3.099909090909092	197
P17710	PF03727	280	514	3.615748936170213	234	G5B184	362	596	5.666268085106385	234
P17710	PF03727	728	962	3.857617021276595	234	G5B184	810	1044	3.08287659574468	234
Q9ER56	PF00648	45	338	1.91269387755102	293	G5AMA9	46	339	2.6696972789115647	293
Q9ER56	PF01067	360	456	8.464216494845362	96	G5AMA9	361	459	8.562545454545452	98
Q6PHZ8	PF13499	158	230	0.70213698630137	72	G5C7F4	143	215	0.7074109589041094	72
Q6PHZ8	PF13833	99	146	2.522583333333333	47	G5C7F4	84	131	2.5567083333333342	47
Q8BW94	PF03028	3482	3598	6.260128205128205	116	G5BV95	3466	3582	6.6445897435897425	116
Q8BW94	PF08393	834	1229	4.251929292929291	395	G5BV95	818	1212	2.2950101265822758	394
Q8BW94	PF12774	1357	1683	6.193960244648317	326	G5BV95	1341	1667	4.1392752293577955	326
Q8BW94	PF12775	2003	2179	5.538112994350282	176	G5BV95	1987	2162	3.7820568181818186	175
Q8BW94	PF12777	2644	2989	2.3946936416184976	345	G5BV95	2628	2973	1.7491069364161853	345
Q8BW94	PF12780	2370	2630	8.108509578544059	260	G5BV95	2354	2614	8.454720306513407	260
Q8BW94	PF12781	3019	3239	3.0494615384615384	220	G5BV95	3003	3223	3.1265475113122165	220
Q8BW94	PF17852	1851	1994	14.444805555555556	143	G5BV95	1835	1978	18.216868055555565	143
Q8BW94	PF17857	2213	2309	5.036144329896909	96	G5BV95	2197	2293	5.83537113402062	96
Q8BW94	PF18198	3620	3771	11.34586842105263	151	G5BV95	3604	3755	11.382638157894736	151
Q8BW94	PF18199	3778	4078	4.949820598006641	300	G5BV95	3762	4062	4.8633421926910305	300
Q8CHT1	PF00018	620	664	1.1391111111111112	44	G5ASW9	597	641	1.1371111111111114	44
Q8CHT1	PF00169	491	595	10.724980952380957	104	G5ASW9	468	572	10.72178095238096	104
Q8CHT1	PF00621	277	454	5.021342696629215	177	G5ASW9	254	431	5.041977528089892	177
Q8BMQ2	PF12657	59	249	1.7292251308900537	190	G5AT41	15	205	1.7092565445026175	190
Q8BMQ2	PF12660	733	784	0.17096153846153847	51	G5AT41	687	738	0.17067307692307696	51
P0C7T6	PF08517	466	577	6.918214285714287	111	G5BNU0	468	579	6.960410714285715	111
Q9DBT5	PF00962	333	736	5.860851485148518	403	G5BQX0	370	773	5.7782995049504935	403
P21981	PF00868	4	120	2.761606837606837	116	G5B816	5	121	4.233145299145298	116
P21981	PF00927	472	570	0.03833333333333333	98	G5B816	482	581	0.11849000000000005	99
P21981	PF00927	585	682	0.8592448979591835	97	G5B816	596	693	4.526622448979592	97
P21981	PF01841	271	358	12.083624999999996	87	G5B816	277	364	12.082897727272739	87
Q91WT9	PF00291	80	372	0.9318156996587028	292	G5B2V0	65	357	1.8434982935153583	292
Q91WT9	PF00571	411	463	5.9198867924528304	52	G5B2V0	397	449	7.630886792452832	52
Q60687	PF00007	18	122	1.3560285714285714	104	G5C6P1	18	122	3.6581047619047617	104
P49003	PF00019	350	450	7.925405940594055	100	G5C2E2	353	453	7.916920792079205	100
P49003	PF00688	30	301	5.938169117647061	271	G5C2E2	31	304	7.0326861313868605	273
Q61221	PF00989	93	150	7.821241379310341	57	G5C5I4	98	155	8.684017241379307	57
Q61221	PF08447	253	338	9.176999999999998	85	G5C5I4	258	343	10.289127906976743	85
Q61221	PF08778	799	834	0.0	35	G5C5I4	796	831	0.0	35
Q61221	PF11413	563	592	0.0	29	G5C5I4	555	584	0.0	29
Q99PQ2	PF00622	339	441	12.607339805825243	102	G5C995	309	411	11.073533980582523	102
Q99PQ2	PF00643	88	126	0.0	38	G5C995	89	128	0.17570000000000002	39
Q99PQ2	PF13765	287	334	0.0	47	G5C995	257	304	0.0	47
Q99PQ2	PF15227	15	55	0.02109756097560976	40	G5C995	16	56	0.01697560975609756	40
P97765	PF02893	37	129	0.95047311827957	92	G5BNA1	38	108	0.13180281690140844	70
Q8QZV0	PF01335	25	107	2.9553132530120485	82	G5AZR0	26	108	3.041963855421687	82
Q6V595	PF00651	60	164	9.639361904761904	104	G5BTF1	63	167	3.1072666666666637	104
Q6V595	PF01344	411	451	6.625902439024391	40	G5BTF1	414	454	9.531926829268293	40
Q6V595	PF01344	456	500	0.3847333333333333	44	G5BTF1	459	503	0.3859555555555555	44
Q6V595	PF01344	545	581	16.84654054054054	36	G5BTF1	548	584	16.838702702702705	36
Q6V595	PF07707	171	272	4.975205882352942	101	G5BTF1	174	275	3.994313725490197	101
P26443	PF00208	262	451	1.3883894736842108	189	G5ATF9	255	444	1.4034526315789475	189
P26443	PF02812	112	240	0.0397984496124031	128	G5ATF9	105	233	0.0544108527131783	128
O70273	PF00178	207	287	0.24154320987654326	80	G5AXU9	208	288	0.2394691358024692	80
O70273	PF02198	34	113	0.19996250000000004	79	G5AXU9	35	114	0.197625	79
Q8CFL8	PF04434	533	567	4.64302857142857	34	G5B7P3	531	565	11.6508	34
Q80UK0	PF13716	37	152	17.03236206896552	115	G5BIR5	38	153	17.032767241379307	115
Q8CHU3	PF01417	16	139	7.704266129032257	123	G5BKM5	17	140	7.429137096774193	123
Q8C767	PF03370	126	230	0.1346761904761905	104	G5AV62	80	184	0.15576190476190474	104
Q61171	PF00578	7	139	7.268977443609022	132	G5BYX0	8	140	7.226097744360902	132
Q61171	PF10417	160	195	0.13069444444444445	35	G5BYX0	161	196	0.11825000000000002	35
Q9Z1R4	PF15576	15	263	13.558301204819276	248	G5C3F0	16	264	8.437787148594378	248
Q80W22	PF00291	107	397	12.352474226804128	290	G5AQW7	108	398	9.363766323024057	290
Q80W22	PF14821	2	80	6.426645569620254	78	G5AQW7	3	81	1.293784810126582	78
Q9D075	PF01746	135	306	6.7527674418604615	171	G5C1D6	133	304	9.117331395348842	171
Q8K268	PF00005	195	355	1.8734099378881983	160	G5BTE0	196	356	1.868	160
Q8K268	PF00005	509	638	0.35964615384615384	129	G5BTE0	510	639	0.3591769230769229	129
Q8K268	PF12848	394	472	3.3652911392405063	78	G5BTE0	395	473	3.393303797468353	78
Q9WTU6	PF00069	25	320	4.815932432432433	295	G5C7A6	26	321	5.2558952702702735	295
Q9DCM0	PF00753	36	181	4.292301369863016	145	G5AZP0	37	182	4.11686301369863	145
P83714	PF06875	37	202	2.133457831325302	165	G5BYK0	54	218	1.6673272727272723	164
Q9D572	PF00789	395	466	3.226986111111112	71	G5AUR2	486	557	4.9767361111111095	71
Q9D572	PF08059	231	302	0.21988888888888888	71	G5AUR2	300	370	0.4141971830985916	70
Q9QXK7	PF00753	22	190	7.318585798816569	168	G5BEK4	23	191	7.31930769230769	168
Q9QXK7	PF07521	381	445	0.2582461538461538	64	G5BEK4	382	446	0.25830769230769235	64
Q9QXK7	PF10996	245	366	5.618786885245902	121	G5BEK4	246	367	5.586450819672133	121
Q9QXK7	PF11718	478	681	5.095490196078429	203	G5BEK4	479	682	4.289774509803921	203
Q9JK88	PF00079	26	391	5.794166666666664	365	G5AMJ8	27	392	9.01903825136612	365
O35071	PF00225	10	347	5.277875739644968	337	G5BW92	11	348	5.2802603550295855	337
O35071	PF00498	524	589	0.5350757575757575	65	G5BW92	524	589	3.2168181818181822	65
O35071	PF16183	351	521	0.29060233918128664	170	G5BW92	352	521	0.2898235294117648	169
Q924T7	PF01485	774	834	8.516918032786888	60	G5B293	778	838	10.529229508196721	60
Q924T7	PF09409	70	136	0.4858208955223881	66	G5B293	71	137	5.513089552238807	66
Q924T7	PF16678	476	620	0.3092137931034483	144	G5B293	482	625	3.5386875	143
Q924T7	PF18091	934	1023	5.381833333333334	89	G5B293	939	1028	5.381644444444443	89
Q924T7	PF18486	0	63	0.16171874999999988	63	G5B293	1	64	1.5077500000000017	63
Q922D4	PF04499	129	362	6.650482905982912	233	G5BTV1	130	363	6.45163247863248	233
Q922D4	PF04499	365	511	11.530462585034009	146	G5BTV1	366	512	11.536394557823137	146
O09174	PF02515	2	348	4.900772334293946	346	G5BQ98	3	350	4.78566379310345	347
Q8BML1	PF00307	519	621	7.454456310679611	102	G5C7T6	520	622	7.372339805825244	102
Q8BML1	PF00412	752	808	2.4327894736842106	56	G5C7T6	1003	1059	1.9670526315789476	56
Q8BML1	PF01494	86	123	31.59597368421053	37	G5C7T6	87	124	31.409131578947374	37
Q9D8Q6	PF17721	2	234	0.2849699570815451	232	G5CB13	3	235	0.009525862068965515	232
Q8K2R5	PF00096	83	105	0.0	22	G5BYC9	81	103	0.0	22
Q8K2R5	PF00096	111	133	0.0	22	G5BYC9	109	131	0.0	22
Q8K2R5	PF00096	139	161	0.0	22	G5BYC9	137	159	0.0	22
Q8K2R5	PF00096	167	189	0.0	22	G5BYC9	165	187	0.0	22
Q8K2R5	PF00096	224	245	0.0	21	G5BYC9	222	243	0.0	21
Q8K2R5	PF00096	251	273	0.0	22	G5BYC9	249	271	0.0	22
Q8K2R5	PF00096	280	301	0.0	21	G5BYC9	278	299	0.0	21
Q8K2R5	PF00096	307	329	0.0	22	G5BYC9	305	327	0.0	22
Q8K2R5	PF00096	335	357	2.8453913043478254	22	G5BYC9	333	355	2.827739130434783	22
Q8K2R5	PF00096	363	385	0.0	22	G5BYC9	361	383	0.0	22
Q8K2R5	PF00096	391	413	10.738304347826087	22	G5BYC9	389	411	0.3482608695652174	22
Q8K2R5	PF00096	515	537	3.4976086956521737	22	G5BYC9	506	528	0.16934782608695653	22
Q8K2R5	PF00096	543	565	0.0	22	G5BYC9	534	556	0.0	22
Q8K2R5	PF00096	571	593	0.2744782608695652	22	G5BYC9	562	584	0.2726521739130435	22
Q8C828	PF01344	200	243	4.81925	43	G5AN64	201	244	2.024818181818182	43
Q8C828	PF01344	246	291	1.3510869565217392	45	G5AN64	247	292	1.3150652173913042	45
Q9QY31	PF00096	177	199	0.0	22	G5C2U3	139	161	0.0	22
Q9QY31	PF00096	204	225	0.0	21	G5C2U3	166	187	0.05181818181818183	21
Q9QY31	PF00096	231	253	0.0	22	G5C2U3	193	215	0.0	22
Q9QY31	PF00096	259	277	0.0	18	G5C2U3	221	239	0.0	18
Q9QWY8	PF00169	340	427	8.981897727272726	87	G5B4Q7	328	415	8.992988636363636	87
Q9QWY8	PF00018	1091	1138	6.268083333333332	47	G5B4Q7	1079	1126	6.4276666666666635	47
Q9QWY8	PF01412	454	569	0.4662241379310345	115	G5B4Q7	442	557	0.5096637931034483	115
Q9QWY8	PF12796	600	678	0.04322784810126583	78	G5B4Q7	588	666	0.19292405063291135	78
Q9QWY8	PF16746	62	285	1.9167544642857144	223	G5B4Q7	53	276	1.914946428571428	223
Q6P5F9	PF03810	45	110	8.045075757575757	65	G5C1Y9	46	111	8.046363636363637	65
Q6P5F9	PF08389	123	267	6.568165517241383	144	G5C1Y9	124	273	9.97592666666667	149
Q6P5F9	PF08767	708	1026	14.261169278996865	318	G5C1Y9	714	1032	14.21911285266458	318
Q6P5F9	PF18777	344	380	9.088108108108113	36	G5C1Y9	350	386	9.448756756756756	36
Q6P5F9	PF18784	404	471	10.326279411764704	67	G5C1Y9	410	477	5.751661764705883	67
Q6P5F9	PF18787	484	534	15.73141176470588	50	G5C1Y9	490	540	15.732372549019606	50
Q9D7V1	PF00017	314	389	0.8729736842105261	75	G5ARF1	339	414	0.8044605263157895	75
O88327	PF01044	46	275	3.421191304347828	229	G5BAD1	1	230	3.5342347826086944	229
Q9CZW2	PF05238	56	336	1.8164270462633447	280	G5B1X8	30	312	2.922918439716313	282
A2AQW0	PF00069	660	910	3.085235059760956	250	G5BZ39	503	799	4.696892255892257	296
A2AQW0	PF13281	179	517	6.801265486725668	338	G5BZ39	22	360	10.383421828908553	338
A2AQW0	PF19039	530	626	4.967082474226802	96	G5BZ39	373	469	13.338773195876286	96
Q8R1N4	PF04969	190	268	2.6808607594936706	78	G5BIK7	192	270	1.5349367088607593	78
Q8R1N4	PF14050	8	66	16.407152542372874	58	G5BIK7	9	67	16.254457627118644	58
Q80XN0	PF00106	55	240	3.774091397849461	185	G5ALD6	57	242	4.831666666666665	185
Q8BZF8	PF02878	26	161	1.7455147058823528	135	G5BXE4	1	136	1.7454411764705886	135
Q8BZF8	PF02879	199	305	2.485728971962615	106	G5BXE4	174	280	4.250168224299063	106
Q8BZF8	PF02880	311	424	11.94609649122807	113	G5BXE4	286	399	11.946236842105264	113
Q64287	PF10401	249	416	4.715041666666669	167	G5BSE5	250	417	5.469833333333334	167
Q64287	PF00605	22	127	0.16407547169811326	105	G5BSE5	23	128	0.16407547169811326	105
Q0GNC1	PF02181	590	952	2.2638705234159784	362	G5AWI4	433	795	2.305049586776858	362
Q0GNC1	PF02205	1006	1021	0.0	15	G5AWI4	849	864	0.0	15
Q0GNC1	PF06367	155	339	11.923264864864874	184	G5AWI4	156	340	11.6596	184
Q0GNC1	PF06371	22	151	3.040076923076924	129	G5AWI4	23	152	4.142492307692307	129
Q91XD8	PF00153	45	136	10.62271739130435	91	G5ALW5	6	97	9.357630434782607	91
Q91XD8	PF00153	141	225	8.610705882352944	84	G5ALW5	102	186	8.416129411764706	84
Q91XD8	PF00153	240	319	23.591825	79	G5ALW5	199	277	30.872379746835453	78
Q9D1P4	PF04968	3	63	3.0942786885245903	60	G5BHD8	4	64	3.0739836065573773	60
Q9D1P4	PF04968	154	215	0.07593548387096773	61	G5BHD8	155	216	0.07593548387096773	61
Q9D1P4	PF04969	229	305	7.948506493506493	76	G5BHD8	230	306	7.495090909090909	76
Q5SP85	PF10226	28	218	1.3417748691099471	190	G5BKK0	28	202	2.2439314285714294	174
P84086	PF05835	0	130	0.0203969465648855	130	G5BPY2	1	131	0.0203969465648855	130
Q8C804	PF15678	34	435	0.5866791044776121	401	G5AL26	36	437	0.7989278606965176	401
P55002	PF05507	5	150	4.019390410958902	145	G5BRV2	6	149	3.503402777777779	143
Q922E6	PF06743	444	511	1.6262058823529404	67	G5BH09	366	433	0.1665441176470588	67
Q922E6	PF08373	620	674	12.898181818181815	54	G5BH09	544	598	1.5295454545454543	54
Q9DCK4	PF15909	99	194	0.06026041666666668	95	G5B4L5	107	201	0.0	94
Q3UMY5	PF00400	310	357	0.0	47	G5ANU1	319	366	0.0	47
Q3UMY5	PF00400	513	547	2.0047714285714293	34	G5ANU1	522	556	2.0007999999999995	34
Q3UMY5	PF00400	597	630	1.520323529411765	33	G5ANU1	606	639	13.4325	33
Q3UMY5	PF00400	726	759	0.0	33	G5ANU1	735	767	3.622030303030303	32
Q3UMY5	PF00400	836	873	0.18194736842105266	37	G5ANU1	845	882	0.18165789473684207	37
Q3UMY5	PF03451	236	306	19.426380281690143	70	G5ANU1	245	315	19.43691549295775	70
Q9CRA9	PF05769	1	129	0.3254961240310077	128	G5ATU4	2	129	0.5274062500000001	127
Q3U3S3	PF13092	177	322	2.178965753424657	145	G5ARS9	202	347	1.199116438356164	145
Q8K3A9	PF06859	551	659	6.962889908256883	108	G5AN29	483	591	6.212495412844043	108
Q8K3A9	PF13847	422	474	0.23271698113207545	52	G5AN29	354	405	0.2364807692307692	51
P70661	PF00010	83	133	5.180019607843136	50	G5B187	84	134	6.455490196078433	50
Q6PFX7	PF15439	3	422	0.10560238095238096	419	G5BW17	4	424	0.1049524940617577	420
Q6PFX7	PF15452	571	832	0.07433587786259542	261	G5BW17	945	1210	0.07317735849056606	265
O70161	PF01504	159	440	2.583563829787231	281	G5AKP8	116	397	2.256570921985817	281
Q6KAU4	PF10240	45	296	1.5387579365079367	251	G5BLI1	21	272	1.531611111111112	251
Q810I0	PF07200	45	163	0.10404201680672266	118	G5BG78	138	256	0.09438655462184874	118
O88196	PF13639	1928	1969	0.0	41	G5AXH9	1813	1854	0.0	41
O88196	PF19179	621	736	2.1642155172413786	115	G5AXH9	553	668	3.54955172413793	115
Q8BJ56	PF01734	10	175	2.728710843373494	165	G5C8G3	11	176	2.125771084337348	165
Q64691	PF00648	74	414	3.372941348973609	340	G5BM28	75	415	3.280618768328442	340
Q64691	PF01067	435	573	13.489992805755405	138	G5BM28	436	578	13.115797202797213	142
Q64691	PF13202	793	806	1.227	13	G5BM28	798	811	4.774142857142857	13
Q64691	PF13833	664	722	1.5878305084745759	58	G5BM28	669	727	1.737813559322034	58
Q64691	PF16648	582	652	4.832098591549295	70	G5BM28	587	657	4.8365352112676065	70
Q3TFQ1	PF00622	63	174	0.9537321428571428	111	G5B9Z5	64	175	0.9537321428571428	111
O35718	PF00017	45	126	4.545012195121948	81	G5AVF0	46	127	4.0797439024390245	81
Q61074	PF00481	54	106	1.8971509433962268	52	G5BZ09	1	53	1.1790566037735846	52
Q61074	PF00481	307	485	4.523111731843573	178	G5BZ09	254	432	4.526871508379892	178
Q3UQU0	PF00439	145	227	0.17639759036144578	82	G5BPH6	209	291	0.1732168674698795	82
Q3UQU0	PF12024	285	462	3.792134831460674	177	G5BPH6	356	533	4.2231629213483135	177
Q8R0W1	PF15800	72	408	0.8871691394658759	336	G5B684	38	376	0.9031769911504416	338
P30282	PF00134	81	151	12.865183098591547	70	G5BNJ0	1	71	9.975859154929573	70
P30282	PF02984	156	253	8.274551020408165	97	G5BNJ0	76	173	7.436112244897952	97
Q9JJV1	PF00030	13	97	1.6240117647058834	84	G5AKL2	14	98	0.8784705882352943	84
Q9JJV1	PF00030	106	194	1.2966853932584266	88	G5AKL2	107	195	1.5034494382022467	88
O35098	PF01979	63	452	4.518684615384613	389	G5BFB4	64	453	4.791838461538464	389
Q8R2M2	PF08698	639	732	2.4889468085106383	93	G5AW24	551	644	2.4887978723404247	93
Q8BMQ8	PF19036	115	237	13.969544715447158	122	G5BE12	110	232	13.92556910569106	122
Q8BMQ8	PF19037	282	372	17.555417582417586	90	G5BE12	277	367	14.833461538461535	90
Q8BMQ8	PF19038	414	521	9.946509259259257	107	G5BE12	408	515	9.948074074074077	107
O08859	PF00193	36	127	0.04880434782608696	91	G5B603	37	128	0.043880434782608696	91
O08859	PF00431	134	243	0.3101818181818183	109	G5B603	135	244	0.30130909090909114	109
Q32M08	PF01207	30	291	2.0983282442748097	261	G5BR56	31	292	1.4680763358778623	261
Q64253	PF00021	22	98	0.3847402597402597	76	G5AWG5	23	98	0.6897499999999998	75
Q2PZL6	PF00008	3867	3896	0.067	29	G5B5V9	3865	3894	0.067	29
Q2PZL6	PF00008	4430	4460	0.0	30	G5B5V9	4428	4458	0.0	30
Q2PZL6	PF00028	141	240	0.8189300000000002	99	G5B5V9	142	241	1.9556300000000004	99
Q2PZL6	PF00028	254	342	0.8330674157303373	88	G5B5V9	255	343	0.9863370786516852	88
Q2PZL6	PF00028	364	451	9.321204545454542	87	G5B5V9	365	451	9.431413793103452	86
Q2PZL6	PF00028	479	572	10.332085106382976	93	G5B5V9	479	572	9.332489361702127	93
Q2PZL6	PF00028	587	678	5.556141304347827	91	G5B5V9	587	678	8.346815217391304	91
Q2PZL6	PF00028	693	783	8.80042857142857	90	G5B5V9	693	783	8.720725274725275	90
Q2PZL6	PF00028	797	882	11.725616279069769	85	G5B5V9	797	882	11.973	85
Q2PZL6	PF00028	900	985	8.37943023255814	85	G5B5V9	900	985	9.16829069767442	85
Q2PZL6	PF00028	1000	1089	10.962877777777779	89	G5B5V9	1000	1089	12.204744444444444	89
Q2PZL6	PF00028	1104	1197	8.793670212765957	93	G5B5V9	1104	1197	9.910585106382976	93
Q2PZL6	PF00028	1214	1305	1.9713586956521736	91	G5B5V9	1214	1305	6.580119565217393	91
Q2PZL6	PF00028	1322	1409	4.342897727272727	87	G5B5V9	1322	1409	1.9031931818181815	87
Q2PZL6	PF00028	1427	1516	5.608811111111111	89	G5B5V9	1427	1516	6.4426	89
Q2PZL6	PF00028	1542	1620	14.86851898734177	78	G5B5V9	1542	1620	16.425430379746835	78
Q2PZL6	PF00028	1637	1729	9.353838709677417	92	G5B5V9	1637	1729	7.071677419354835	92
Q2PZL6	PF00028	1747	1830	8.724440476190477	83	G5B5V9	1747	1830	9.01825	83
Q2PZL6	PF00028	1845	1933	25.606528089887643	88	G5B5V9	1845	1933	16.431314606741573	88
Q2PZL6	PF00028	1948	2037	12.647855555555553	89	G5B5V9	1948	2037	13.37127777777778	89
Q2PZL6	PF00028	2057	2144	10.279965909090908	87	G5B5V9	2057	2144	13.112056818181815	87
Q2PZL6	PF00028	2158	2248	5.262835164835165	90	G5B5V9	2158	2248	18.930989010989013	90
Q2PZL6	PF00028	2263	2353	14.886923076923075	90	G5B5V9	2263	2353	9.388439560439563	90
Q2PZL6	PF00028	2368	2443	16.96725	75	G5B5V9	2368	2440	16.637904109589037	72
Q2PZL6	PF00028	2472	2557	8.58346511627907	85	G5B5V9	2470	2555	8.585813953488373	85
Q2PZL6	PF00028	2574	2661	9.651613636363637	87	G5B5V9	2572	2659	9.668829545454543	87
Q2PZL6	PF00028	2678	2765	6.32046590909091	87	G5B5V9	2676	2763	5.827397727272728	87
Q2PZL6	PF00028	2779	2863	5.512070588235294	84	G5B5V9	2777	2861	5.213847058823529	84
Q2PZL6	PF00028	2882	2973	7.792184782608695	91	G5B5V9	2880	2971	7.10107608695652	91
Q2PZL6	PF00028	2993	3081	0.7514382022471914	88	G5B5V9	2991	3079	6.412078651685394	88
Q2PZL6	PF00028	3096	3185	4.519155555555553	89	G5B5V9	3094	3183	10.402377777777778	89
Q2PZL6	PF00028	3203	3288	6.3649999999999975	85	G5B5V9	3201	3286	6.529755813953493	85
Q2PZL6	PF00028	3304	3397	6.474595744680853	93	G5B5V9	3302	3395	6.0201489361702105	93
Q2PZL6	PF00028	3410	3501	12.582532608695653	91	G5B5V9	3408	3499	11.869804347826085	91
Q2PZL6	PF00028	3516	3606	9.451395604395604	90	G5B5V9	3514	3604	11.515197802197795	90
Q2PZL6	PF02210	4003	4143	1.2651205673758863	140	G5B5V9	4001	4141	1.3760780141843976	140
Q2PZL6	PF02210	4251	4373	4.181414634146342	122	G5B5V9	4249	4371	1.9022113821138211	122
Q2PZL6	PF07645	3901	3932	0.0	31	G5B5V9	3899	3930	0.0	31
Q2PZL6	PF12661	4172	4192	0.0	20	G5B5V9	4170	4190	0.0	20
Q924Z6	PF03810	31	95	17.768323076923085	64	G5AJV1	32	96	17.765784615384625	64
Q924Z6	PF08389	102	276	6.017588571428571	174	G5AJV1	103	277	6.0219257142857145	174
P70354	PF00046	87	143	0.9889298245614035	56	G5AVB0	88	144	1.0119473684210525	56
O35239	PF00102	326	572	8.512777327935225	246	G5AL76	306	553	8.329411290322579	247
O35239	PF00650	89	236	15.878101351351352	147	G5AL76	69	216	13.906797297297286	147
O70209	PF00412	245	295	9.264313725490195	50	G5B2W2	292	342	9.194117647058825	50
O70209	PF00595	7	79	3.2346575342465753	72	G5B2W2	8	80	3.2393150684931507	72
O70209	PF15936	136	214	0.027468354430379743	78	G5B2W2	184	262	0.007911392405063292	78
Q8C5W3	PF14560	350	419	6.630271428571428	69	G5APF3	351	420	7.155757142857143	69
Q8C5W3	PF14580	190	303	0.5357894736842105	113	G5APF3	191	304	0.6847192982456141	113
Q8VHZ7	PF04427	89	255	4.385562874251497	166	G5B9W6	90	256	5.168994011976047	166
P46662	PF00373	108	221	8.070684210526322	113	G5APW5	108	221	9.672991228070178	113
P46662	PF09379	28	85	14.009293103448277	57	G5APW5	29	86	13.974758620689654	57
P46662	PF09380	225	313	1.2254943820224722	88	G5APW5	225	313	1.2226292134831462	88
P46662	PF00769	346	577	0.0	231	G5APW5	346	576	0.002662337662337663	230
Q8K3H5	PF00063	339	1039	3.5476604850213977	700	G5AUV9	236	937	5.669330484330479	701
Q8K3H5	PF00069	169	286	0.18552542372881356	117	G5AUV9	66	183	0.21681355932203392	117
Q8K3H5	PF00612	1083	1099	2.931647058823529	16	G5AUV9	981	997	6.018352941176469	16
Q8BGZ7	PF00038	148	461	0.2785382165605097	313	G5B3P5	137	450	1.7724808917197454	313
Q8BGZ7	PF16208	15	145	0.0	130	G5B3P5	16	134	0.0	118
P51880	PF00061	7	130	6.573975806451613	123	G5B3W4	8	131	5.827782258064513	123
P50404	PF00059	272	373	0.2865588235294117	101	G5C4H5	274	375	1.3760396039603962	101
P50404	PF01391	44	95	0.0	51	G5C4H5	46	97	0.0	51
P50404	PF01391	161	218	0.0	57	G5C4H5	163	220	0.0	57
P50404	PF09006	223	266	0.0	43	G5C4H5	225	267	0.0	42
Q9JIX0	PF10163	12	94	0.0	82	G5AVI7	11	93	0.0	82
Q9QZS8	PF00017	214	294	0.4615432098765433	80	G5BLG5	209	289	0.7945061728395062	80
Q9QZS8	PF00617	625	704	6.2674249999999985	79	G5BLG5	620	699	6.258787499999999	79
P61969	PF00412	22	79	6.493948275862071	57	G5BGG2	54	111	6.4715862068965535	57
P61969	PF00412	86	139	0.0	53	G5BGG2	118	171	0.0	53
Q6PCW6	PF04749	22	105	1.1643452380952384	83	G5AZR8	45	128	1.1644642857142855	83
Q8VIK3	PF00538	46	120	0.5149066666666666	74	G5BYE4	7	81	0.2435333333333332	74
A2APV2	PF02181	615	980	3.9521502732240448	365	G5B7R5	569	940	5.0348629032258065	371
A2APV2	PF06367	277	474	4.367964646464647	197	G5B7R5	239	436	4.189489898989898	197
A2APV2	PF06371	39	144	0.9215377358490564	105	G5B7R5	1	106	1.3919811320754718	105
A2APV2	PF06371	217	274	13.374275862068965	57	G5B7R5	179	236	14.548	57
O55234	PF00227	56	237	2.8453021978022006	181	G5ASK0	57	238	3.3103351648351653	181
P11157	PF00268	79	346	9.977854477611947	267	G5B586	79	346	11.932134328358213	267
Q9D428	PF10256	20	131	6.9207321428571404	111	G5BE36	116	227	6.914214285714282	111
P68404	PF00069	343	598	9.509570312499998	255	G5BV64	278	533	9.177773437500004	255
P68404	PF00130	36	78	13.721046511627907	42	G5BV64	38	79	5.879190476190478	41
P68404	PF00130	101	152	4.758384615384615	51	G5BV64	38	89	4.748576923076924	51
P68404	PF00168	172	276	4.7699428571428575	104	G5BV64	109	211	3.8930582524271817	102
P68404	PF00433	624	661	2.9825526315789483	37	G5BV64	558	595	0.09860526315789474	37
Q3TYX3	PF00856	304	349	4.380804347826088	45	G5CBQ5	306	351	3.5820869565217413	45
Q91ZK0	PF03299	210	404	2.005184615384616	194	G5B144	211	405	2.007158974358975	194
P56394	PF05051	18	62	0.0	44	G5AU99	19	63	0.0	44
Q91YE8	PF00595	33	83	0.042647058823529406	50	G5ARW6	14	64	0.13299999999999998	50
Q9JMB1	PF14912	107	126	0.0	19	G5B3S0	11	30	0.0	19
Q9JMB1	PF14912	181	202	0.0	21	G5B3S0	85	105	0.0	20
Q9JMB1	PF14912	208	266	0.016101694915254237	58	G5B3S0	112	170	0.028135593220338973	58
Q9JMB1	PF14912	289	334	0.2620652173913044	45	G5B3S0	193	238	0.26489130434782604	45
Q9JMB1	PF14912	312	368	0.2444385964912281	56	G5B3S0	216	272	0.21429824561403515	56
Q6P5H6	PF00373	101	208	9.71549074074074	107	G5BM59	71	178	9.713731481481481	107
Q6P5H6	PF08736	308	343	0.014777777777777782	35	G5BM59	278	313	0.011083333333333334	35
Q6P5H6	PF09379	31	82	0.07019230769230766	51	G5BM59	1	52	0.03880769230769232	51
Q6P5H6	PF09380	215	300	19.754604651162783	85	G5BM59	185	270	19.747395348837205	85
Q9D9H8	PF10561	126	339	8.114448598130839	213	G5B7W5	160	374	6.489553488372091	214
Q3U1D9	PF15239	7	293	0.159177700348432	286	G5B2W4	8	294	0.3136898954703833	286
Q8CFR0	PF00386	159	283	8.385192000000004	124	G5AW97	135	245	2.7879459459459466	110
Q8BGT8	PF00041	50	139	0.6914777777777777	89	G5BLB9	52	141	0.6931333333333332	89
Q9JLK7	PF13499	85	146	0.0	61	G5AWX0	76	137	0.0	61
Q9JLK7	PF13499	162	225	0.0	63	G5AWX0	153	216	0.0	63
Q7TT50	PF00069	75	341	3.776254681647939	266	G5AWG6	53	311	5.946891891891893	258
Q7TT50	PF00130	1026	1076	2.1718627450980392	50	G5AWG6	996	1046	2.1649019607843134	50
Q7TT50	PF00780	1246	1510	6.814045283018862	264	G5AWG6	1216	1479	5.411840909090905	263
Q7TT50	PF08826	877	938	0.0	61	G5AWG6	847	907	0.017049180327868854	60
Q7TT50	PF15796	526	605	0.0	79	G5AWG6	496	575	0.0	79
Q9QY53	PF00018	160	205	2.2445869565217405	45	G5APS8	175	220	10.908152173913043	45
Q8BPW0	PF15157	3	100	0.0	97	G5BVX9	2	98	3.020670103092784	96
P51910	PF08212	36	181	11.331856164383561	145	E3VX36	37	182	10.641130136986307	145
Q8CJC5	PF07177	19	171	4.217235294117649	152	G5BMV5	46	197	4.299309210526315	151
Q8CJC5	PF13920	194	241	1.0737291666666666	47	G5BMV5	226	273	0.35525	47
Q8R317	PF00240	51	98	14.452124999999995	47	G5BP04	1	48	14.424062499999994	47
Q8R317	PF00627	540	575	0.7461666666666668	35	G5BP04	485	520	0.7438888888888887	35
Q60634	PF01145	16	186	13.09443274853802	170	G5BVI9	1	226	14.925862831858414	225
Q60634	PF15975	312	386	3.032093333333333	74	G5BVI9	352	426	2.9712666666666667	74
Q99KU1	PF01255	31	250	4.961249999999996	219	G5AUR7	14	233	4.556709090909093	219
Q923D4	PF07189	2	78	1.970688311688312	76	G5BL63	3	79	1.9709870129870128	76
Q4VBF2	PF01424	199	238	2.5205500000000005	39	G5C5X7	141	180	3.78265	39
Q4VBF2	PF13902	72	176	2.8356380952380955	104	G5C5X7	31	137	2.932766355140185	106
Q3V2J0	PF06730	5	215	0.22400947867298585	210	G5BJF6	6	237	0.2344827586206896	231
Q9D8S4	PF00929	43	205	2.222447852760737	162	G5B7H2	44	206	2.21879754601227	162
Q99LI8	PF00790	6	138	5.798172932330824	132	G5BJ71	7	139	5.797812030075186	132
Q99LI8	PF01363	161	219	0.24689830508474575	58	G5BJ71	162	220	0.24686440677966104	58
Q99LI8	PF12210	404	498	2.7849789473684194	94	G5BJ71	407	501	3.990884210526315	94
Q9D6D8	PF00160	163	250	0.12195454545454545	87	G5BGE3	111	197	0.07396551724137931	86
Q80Y19	PF00620	65	208	6.481423611111108	143	G5BWE4	66	209	7.471597222222225	143
P54775	PF17862	357	400	7.376181818181819	43	G5APZ6	358	401	7.376181818181819	43
P54775	PF00004	201	334	2.7829477611940288	133	G5APZ6	202	335	2.7769776119402976	133
P54775	PF16450	88	143	1.1856785714285718	55	G5APZ6	89	144	1.0373750000000004	55
A1L317	PF00038	139	450	0.10895192307692307	311	G5AX71	116	429	0.15653821656050956	313
Q6P6L0	PF09727	62	245	7.385038043478263	183	G5BG26	62	245	7.4416413043478284	183
P70677	PF00656	44	274	6.386670995670994	230	G5BGG7	45	275	6.785865800865798	230
Q6P5G3	PF02820	191	249	11.814932203389821	58	G5C4L4	189	247	11.81713559322033	58
Q6P5G3	PF02820	291	354	0.12604687499999995	63	G5C4L4	289	352	0.12337499999999996	63
Q6P5G3	PF02820	390	461	2.754763888888889	71	G5C4L4	388	459	1.8944722222222217	71
Q6P5G3	PF02820	498	563	3.377196969696969	65	G5C4L4	496	561	3.37830303030303	65
P15975	PF00443	322	347	17.230461538461537	25	G5BGX9	1	26	18.971346153846152	25
Q8C165	PF01546	120	239	10.507741666666668	119	G5BX50	115	234	12.627808333333332	119
Q8C165	PF07687	240	383	1.1585000000000008	143	G5BX50	235	378	4.939312500000003	143
Q9CR61	PF05676	39	101	0.7526984126984124	62	G5BYS2	40	102	0.556015873015873	62
Q8BII1	PF05044	466	586	5.641743801652894	120	G5C1L9	131	250	3.4527749999999986	119
Q80U23	PF15290	18	331	0.02392038216560509	313	G5AV74	63	375	0.02044728434504792	312
O08553	PF01979	63	452	4.4056435897435895	389	G5BY99	53	442	4.404051282051283	389
O08691	PF00491	24	317	5.355986394557821	293	G5C7X6	25	317	5.4625938566552925	292
Q8BG31	PF15505	41	119	0.009772151898734177	78	G5AQP1	42	117	0.0	75
Q9EPN1	PF06469	1955	2121	0.20334131736526934	166	G5AVY8	1938	2104	0.2042395209580839	166
Q9EPN1	PF13385	231	391	8.259931677018633	160	G5AVY8	238	398	8.311086956521736	160
Q9EPN1	PF14844	2147	2186	2.839975	39	G5AVY8	2130	2168	2.0422307692307693	38
Q9EPN1	PF15787	462	732	16.33847601476015	270	G5AVY8	469	726	13.648182170542633	257
Q8VIB5	PF00046	229	285	0.035	56	G5BLC2	227	283	0.03508771929824561	56
Q03249	PF01087	23	195	1.2857514450867051	172	G5B064	24	196	2.8568959537572263	172
Q03249	PF02744	202	367	0.9547409638554218	165	G5B064	203	368	0.9195120481927708	165
Q9WTP9	PF00046	102	158	0.012192982456140351	56	G5B4Z0	25	81	0.03491228070175438	56
Q8BYB9	PF05686	49	387	2.556932153392331	338	G5AUA4	50	388	2.987666666666665	338
Q9R1K5	PF00400	306	340	0.26557142857142857	34	G5AKQ5	307	341	0.26542857142857146	34
Q9R1K5	PF00400	346	385	0.025725	39	G5AKQ5	347	386	0.0342	39
Q9R1K5	PF00400	435	470	6.629527777777778	35	G5AKQ5	436	471	6.745055555555553	35
Q9R1K5	PF12894	225	279	3.8300181818181818	54	G5AKQ5	226	280	3.828545454545454	54
Q8VBT2	PF00291	9	303	4.458376271186441	294	G5AKX0	10	304	5.48007118644068	294
Q50L42	PF00168	81	184	7.116538461538463	103	G5BM22	93	196	7.057432692307692	103
Q50L42	PF01735	381	620	6.092558333333337	239	G5BM22	393	632	7.227254166666667	239
Q50L42	PF18695	221	328	4.301425925925926	107	G5BM22	233	340	3.795481481481482	107
Q9D3W5	PF13516	219	239	0.053	20	G5BGA6	218	238	0.0	20
Q9D3W5	PF13516	249	272	2.837916666666666	23	G5BGA6	248	271	34.57016666666667	23
Q9D3W5	PF13516	278	300	9.272695652173912	22	G5BGA6	249	271	36.07321739130435	22
Q9WUP7	PF01088	7	208	7.336301980198018	201	G5ASG5	17	218	6.999777227722772	201
Q9WUP7	PF18031	264	308	0.5090888888888889	44	G5ASG5	311	355	0.5044444444444445	44
B2RR83	PF00270	212	366	6.056632258064514	154	G5BA99	202	356	6.339864516129035	154
B2RR83	PF00271	625	757	11.448563909774439	132	G5BA99	615	747	11.43963909774436	132
B2RR83	PF01424	66	118	0.7994905660377362	52	G5BA99	56	108	0.3598490566037734	52
B2RR83	PF04146	1303	1368	10.234318181818182	65	G5BA99	1292	1357	10.234439393939393	65
B2RR83	PF04146	1375	1433	0.4918813559322035	58	G5BA99	1364	1422	0.4927796610169492	58
B2RR83	PF04408	823	904	15.105109756097562	81	G5BA99	813	893	15.302432098765435	80
B2RR83	PF07717	985	1079	6.6336421052631565	94	G5BA99	974	1068	6.463599999999999	94
Q9CRB0	PF00787	82	101	5.246600000000003	19	G5C8I8	1	20	1.0880500000000002	19
P58686	PF03670	0	82	0.0	82	G5ASF6	1	83	0.0	82
Q9WVH3	PF00250	103	182	0.3609375000000001	79	G5BW33	104	183	0.09245	79
Q9WVH3	PF16676	463	502	0.0	39	G5BW33	462	502	0.0	40
Q9EQ15	PF00400	284	320	22.072081081081084	36	G5CA20	286	322	13.058864864864875	36
Q8BU88	PF00237	70	171	2.745107843137254	101	G5AY04	37	138	2.9123235294117653	101
P48031	PF00046	247	303	0.10064912280701753	56	G5AY44	77	133	0.10478947368421053	56
Q60611	PF16534	72	169	5.474285714285713	97	G5AZC4	73	170	5.476887755102041	97
Q60611	PF16557	176	246	0.4557887323943662	70	G5AZC4	177	247	0.4562535211267605	70
Q60611	PF00046	646	698	0.37649056603773584	52	G5AZC4	548	600	0.3769056603773585	52
Q60611	PF02376	402	444	0.3282325581395349	42	G5AZC4	328	370	0.882906976744186	42
Q60611	PF02376	495	566	0.2297916666666667	71	G5AZC4	402	472	0.2530281690140845	70
Q9DBX7	PF00010	43	98	0.031714285714285716	55	G5C4Y6	44	99	0.03160714285714285	55
Q9DBX7	PF07527	118	156	2.5846153846153848	38	G5C4Y6	119	157	2.572230769230769	38
Q62074	PF00069	254	354	6.161524752475248	100	G5BT66	244	343	6.192869999999999	99
Q62074	PF00130	140	191	0.01480769230769231	51	G5BT66	129	180	0.01480769230769231	51
Q62074	PF00433	549	582	0.0	33	G5BT66	462	495	0.0	33
Q62074	PF00564	25	106	0.030719512195121958	81	G5BT66	14	95	0.08720731707317071	81
Q8C0D0	PF01509	94	242	3.396026845637584	148	G5BKB1	103	251	4.324308724832217	148
P09838	PF10391	249	298	7.7089599999999985	49	G5BEU5	249	298	7.87938	49
P09838	PF14716	164	222	0.1423728813559322	58	G5BEU5	164	221	11.395758620689659	57
P09838	PF14791	445	508	0.948203125	63	G5BEU5	445	508	0.756703125	63
P09838	PF14792	304	374	6.951380281690142	70	G5BEU5	304	374	5.005845070422534	70
P09838	PF00533	31	110	7.706299999999999	79	G5BEU5	32	111	7.586174999999999	79
P54846	PF03131	131	221	0.33808791208791217	90	G5B2A1	132	222	0.33687912087912103	90
P54846	PF08383	67	100	8.513529411764708	33	G5B2A1	68	101	8.457676470588234	33
Q80VA5	PF00018	272	321	4.4786199999999985	49	G5B2D2	282	331	4.5047799999999985	49
Q80VA5	PF07653	179	235	1.8157719298245611	56	G5B2D2	188	245	0.3092931034482759	57
Q80VA5	PF13181	1168	1190	21.008347826086954	22	G5B2D2	1228	1249	10.691636363636364	21
Q3UCQ1	PF00250	247	294	7.022833333333334	47	G5BJA9	117	163	7.197574468085105	46
P52801	PF00812	42	163	4.9909836065573785	121	G5AZK6	1	122	4.507491803278684	121
P34884	PF01187	1	114	1.9344736842105257	113	E3VX64	2	115	1.8562035398230088	113
Q8CGN5	PF03036	14	414	0.3569600997506237	400	G5CA97	15	413	0.6632982456140353	398
Q9R1R2	PF00630	320	414	8.487768421052632	94	G5BBQ9	321	415	8.732842105263156	94
Q9R1R2	PF00643	112	149	0.2844473684210527	37	G5BBQ9	113	150	0.3653421052631579	37
Q9R1R2	PF01436	485	512	0.3071071428571429	27	G5BBQ9	486	513	0.31592857142857145	27
Q9R1R2	PF01436	532	559	3.9248214285714282	27	G5BBQ9	533	560	3.927928571428572	27
Q9R1R2	PF01436	575	601	4.921666666666668	26	G5BBQ9	576	602	4.921592592592593	26
Q9R1R2	PF01436	621	648	0.30789285714285713	27	G5BBQ9	622	649	0.3078214285714286	27
Q9R1R2	PF01436	668	695	0.32089285714285715	27	G5BBQ9	669	696	0.32089285714285715	27
Q9R1R2	PF01436	712	736	0.0	24	G5BBQ9	713	737	0.0	24
Q9R1R2	PF13445	21	59	6.185307692307693	38	G5BBQ9	22	60	4.788384615384615	38
Q9QUP5	PF00193	161	254	0.7283510638297873	93	G5AT32	160	253	0.8510851063829789	93
Q9QUP5	PF00193	269	351	1.3223253012048195	82	G5AT32	268	350	3.5535662650602404	82
Q9QUP5	PF07686	50	144	1.4945473684210526	94	G5AT32	49	143	2.8087789473684213	94
O35929	PF00071	81	237	9.884808917197454	156	G5C6K6	82	235	9.758551948051947	153
P41245	PF00040	229	270	0.0	41	G5B7Q1	230	271	0.0	41
P41245	PF00040	287	328	0.0	41	G5B7Q1	288	329	0.024761904761904763	41
P41245	PF00040	346	387	3.116761904761904	41	G5B7Q1	347	388	7.708095238095237	41
P41245	PF00045	538	581	0.040795454545454544	43	G5B7Q1	513	556	0.4317727272727275	43
P41245	PF00045	585	618	2.7476470588235293	33	G5B7Q1	560	593	5.635147058823527	33
P41245	PF00413	114	228	6.420391304347825	114	G5B7Q1	115	229	6.012034782608698	114
P41245	PF01471	41	94	0.2306481481481481	53	G5B7Q1	41	94	0.4222592592592593	53
Q8BHY2	PF03914	304	452	10.269651006711413	148	G5AWT3	394	542	9.868033557046985	148
Q61576	PF00254	54	118	10.60727692307692	64	G5B0L8	51	114	10.241437500000004	63
Q61576	PF00254	173	257	10.058470588235297	84	G5B0L8	143	227	8.128023529411765	84
Q61576	PF00254	280	369	4.220922222222224	89	G5B0L8	250	339	10.1938	89
Q61576	PF00254	391	481	3.3075824175824176	90	G5B0L8	361	451	3.2941538461538467	90
Q61576	PF13202	503	523	0.3723809523809524	20	G5B0L8	473	493	0.4690476190476191	20
Q61576	PF13202	547	566	0.0	19	G5B0L8	517	536	0.0	19
Q9D9T0	PF05186	0	40	16.484414634146344	40	G5C4I0	1	41	16.788926829268288	40
Q9Z2C8	PF00313	113	163	0.07607843137254901	50	G5B5B0	21	71	0.07764705882352943	50
P54923	PF03747	10	327	6.209842767295597	317	G5AUA2	78	395	6.375748427672956	317
P62492	PF00071	12	172	10.502000000000002	160	G5AN52	13	173	10.391223602484473	160
Q8VED9	PF00337	38	169	5.521621212121207	131	G5BFI1	27	158	5.5274696969697015	131
Q00623	PF01442	77	253	0.03937853107344634	176	G5BQH5	78	254	0.03789265536723165	176
Q80Y73	PF17664	0	167	4.185357142857141	167	G5CB08	1	193	2.8778489583333347	192
P97393	PF00071	154	245	6.667358695652172	91	G5AZT5	155	246	10.279576086956524	91
P97393	PF00620	1273	1421	1.3398859060402688	148	G5AZT5	1276	1424	1.3968389261744965	148
P97393	PF01846	484	544	0.0016229508196721313	60	G5AZT5	485	545	0.1990983606557377	60
P97393	PF16512	259	337	3.757481012658227	78	G5AZT5	260	338	3.7668860759493663	78
Q91WI7	PF15907	48	381	8.28694610778443	333	G5AS18	49	383	7.657644776119403	334
Q9D0K1	PF04088	118	255	10.397086956521742	137	G5C1Z7	88	225	10.446007246376816	137
Q9D0K1	PF14604	280	333	1.8328888888888888	53	G5C1Z7	250	303	2.9559444444444445	53
Q3U5Q7	PF02223	256	409	5.2689740259740265	153	G5C0Z0	80	232	6.506026315789474	152
Q6PAQ4	PF00929	254	403	0.322	149	G5B8H5	241	390	0.42286666666666667	149
Q69Z99	PF00096	290	312	0.0	22	G5BA49	209	231	0.0	22
O70456	PF00244	8	230	1.8583273542600895	222	G5AUS2	9	231	1.8620672645739915	222
P17125	PF00019	311	406	8.14878125	95	G5B691	253	347	8.236473684210527	94
P17125	PF00688	59	250	2.1302916666666665	191	G5B691	1	192	2.1314895833333334	191
Q3UYK3	PF00566	518	720	25.15032019704434	202	G5BLU0	512	714	25.15287684729064	202
Q3UYK3	PF02893	146	249	8.886278846153846	103	G5BLU0	140	243	18.948019230769226	103
Q3UYK3	PF02893	295	401	5.018252336448602	106	G5BLU0	289	395	5.022738317757013	106
Q9QXG9	PF14973	19	157	7.614215827338133	138	G5B281	20	168	1.279879194630872	148
A2RT62	PF13516	318	339	0.031090909090909093	21	G5BXV6	318	339	0.031090909090909093	21
A2RT62	PF13516	345	360	0.0	15	G5BXV6	345	360	0.0	15
A2RT62	PF13516	396	417	0.03545454545454545	21	G5BXV6	396	417	0.03545454545454545	21
P62309	PF01423	7	60	4.275759259259258	53	G5C6V2	8	60	0.3693076923076923	52
Q68FF6	PF12205	647	762	0.5979741379310345	115	G5BVP2	669	784	0.7355086206896551	115
Q68FF6	PF01412	17	118	1.3494117647058823	101	G5BVP2	39	140	1.343705882352941	101
Q68FF6	PF08518	272	300	0.0	28	G5BVP2	294	322	0.0	28
Q68FF6	PF08518	336	364	16.026689655172415	28	G5BVP2	358	386	16.009689655172416	28
Q68FF6	PF12796	136	225	4.812655555555555	89	G5BVP2	158	247	4.809166666666667	89
Q68FF6	PF16559	417	481	0.0	64	G5BVP2	439	503	0.0	64
P63242	PF01287	82	149	8.32875	67	G5B5B1	91	158	8.403941176470589	67
P70697	PF01208	14	359	4.617783236994222	345	G5ARU6	15	360	4.671647398843935	345
Q99PN3	PF00622	440	536	9.055804123711342	96	G5C3B0	442	538	1.1529793814432994	96
Q99PN3	PF00643	97	135	3.591692307692308	38	G5C3B0	98	136	4.502564102564103	38
Q99PN3	PF13765	320	368	0.9872857142857144	48	G5C3B0	315	363	1.0116938775510202	48
Q99PN3	PF15227	15	55	0.0	40	G5C3B0	16	56	0.0	40
P09023	PF00046	146	202	0.07882456140350877	56	G5C4M4	147	203	0.07882456140350877	56
Q923B0	PF06094	3	118	5.27525	115	G5B1U6	4	119	5.6596034482758615	115
Q8BGF3	PF00400	102	144	0.29313953488372096	42	G5BA14	103	145	0.3882093023255813	42
P18760	PF00241	26	145	9.4538	119	G5B6J0	32	151	9.757725	119
Q6P4T2	PF00270	482	657	2.32553409090909	175	G5BMV9	483	658	2.32634090909091	175
Q6P4T2	PF00270	1329	1495	4.637844311377247	166	G5BMV9	1330	1496	4.692904191616762	166
Q6P4T2	PF00271	713	857	9.688103448275859	144	G5BMV9	714	858	8.865806896551724	144
Q6P4T2	PF02889	981	1284	5.018055921052628	303	G5BMV9	982	1285	5.017559210526313	303
Q6P4T2	PF02889	1811	2122	6.8905961538461575	311	G5BMV9	1812	2123	6.890724358974363	311
Q6P4T2	PF18149	253	362	16.699299999999994	109	G5BMV9	254	363	16.687790909090914	109
Q9ER71	PF00071	22	193	10.552401162790703	171	G5BCY9	24	195	10.943546511627906	171
P04627	PF00130	98	144	22.21702127659575	46	G5B0C3	99	145	22.2166170212766	46
P04627	PF02196	19	88	2.7511428571428564	69	G5B0C3	20	89	2.7534285714285702	69
P04627	PF07714	308	562	9.2440274509804	254	G5B0C3	311	565	12.750407843137259	254
Q8CBY8	PF05502	22	123	0.14026470588235296	101	G5B721	23	124	0.13533333333333336	101
Q8CBY8	PF05502	226	347	3.768729508196721	121	G5B721	227	348	3.7763360655737706	121
P97350	PF00514	279	315	0.05059459459459459	36	G5B3A4	279	315	0.05037837837837839	36
P97350	PF00514	320	359	0.80435	39	G5B3A4	320	359	0.7072	39
Q6NXY9	PF11705	5	208	0.3218578431372549	203	G5BBF6	6	211	0.4338786407766991	205
Q3UPP8	PF17045	17	279	0.0037262357414448674	262	G5BL13	18	280	0.0	262
Q5DTW7	PF15395	450	1510	0.7912082940622056	1060	G5AUM0	450	1510	1.065558906691799	1060
Q8R104	PF02146	79	260	5.472054945054946	181	G5AUC0	51	232	4.913912087912088	181
Q9DBR3	PF00514	49	90	15.726142857142856	41	G5BPK7	50	91	15.83885714285715	41
Q8K2D0	PF15814	65	387	0.11069349845201236	322	G5B0X3	1	323	0.11147204968944104	322
P54071	PF00180	47	440	2.9118578680203044	393	G5CAA4	48	441	2.9005786802030484	393
Q9DAJ5	PF03259	3	91	10.092494382022476	88	G5B1Y1	80	168	10.002494382022473	88
Q9D0G0	PF07147	0	422	3.8266855791962175	422	G5ARL4	1	421	4.822950118764845	420
P20444	PF00069	340	582	10.423876543209873	242	G5BIH8	260	481	7.5543738738738755	221
P20444	PF00130	36	78	13.700372093023255	42	G5BIH8	21	62	5.8685238095238095	41
P20444	PF00130	101	152	4.747653846153846	51	G5BIH8	21	72	4.739961538461538	51
P20444	PF00168	171	275	0.03961904761904761	104	G5BIH8	91	195	0.03952380952380953	104
P20444	PF00433	623	657	1.0916	34	G5BIH8	522	556	1.0961714285714288	34
P41971	PF00178	6	84	7.478443037974683	78	G5C0S7	7	85	9.668088607594939	78
Q91X84	PF12884	43	63	0.0	20	G5B1S7	1	21	0.0	20
Q91X84	PF12885	158	317	0.04646875	159	G5B1S7	117	275	0.04635220125786164	158
Q91X84	PF12886	544	618	0.0	74	G5B1S7	503	577	0.0	74
P23906	PF00605	6	110	0.0	104	G5CAL3	7	111	0.0	104
Q91WG7	PF00130	268	317	0.11234000000000001	49	G5BT94	272	321	0.18248	49
Q91WG7	PF00609	574	748	0.2995142857142858	174	G5BT94	579	753	0.2988114285714284	174
Q91WG7	PF00781	430	541	4.7026607142857175	111	G5BT94	435	546	4.774901785714289	111
Q91WG7	PF14513	4	171	7.822374999999997	167	G5BT94	5	175	8.588257309941522	170
O54791	PF03131	23	114	0.03496739130434783	91	G5AYS7	94	185	0.034391304347826085	91
Q6A028	PF00169	210	304	5.2999263157894765	94	G5BRL1	211	305	4.1723263157894745	94
Q8VDG5	PF04127	35	82	29.35022916666667	47	G5AQI7	36	83	29.02135416666667	47
Q8VDG5	PF04127	158	261	14.180394230769231	103	G5AQI7	159	262	10.603	103
Q3U6Q4	PF10486	28	291	6.697075757575754	263	G5B5G6	36	289	4.920633858267715	253
Q3U6Q4	PF10486	410	752	4.049588921282799	342	G5B5G6	411	747	6.103735905044518	336
Q149T7	PF00481	226	309	9.835	83	G5BNW2	146	229	9.917023809523807	83
Q149T7	PF00481	370	454	0.792458823529412	84	G5BNW2	290	374	0.8832000000000002	84
Q99KN1	PF00339	38	138	5.744297029702972	100	G5BG03	172	272	6.940920792079207	100
Q99KN1	PF02752	162	283	3.596844262295083	121	G5BG03	296	417	3.949901639344261	121
Q8BLB7	PF00536	808	872	4.676738461538461	64	G5C769	706	770	4.713338461538462	64
Q8BLB7	PF02820	267	335	6.36427536231884	68	G5C769	268	336	8.96231884057971	68
Q8BLB7	PF02820	374	441	7.657249999999999	67	G5C769	375	442	9.111485294117646	67
Q8BLB7	PF02820	478	543	0.7708333333333335	65	G5C769	479	544	0.6934848484848484	65
Q8BH74	PF04121	210	908	6.727456366237483	698	G5BBG9	202	937	7.782322010869555	735
Q3U133	PF00096	518	538	0.0	20	G5AML8	507	527	0.05247619047619048	20
Q3U133	PF00096	544	566	0.0	22	G5AML8	469	499	0.0	30
Q3U133	PF00096	572	594	0.1197826086956522	22	G5AML8	505	527	0.09582608695652174	22
Q3U133	PF01352	107	135	0.06017241379310345	28	G5AML8	122	150	0.06017241379310345	28
Q3U133	PF12417	24	79	6.8842678571428575	55	G5AML8	27	82	6.881214285714284	55
Q3U133	PF13912	453	466	0.029571428571428575	13	G5AML8	469	481	0.0	12
Q64012	PF00076	22	84	1.8813015873015868	62	G5BPU0	23	85	0.9513650793650796	62
Q99KF0	PF00619	19	104	4.901081395348838	85	G5AKN7	20	105	4.377616279069767	85
Q61839	PF00212	95	125	0.0	30	G5ASX7	96	126	0.0	30
Q922B9	PF14722	146	297	1.4027631578947368	151	G5BIQ7	159	309	1.4174172185430465	150
Q922B9	PF14723	951	1028	0.0	77	G5BIQ7	827	904	0.07057692307692309	77
Q9WUQ5	PF00048	22	85	4.8799375000000005	63	G5BX11	23	86	4.786390625000001	63
Q99LP6	PF01025	57	214	2.9603101265822787	157	G5B2Z9	71	228	3.225455696202532	157
Q8K1I7	PF02205	30	54	0.0	24	G5C941	31	55	0.0	24
Q3UGF1	PF15911	507	563	0.06935087719298245	56	G5C3V1	512	568	0.08478947368421053	56
Q6IFZ9	PF00038	104	417	0.8427643312101915	313	G5ALS5	139	452	0.8395859872611463	313
Q6IFZ9	PF16208	7	101	0.3788315789473684	94	G5ALS5	40	136	0.1560721649484536	96
Q499E6	PF15011	12	173	0.1841728395061729	161	G5C6H3	13	183	0.11246783625730998	170
Q641P0	PF00022	11	408	6.09563567839196	397	G5AMV2	1	398	6.106128140703522	397
Q8CEQ0	PF00069	3	286	2.9110950704225345	283	G5BLM9	4	287	2.905461267605633	283
E9Q5C9	PF05022	626	698	0.041301369863013686	72	G5CAG8	623	695	0.040547945205479455	72
Q923E4	PF02146	355	438	7.193928571428573	83	G5B7Y9	20	103	7.190500000000003	83
Q80X90	PF00307	16	121	9.937471698113212	105	G5BMH1	17	122	9.968150943396227	105
Q80X90	PF00307	139	238	1.24413	99	G5BMH1	140	239	1.2445000000000002	99
Q80X90	PF00630	252	343	9.019749999999998	91	G5BMH1	253	344	7.5749782608695675	91
Q80X90	PF00630	351	441	0.014802197802197803	90	G5BMH1	352	443	1.3274456521739133	91
Q80X90	PF00630	449	539	2.037362637362637	90	G5BMH1	451	541	2.0904175824175826	90
Q80X90	PF00630	548	631	0.5680833333333334	83	G5BMH1	550	633	0.2978333333333333	83
Q80X90	PF00630	642	732	5.120142857142857	90	G5BMH1	644	734	5.596934065934067	90
Q80X90	PF00630	739	835	0.8419690721649484	96	G5BMH1	741	837	0.8422371134020619	96
Q80X90	PF00630	843	934	3.630826086956522	91	G5BMH1	845	936	4.024434782608696	91
Q80X90	PF00630	942	1030	0.0334494382022472	88	G5BMH1	944	1032	0.014235955056179774	88
Q80X90	PF00630	1037	1123	4.6864597701149435	86	G5BMH1	1039	1125	4.687045977011494	86
Q80X90	PF00630	1130	1216	0.6211494252873563	86	G5BMH1	1132	1218	0.5503333333333332	86
Q80X90	PF00630	1225	1318	0.0	93	G5BMH1	1227	1320	0.0	93
Q80X90	PF00630	1325	1411	5.447172413793101	86	G5BMH1	1327	1413	5.449620689655171	86
Q80X90	PF00630	1418	1507	1.1063333333333332	89	G5BMH1	1420	1540	0.21345454545454548	120
Q80X90	PF00630	1514	1604	1.644043956043956	90	G5BMH1	1547	1637	1.6338241758241754	90
Q80X90	PF00630	1611	1700	11.452111111111105	89	G5BMH1	1644	1733	9.106466666666664	89
Q80X90	PF00630	1764	1811	0.21425	47	G5BMH1	1797	1844	0.3983125	47
Q80X90	PF00630	1822	1904	8.826144578313254	82	G5BMH1	1855	1937	8.82760240963855	82
Q80X90	PF00630	2000	2085	2.8269767441860467	85	G5BMH1	2033	2118	2.8275232558139543	85
Q80X90	PF00630	2126	2181	0.11521428571428573	55	G5BMH1	2159	2214	0.3307321428571429	55
Q80X90	PF00630	2192	2275	0.4606666666666666	83	G5BMH1	2225	2308	0.4608452380952381	83
Q80X90	PF00630	2298	2371	0.02439189189189189	73	G5BMH1	2331	2404	0.024459459459459463	73
Q80X90	PF00630	2383	2467	1.0032705882352941	84	G5BMH1	2416	2500	1.5530823529411768	84
Q80X90	PF00630	2509	2597	12.426932584269665	88	G5BMH1	2542	2630	12.43802247191011	88
O54804	PF01633	134	369	2.7323135593220305	235	G5BTV5	85	271	3.4496524064171115	186
Q60952	PF15035	38	211	0.0741206896551724	173	G5B851	40	213	0.22339655172413792	173
P59808	PF00536	627	685	9.558610169491526	58	G5BMC3	804	862	9.554338983050847	58
P59808	PF07647	1162	1219	1.0220689655172412	57	G5BMC3	1347	1404	1.0140517241379308	57
P59808	PF07653	550	602	14.058132075471699	52	G5BMC3	727	779	15.79764150943396	52
P59808	PF12485	393	547	0.8970709677419356	154	G5BMC3	570	724	0.8916451612903227	154
Q8C0D5	PF00009	17	261	3.3805877551020407	244	G5BEZ7	18	262	3.770212244897957	244
Q8C0D5	PF00679	986	1070	2.19315294117647	84	G5BEZ7	987	1071	2.151117647058824	84
Q8C0D5	PF14492	614	677	1.5913437499999998	63	G5BEZ7	614	677	1.5478437499999995	63
P84099	PF01280	3	144	0.0	141	G5BRW3	4	145	0.0	141
P54731	PF00789	567	645	3.1793417721518984	78	G5C4G2	569	647	3.0413164556962022	78
P54731	PF14555	10	41	2.36975	31	G5C4G2	11	42	2.3943125	31
Q5DTT2	PF01369	556	702	8.007517006802722	146	G5CAH2	555	712	7.515183544303797	157
Q5DTT2	PF15410	757	868	4.3686875	111	G5CAH2	848	959	4.912401785714286	111
Q8BQ47	PF11938	42	198	0.023796178343949047	156	G5AN18	36	192	0.023700636942675157	156
Q14CH7	PF01411	73	617	3.5685706422018337	544	G5BNP3	1	572	3.292533216783214	571
Q14CH7	PF07973	725	772	4.161187500000001	47	G5BNP3	680	727	3.6022708333333333	47
O35701	PF00092	77	249	7.0946300578034736	172	G5AZA6	13	185	7.1051213872832415	172
O35701	PF10393	437	463	0.2487037037037037	26	G5AZA6	331	356	0.3949230769230768	25
O35701	PF12662	282	302	0.0	20	G5AZA6	218	238	0.0	20
O35701	PF12662	407	429	0.0	22	G5AZA6	301	323	0.0	22
O35701	PF14670	346	382	0.0	36	G5AZA6	240	276	0.0	36
Q9Z132	PF00090	150	200	0.0	50	G5C6H2	152	202	0.0	50
Q9Z132	PF15913	41	141	4.699534653465347	100	G5C6H2	43	143	4.734534653465347	100
P29477	PF02898	130	490	0.8720720221606652	360	G5BVM9	137	509	0.8967184986595179	372
P29477	PF00175	972	1085	1.0782543859649123	113	G5BVM9	1001	1114	1.5615000000000006	113
P29477	PF00258	534	665	12.048848484848488	131	G5BVM9	553	694	6.972133802816901	141
P29477	PF00667	720	940	6.768873303167425	220	G5BVM9	749	969	5.1036244343891415	220
Q9D4H8	PF00888	13	643	8.350510301109356	630	G5BI23	14	644	8.287261489698897	630
Q9D4H8	PF10557	674	734	0.2402786885245901	60	G5BI23	675	735	0.2360163934426229	60
Q8BRN9	PF00168	691	802	0.4813839285714288	111	G5AUI3	706	817	0.399723214285714	111
Q9JJR9	PF09668	104	207	1.6379423076923072	103	G5BUX0	286	389	4.0047500000000005	103
Q60987	PF00250	171	255	3.6221294117647047	84	G5C2K9	89	173	3.616435294117648	84
O88566	PF00615	80	197	2.275661016949153	117	G5BGY5	81	198	1.5528220338983056	117
O88566	PF00778	759	836	8.728653846153849	77	G5BGY5	754	831	8.728692307692308	77
O88566	PF08833	432	468	0.0	36	G5BGY5	433	469	0.0	36
O88566	PF16646	9	72	0.07378124999999999	63	G5BGY5	10	73	0.0	63
B9EKI3	PF12325	1001	1084	0.08588095238095238	83	G5AVQ7	755	838	0.08608333333333333	83
Q9EQ32	PF14545	180	318	4.655388489208632	138	G5BEU1	174	312	4.852647482014387	138
Q9EQ32	PF18567	10	141	10.340371212121207	131	G5BEU1	7	138	9.10385606060606	131
P62320	PF01423	8	71	2.1016875	63	G5B630	9	72	2.2063593749999995	63
P97328	PF00294	3	288	8.286398601398602	285	G5BYZ2	4	289	9.332262237762238	285
P22907	PF01379	20	230	5.295151658767772	210	G5BHN5	21	231	5.31062085308057	210
P22907	PF03900	244	318	1.0333466666666666	74	G5BHN5	245	319	1.2297333333333336	74
P54823	PF00270	120	285	1.1882710843373496	165	G5BHM5	121	286	1.1882710843373496	165
P54823	PF00271	322	428	4.4440841121495325	106	G5BHM5	323	429	4.4440841121495325	106
Q9D8I1	PF11938	47	176	0.3428076923076924	129	G5AZ71	46	175	1.0778923076923073	129
E9PUQ8	PF00130	163	213	0.26276470588235296	50	G5BXG2	122	172	0.021235294117647064	50
E9PUQ8	PF00130	235	286	0.0	51	G5BXG2	194	266	3.971027397260274	72
E9PUQ8	PF00169	54	143	1.5026444444444444	89	G5BXG2	13	102	1.8850222222222224	89
E9PUQ8	PF00609	764	920	4.753547770700639	156	G5BXG2	746	948	9.43518226600985	202
E9PUQ8	PF00781	320	432	5.052991150442477	112	G5BXG2	300	412	5.068044247787607	112
E9PUQ8	PF07647	1147	1210	0.13203125000000002	63	G5BXG2	1165	1228	0.13203125000000002	63
O89091	PF00096	368	391	0.0	23	G5C0G9	270	293	0.0	23
O89091	PF00096	397	421	0.0	24	G5C0G9	299	323	0.0	24
O89091	PF00096	427	449	0.0	22	G5C0G9	329	351	0.0	22
Q61129	PF00057	230	260	0.0	30	G5AQM1	204	234	0.05780645161290322	30
Q61129	PF00057	263	297	0.0	34	G5AQM1	237	271	0.0	34
Q61129	PF00089	360	588	8.171432314410477	228	G5AQM1	319	547	8.515489082969433	228
Q61129	PF00530	123	218	0.4594270833333333	95	G5AQM1	97	192	1.3574166666666665	95
Q61129	PF07648	67	108	0.0	41	G5AQM1	41	82	0.0	41
Q8BM14	PF00561	77	376	6.9523166666666665	299	G5BT04	79	378	6.7318833333333385	299
Q9CZ09	PF06325	177	213	0.3087297297297297	36	G5B148	123	159	1.665108108108108	36
Q9Z277	PF00439	1343	1426	0.06934523809523807	83	G5BG74	1345	1428	0.04120238095238096	83
Q9Z277	PF00628	1185	1232	0.2366666666666667	47	G5BG74	1184	1231	0.2369375	47
Q9Z277	PF10537	21	118	0.2208265306122448	97	G5BG74	22	119	0.2743877551020407	97
Q9Z277	PF15612	727	767	5.527268292682927	40	G5BG74	726	766	8.250951219512197	40
Q9Z277	PF15613	899	1023	3.2939200000000013	124	G5BG74	898	1022	2.56212	124
P27889	PF04812	313	550	0.6778067226890757	237	G5B247	314	550	0.6862827004219412	236
P27889	PF04814	7	173	3.047724550898204	166	G5B247	8	174	3.05902994011976	166
Q8BMJ2	PF00133	20	104	0.5168117647058824	84	G5C840	21	103	0.5290843373493977	82
Q8BMJ2	PF00133	189	756	4.16770950704225	567	G5C840	188	755	5.034825704225349	567
Q8BMJ2	PF08264	795	911	12.489273504273507	116	G5C840	794	863	0.018771428571428567	69
Q8C9J3	PF00406	613	679	13.804537313432837	66	G5C9H1	601	666	10.760272727272728	65
Q8C9J3	PF06294	4	100	4.974969072164948	96	G5C9H1	5	101	4.057340206185566	96
Q8C854	PF00076	92	161	0.08365714285714287	69	G5BR19	70	139	0.07988571428571427	69
Q8C854	PF00076	225	293	6.251768115942029	68	G5BR19	203	271	5.4860579710144926	68
Q8C854	PF00076	515	582	0.0294264705882353	67	G5BR19	469	536	0.0294264705882353	67
O88834	PF00017	224	300	0.2765584415584417	76	G5BZA8	243	319	0.12518181818181814	76
Q9D113	PF05180	73	137	7.608738461538462	64	G5B6B6	70	134	7.336323076923077	64
Q9JLV1	PF00397	23	53	0.0	30	G5BVW6	127	157	0.0	30
Q9JLV1	PF02179	430	500	0.7196478873239436	70	G5BVW6	533	603	0.08961971830985918	70
Q8BGX2	PF10171	29	191	4.300631901840493	162	G5BUI3	28	142	6.9952695652173915	114
P70663	PF00050	441	494	0.017962962962962962	53	G5BSU7	449	502	0.01805555555555556	53
P70663	PF09289	418	439	0.0	21	G5BSU7	426	447	0.0	21
P70663	PF10591	498	635	0.5459202898550725	137	G5BSU7	506	643	0.5504782608695652	137
Q9CQC9	PF00025	11	196	10.170010752688176	185	G5BN16	12	197	9.60544086021506	185
Q8BPP5	PF16975	39	144	0.0	105	G5B7S9	40	145	0.0	105
Q99ME2	PF00400	203	236	13.644411764705884	33	G5BZU8	204	237	13.608117647058823	33
Q99ME2	PF00400	287	324	2.8926578947368418	37	G5BZU8	288	325	2.2196578947368417	37
Q99ME2	PF00400	974	1013	3.03805	39	G5BZU8	971	1010	7.2679	39
O54887	PF15358	25	584	0.12006785714285716	559	G5B8Q6	26	565	0.2213079777365491	539
Q8C4U3	PF01392	57	162	6.965745283018869	105	G5BZ48	182	287	8.549518867924528	105
Q8C4U3	PF01759	199	294	4.499583333333334	95	G5BZ48	324	419	4.472145833333332	95
Q8VEB6	PF00753	19	83	1.228415384615385	64	G5BVT1	20	84	1.0730153846153845	64
Q8VEB6	PF12706	243	312	0.16398571428571426	69	G5BVT1	245	314	0.1467285714285714	69
Q8R0Z2	PF00076	100	156	0.4784736842105263	56	G5AUC5	22	78	0.4244561403508773	56
Q9D8W5	PF01399	299	415	4.194820512820511	116	G5BVE2	300	416	4.169923076923077	116
Q9D8W5	PF18098	421	452	0.31465625	31	G5BVE2	422	453	0.31515625	31
Q6DTY7	PF00300	251	433	4.703661202185792	182	G5AVM0	218	400	5.056196721311477	182
Q6DTY7	PF01591	34	248	7.4250930232558146	214	G5AVM0	1	215	7.17879534883721	214
Q8R3C1	PF14952	15	55	0.0	40	G5C6V5	16	56	0.0	40
Q922J3	PF01302	59	123	1.960476923076922	64	G5AWQ8	60	124	0.9717692307692304	64
Q922J3	PF01302	212	276	0.06046153846153845	64	G5AWQ8	214	278	0.0602923076923077	64
Q922J3	PF16641	1328	1345	0.0	17	G5AWQ8	1376	1393	0.0	17
Q922J3	PF16641	1368	1384	0.0	16	G5AWQ8	1416	1432	0.0	16
Q9QXD6	PF00316	11	197	14.700566844919779	186	G5B6H0	12	198	13.254754010695198	186
Q9QXD6	PF18913	208	331	5.511040322580645	123	G5B6H0	209	332	4.612249999999999	123
Q8C0J6	PF12796	272	358	16.15272413793103	86	G5CB97	30	116	14.316896551724136	86
Q921D9	PF04516	249	439	4.96284293193717	190	G5B584	375	565	4.957319371727749	190
Q9R022	PF00226	13	75	0.6215396825396826	62	G5BGY9	14	76	0.5199841269841271	62
P42580	PF00046	156	212	0.7143859649122812	56	G5BZ31	164	220	0.7146842105263164	56
Q9D2E1	PF00069	9	264	6.008824218750001	255	G5B5L8	10	265	5.85469921875	255
Q8BH16	PF12937	21	56	31.203222222222234	35	G5BIU5	12	47	10.623361111111112	35
Q8BH16	PF13516	101	119	0.0	18	G5BIU5	92	110	0.0	18
Q8BH16	PF13516	128	150	0.05239130434782609	22	G5BIU5	119	141	0.05260869565217391	22
Q8BH16	PF13516	154	177	0.0	23	G5BIU5	145	168	0.0	23
Q8BH16	PF13516	205	229	0.9124	24	G5BIU5	196	220	0.90956	24
Q8BH16	PF13516	309	333	0.0	24	G5BIU5	300	324	0.0	24
Q8C6G8	PF00400	327	361	14.039914285714286	34	G5C197	308	342	14.738885714285715	34
Q8C6G8	PF00400	371	403	9.731969696969696	32	G5C197	352	384	9.70330303030303	32
Q8C6G8	PF00400	423	445	0.1604782608695652	22	G5C197	404	426	0.16095652173913044	22
Q8C6G8	PF00400	553	577	0.20184	24	G5C197	534	558	0.07647999999999999	24
Q8C6G8	PF00400	584	620	0.02189189189189189	36	G5C197	565	601	0.039324324324324325	36
Q8C6G8	PF17814	120	132	0.0	12	G5C197	101	113	0.0	12
Q5SPV6	PF15667	71	231	0.6213726708074535	160	G5B8V7	85	245	0.6933726708074537	160
Q5RJG1	PF08159	481	507	0.13533333333333333	26	G5B589	507	533	0.13444444444444445	26
Q0P5W1	PF12816	611	793	12.244207650273228	182	G5BTB2	613	795	12.185245901639345	182
A0PJN4	PF00179	0	110	2.1926936936936943	110	G5BJC3	1	111	2.209639639639639	110
Q8BP86	PF13921	296	356	0.019573770491803283	60	G5B6B4	297	395	0.6945959595959594	98
Q8BP86	PF13921	403	463	0.3796393442622951	60	G5B6B4	442	502	0.0	60
Q8R2S9	PF00022	47	618	3.224926573426574	571	G5BUP5	48	619	2.9341346153846164	571
Q3U7U3	PF11566	198	317	10.226491666666664	119	G5BPE3	159	277	6.7116470588235275	118
Q3U7U3	PF12937	335	378	5.551136363636363	43	G5BPE3	295	338	0.5780000000000001	43
Q3UM18	PF01926	374	428	2.7063818181818187	54	G5ALE3	377	431	2.3466727272727272	54
O08712	PF00020	64	104	0.0	40	G5C9R9	94	134	0.0	40
O08712	PF00020	106	141	0.0	35	G5C9R9	136	171	0.029861111111111113	35
O08712	PF00531	278	363	0.2478139534883721	85	G5C9R9	308	393	0.06436046511627908	85
P13562	PF00446	21	30	0.0	9	G5BYA8	24	33	0.0	9
Q68FH0	PF00514	557	596	0.0	39	G5B4C6	351	390	0.0	39
Q68FH0	PF00514	601	642	12.602857142857149	41	G5B4C6	395	436	12.565809523809529	41
Q68FH0	PF00514	863	895	2.919333333333334	32	G5B4C6	399	430	13.58853125	31
Q8K3R3	PF00168	673	772	6.4895000000000085	99	G5AZI5	684	783	5.355180000000002	99
Q8K3R3	PF00169	18	121	5.050692307692307	103	G5AZI5	43	146	4.5477884615384605	103
Q8K3R3	PF00387	537	651	5.94104347826087	114	G5AZI5	548	662	5.1132608695652175	114
Q8K3R3	PF00388	291	435	3.620206896551725	144	G5AZI5	316	460	5.096213793103448	144
Q8K3R3	PF09279	197	281	0.856070588235294	84	G5AZI5	222	306	1.2577176470588232	84
Q7TQG1	PF00169	59	155	9.068597938144334	96	G5BMM2	60	176	11.805418803418801	116
P40630	PF00505	48	115	0.26985294117647063	67	G5BLB7	50	116	0.0	66
P40630	PF09011	152	217	1.4518030303030305	65	G5BLB7	154	200	3.7638085106382975	46
P97318	PF00640	60	166	5.570887850467296	106	G5APP4	65	171	5.567953271028035	106
Q8R2W9	PF03630	12	363	5.847625	351	G5BP50	13	364	5.848181818181815	351
Q8CEZ1	PF15080	18	198	12.193093922651936	180	G5ALC1	25	204	18.21235754189943	179
Q8VCI5	PF04614	75	298	0.002678571428571429	223	G5BWK4	76	299	0.012937219730941705	223
P58242	PF00149	21	280	5.3382423076923065	259	G5AUU8	43	302	4.020423076923079	259
Q3UGR5	PF13242	176	245	2.9917428571428566	69	G5C613	191	260	2.084028571428571	69
Q3UGR5	PF13344	9	89	0.5808148148148148	80	G5C613	10	104	0.6340736842105265	94
Q4FZF3	PF00270	34	195	7.792913580246912	161	G5C5B5	15	176	6.242290123456794	161
Q4FZF3	PF00271	236	342	9.970878504672903	106	G5C5B5	217	323	9.969532710280376	106
Q9JLQ2	PF01412	5	117	1.0887876106194692	112	G5B651	6	118	1.0887256637168143	112
Q9JLQ2	PF08518	264	292	0.0	28	G5B651	266	294	0.0	28
Q9JLQ2	PF08518	328	356	10.574413793103448	28	G5B651	334	362	10.590206896551726	28
Q9JLQ2	PF12796	136	224	1.5951235955056178	88	G5B651	137	225	1.5977752808988763	88
Q9JLQ2	PF12205	585	700	0.6547327586206897	115	G5B651	691	806	0.7950775862068965	115
P22777	PF00079	34	401	5.739918478260872	367	G5AXC4	35	402	6.3122888283378735	367
A2AGB2	PF17743	249	544	3.3420506756756745	295	G5BSM4	300	583	5.50056890459364	283
Q921S7	PF07147	303	384	15.665378048780484	81	G5C9M1	304	385	16.026158536585367	81
Q8C079	PF07923	66	335	14.206114814814816	269	G5BD71	67	336	14.22735925925926	269
Q8C079	PF11882	437	629	6.099860103626941	192	G5BD71	438	630	6.1085181347150295	192
Q8C079	PF11882	629	785	3.5226242038216578	156	G5BD71	630	786	3.50947770700637	156
P42337	PF00454	797	1013	9.878792626728108	216	G5C1G3	763	979	9.873894009216588	216
P42337	PF00613	520	702	3.9165027322404384	182	G5C1G3	486	668	3.9096666666666655	182
P42337	PF00792	350	468	0.053932773109243694	118	G5C1G3	361	478	0.05071186440677966	117
P42337	PF00794	173	290	7.78433898305085	117	G5C1G3	174	291	7.78356779661017	117
P42337	PF02192	31	106	10.590644736842103	75	G5C1G3	32	107	10.261644736842102	75
Q9Z0Y9	PF00104	247	427	6.450281767955801	180	G5BPC4	246	460	5.312967441860466	214
Q9Z0Y9	PF00105	94	161	0.0	67	G5BPC4	93	160	0.0	67
E9Q9D5	PF00071	22	176	4.012012903225803	154	G5B2F3	23	200	3.712432584269664	177
P07091	PF01023	4	45	10.569952380952381	41	G5BEQ7	20	61	3.304309523809524	41
Q99KQ4	PF04095	187	462	3.192021739130435	275	G5AS83	129	403	6.319025547445254	274
Q99KQ4	PF18127	9	101	10.981967741935485	92	G5AS83	10	101	10.226336956521745	91
Q3UV48	PF13855	116	172	1.968894736842105	56	G5C055	118	174	0.3253859649122807	56
Q9R229	PF00019	319	419	5.524574257425746	100	G5BNY7	323	423	5.536534653465345	100
Q9R229	PF00688	54	255	6.815663366336633	201	G5BNY7	55	256	6.281544554455446	201
P97789	PF03159	0	226	8.328356828193831	226	G5AZ56	1	227	8.393004405286344	226
P97789	PF17846	271	596	7.279745398773012	325	G5AZ56	272	597	8.709696319018411	325
P97789	PF18129	1101	1170	0.17508571428571426	69	G5AZ56	1102	1171	0.18374285714285715	69
P97789	PF18332	654	843	6.387289473684213	189	G5AZ56	655	844	6.2031894736842075	189
Q99JP6	PF00568	5	108	5.136105769230769	103	G5C5B6	6	109	5.140740384615388	103
Q8K2V6	PF03810	27	96	21.392742857142856	69	G5AVR2	28	97	21.32311428571429	69
O70146	PF07714	54	305	6.681023809523811	251	G5BL05	34	285	6.703531746031749	251
A6X935	PF00092	273	453	9.856165745856352	180	G5BUN4	275	455	10.437657458563534	180
A6X935	PF06668	785	940	3.7233717948717935	155	G5BUN4	767	919	4.241542483660131	152
A6X935	PF08487	35	145	5.904747747747753	110	G5BUN4	37	147	6.046378378378383	110
Q9WVB4	PF00008	958	991	0.0	33	G5B462	821	854	0.0	33
Q9WVB4	PF00008	999	1028	0.0	29	G5B462	862	891	0.07783333333333334	29
Q9WVB4	PF00008	1037	1068	0.0	31	G5B462	900	931	0.0	31
Q9WVB4	PF00008	1077	1106	0.03866666666666666	29	G5B462	940	969	0.13549999999999998	29
Q9WVB4	PF00008	1122	1152	0.5959354838709676	30	G5B462	985	1015	0.5974838709677419	30
Q9WVB4	PF01462	32	59	0.0	27	G5B462	177	204	0.0	27
Q9WVB4	PF01462	279	305	0.0	26	G5B462	178	204	0.0	26
Q9WVB4	PF01462	724	750	0.0	26	G5B462	611	637	0.0	26
Q9WVB4	PF01463	239	263	0.23292000000000004	24	G5B462	138	162	0.1422	24
Q9WVB4	PF01463	461	485	0.0	24	G5B462	360	384	0.0	24
Q9WVB4	PF01463	686	711	0.0	25	G5B462	573	598	0.0	25
Q9WVB4	PF01463	881	905	0.0	24	G5B462	744	768	0.0	24
Q9WVB4	PF02210	1186	1313	2.498875	127	G5B462	1049	1176	2.4991562499999995	127
Q9WVB4	PF12661	1376	1396	0.0	20	G5B462	1239	1259	0.0	20
Q9WVB4	PF13855	78	120	0.062325581395348835	42	G5B462	1	43	0.062441860465116274	42
Q9WVB4	PF13855	158	216	2.100084745762712	58	G5B462	57	115	2.104457627118644	58
Q9WVB4	PF13855	331	390	11.552916666666665	59	G5B462	230	289	11.48045	59
Q9WVB4	PF13855	582	640	1.2340677966101696	58	G5B462	469	527	1.1001694915254236	58
Q9WVB4	PF13855	799	858	1.9570833333333333	59	G5B462	662	721	4.5603	59
A6H630	PF01937	19	416	2.081580402010048	397	G5C0E4	6	405	4.907672499999999	399
P56931	PF02319	132	195	7.535109374999998	63	G5BHY7	131	194	7.508859374999999	63
P56931	PF16421	212	305	5.410755319148937	93	G5BHY7	211	321	6.659288288288289	110
P47810	PF00069	297	566	4.304337037037037	269	G5BRL0	135	404	4.388407407407408	269
Q6VNB8	PF00400	3104	3136	11.573242424242425	32	G5AT03	3125	3157	11.641636363636366	32
Q6VNB8	PF01363	3431	3495	0.01746153846153846	64	G5AT03	3452	3516	0.0	64
Q6VNB8	PF02138	2677	2957	3.9854875444839872	280	G5AT03	2698	2978	3.9856975088967954	280
Q6VNB8	PF14844	2582	2635	2.2251296296296297	53	G5AT03	2603	2656	1.8759814814814817	53
Q9WU84	PF00080	96	229	0.20147014925373133	133	G5BWZ0	97	230	0.6087910447761193	133
Q9WU84	PF00403	15	70	0.8444107142857141	55	G5BWZ0	16	71	0.8985892857142856	55
Q8R1F5	PF01261	25	264	1.8078333333333336	239	G5AQF7	26	270	0.5954857142857141	244
B1ARI9	PF15248	40	108	0.4173188405797101	68	G5BDI2	41	109	0.27018840579710146	68
Q8CGC6	PF00076	5	64	9.621866666666667	59	G5BHA3	6	65	8.541783333333333	59
Q8CGC6	PF00076	115	183	1.794463768115942	68	G5BHA3	116	184	3.36431884057971	68
Q8CGC6	PF00076	326	384	0.1736610169491525	58	G5BHA3	336	394	0.14516949152542374	58
Q8CGC6	PF00076	481	551	0.08764788732394364	70	G5BHA3	491	561	0.08780281690140848	70
Q9D142	PF00293	38	193	3.252410256410257	155	G5AWJ6	39	194	4.55560256410256	155
Q8BWT1	PF00108	6	265	2.43778076923077	259	G5AX32	5	264	2.985119230769233	259
Q8BWT1	PF02803	273	393	7.437033057851241	120	G5AX32	272	392	7.7636033057851215	120
Q8QZY1	PF10255	151	549	8.552223057644117	398	G5AYR8	152	550	8.547877192982464	398
J3QPZ5	PF13863	35	150	0.6399827586206894	115	G5AKW3	35	152	0.006949152542372879	117
Q922W5	PF03807	2	97	8.781010416666666	95	G5BJ85	3	98	7.7457291666666634	95
Q922W5	PF14748	163	267	1.816323809523809	104	G5BJ85	164	265	1.4176764705882354	101
Q91VD1	PF00337	28	157	5.9519153846153845	129	G5AYK1	29	158	9.774138461538461	129
Q91VD1	PF00337	193	302	3.7707181818181814	109	G5AYK1	194	302	2.593211009174312	108
Q91VB4	PF14761	2	211	9.594823809523817	209	G5BSL0	3	212	10.15224285714286	209
Q91VB4	PF14762	254	639	7.748878238341973	385	G5BSL0	256	641	8.92131347150258	385
Q91VB4	PF14763	648	998	8.972125356125359	350	G5BSL0	650	1000	5.919552706552702	350
Q9Z2G0	PF00023	483	529	0.407531914893617	46	G5C6S6	511	557	0.830340425531915	46
Q9Z2G0	PF12796	11	116	12.20923584905661	105	G5C6S6	44	144	13.646168316831695	100
Q9Z2G0	PF12796	157	246	2.8954888888888886	89	G5C6S6	185	274	2.6973666666666665	89
Q80WT0	PF02493	14	31	0.0	17	G5ASM4	15	31	0.0	16
Q80WT0	PF02493	46	58	0.6981538461538462	12	G5ASM4	47	59	0.6978461538461538	12
Q80WT0	PF02493	60	76	0.0	16	G5ASM4	61	77	0.0	16
Q80WT0	PF02493	82	103	0.04113636363636365	21	G5ASM4	83	104	0.0409090909090909	21
Q80WT0	PF02493	105	127	0.22065217391304345	22	G5ASM4	106	128	0.1763478260869565	22
Q80WT0	PF02493	128	145	0.0	17	G5ASM4	129	146	0.0	17
Q80WT0	PF02493	281	303	0.0	22	G5ASM4	282	304	0.0	22
Q80WT0	PF02493	304	326	0.0	22	G5ASM4	305	327	0.0	22
P61208	PF00025	7	170	5.352475609756096	163	G5BRQ0	8	170	5.356527607361963	162
Q9D2U5	PF01423	43	112	2.4131714285714287	69	G5B5E2	44	113	2.4177000000000004	69
Q8K1S1	PF03736	219	250	17.26265625	31	G5BXK0	223	254	15.603437499999998	31
Q8K1S1	PF03736	395	437	10.197860465116278	42	G5BXK0	399	441	10.209116279069766	42
Q8K1S1	PF13855	100	158	9.118525423728814	58	G5BXK0	104	162	1.5568474576271187	58
P84091	PF01217	1	124	13.041298387096775	123	G5BTE1	2	150	10.708630872483221	148
P84091	PF00928	159	434	0.2027355072463768	275	G5BTE1	183	458	0.2029236363636364	275
P43687	PF00046	149	205	0.0	56	G5AKG9	150	206	0.0	56
Q9D658	PF00102	34	144	8.192558558558558	110	G5C8Z2	35	145	8.165846846846847	110
Q99JB0	PF00096	217	241	0.0	24	G5BH07	219	243	0.0	24
Q99JB0	PF00096	247	271	0.0	24	G5BH07	249	273	0.0	24
Q99JB0	PF00096	277	299	0.0	22	G5BH07	279	301	0.0	22
O09173	PF04209	4	433	4.755844186046511	429	G5AU89	5	434	4.0381465116279065	429
E9PZM4	PF00176	475	766	8.315219178082199	291	G5C6N1	461	752	8.309941780821918	291
E9PZM4	PF00271	794	904	8.742801801801804	110	G5C6N1	780	890	8.718117117117117	110
E9PZM4	PF00385	262	342	1.95258024691358	80	G5C6N1	263	343	1.7845555555555552	80
E9PZM4	PF00385	377	446	0.4745	69	G5C6N1	378	432	0.14796363636363635	54
E9PZM4	PF13907	1464	1552	6.282314606741574	88	G5C6N1	1432	1520	6.281033707865169	88
E9PZM4	PF18375	1129	1217	0.0	88	G5C6N1	1097	1185	0.0	88
P40224	PF00048	28	84	0.2483859649122807	56	G5BWZ9	29	85	0.2512807017543859	56
Q5DTT1	PF15735	283	672	0.18096410256410247	389	G5BNT4	284	662	0.05661477572559366	378
Q8BQM7	PF15047	13	219	8.562217391304346	206	G5BV51	14	220	13.263642512077295	206
Q9QWW1	PF00568	3	105	7.090669902912621	102	G5BF08	9	111	7.092407766990293	102
Q64362	PF00179	78	214	12.765299270073	136	G5BQB7	79	215	10.857240875912414	136
Q6P8J7	PF00217	186	400	4.269716279069766	214	G5BK72	187	401	4.6118697674418625	214
Q6P8J7	PF02807	58	127	0.2783142857142857	69	G5BK72	59	128	0.2777857142857143	69
P70434	PF00605	11	123	0.031477876106194694	112	G5C485	14	125	4.459017857142858	111
P70434	PF10401	242	418	6.220197740112997	176	G5C485	226	402	8.641389830508476	176
Q9ET22	PF05577	47	473	6.282060889929738	426	G5BEJ5	46	472	6.52898360655738	426
Q8R1M0	PF02586	60	256	3.6657563451776656	196	G5BYD5	1	202	5.7022623762376226	201
P42932	PF00118	38	528	3.74230549898167	490	G5B1C5	39	528	4.521112244897958	489
Q8BH52	PF00170	291	353	0.0	62	G5ALM5	292	354	0.0	62
Q6PHN9	PF00071	16	167	4.052407894736842	151	G5B784	19	170	4.041605263157895	151
Q921D4	PF04934	12	139	10.80653125	127	G5BQL5	49	183	10.891488888888896	134
Q61235	PF00595	136	173	10.970710526315786	37	G5AK49	1	38	13.126815789473689	37
Q61235	PF18012	219	276	7.096327586206896	57	G5AK49	84	141	7.041948275862068	57
P23359	PF00019	328	428	7.491722772277226	100	G5AUN3	269	369	7.509415841584161	100
P23359	PF00688	138	278	5.457617021276596	140	G5AUN3	79	219	5.153744680851064	140
Q9WVK8	PF00067	39	447	3.687224938875307	408	G5B4A8	1	408	3.5511375921375934	407
Q8BMS9	PF00788	178	263	5.745604651162791	85	G5B4V8	179	264	5.733744186046512	85
Q8BMS9	PF16517	276	315	0.0	39	G5B4V8	277	316	0.0	39
P35569	PF00169	21	110	2.7735888888888884	89	G5C9E7	22	111	2.7932666666666663	89
P35569	PF02174	155	255	7.786970297029702	100	G5C9E7	161	261	7.783108910891088	100
P31324	PF00027	172	255	1.322761904761904	83	G5C2D5	174	257	1.3184404761904762	83
P31324	PF00027	292	382	3.0636703296703285	90	G5C2D5	294	384	2.9978131868131856	90
P31324	PF02197	7	43	0.06602702702702702	36	G5C2D5	8	44	0.06583783783783784	36
Q99JP0	PF00069	15	272	4.021682170542636	257	G5AMW2	16	273	4.024957364341088	257
Q99JP0	PF00780	566	862	6.043050505050508	296	G5AMW2	570	866	6.1179528619528645	296
Q3TQ03	PF15673	84	359	2.7064565217391303	275	G5BH35	92	366	2.2530799999999997	274
A2APY7	PF08241	93	184	2.09425	91	G5ALV2	94	185	2.755967391304348	91
Q9WV84	PF00334	36	169	4.414985074626865	133	G5BXX1	38	171	5.177238805970147	133
Q05020	PF05355	23	96	6.115594594594595	73	G5CBM3	27	100	4.2870135135135135	73
Q8C078	PF00069	164	445	5.649939716312057	281	G5AWM9	154	435	5.654670212765956	281
Q8BLG0	PF02820	28	67	0.0195	39	G5B841	6	45	0.019375	39
Q8BLG0	PF12618	175	257	0.0	82	G5B841	153	235	0.0	82
Q8BLG0	PF18115	89	135	2.6690638297872344	46	G5B841	67	113	1.975617021276596	46
P62960	PF00313	58	124	0.08397014925373134	66	G5AQI3	6	72	0.0765373134328358	66
Q6P1E7	PF03121	383	446	6.495984374999999	63	G5BGG6	402	465	7.082031249999997	63
P20033	PF00341	95	178	0.1288809523809524	83	G5AZ13	98	181	0.13021428571428575	83
P20033	PF04692	20	94	0.0	74	G5AZ13	23	97	0.0	74
Q920P5	PF00406	136	292	5.1283949044586015	156	G5AXL0	137	293	4.992305732484076	156
Q920P5	PF00406	380	535	3.713967948717949	155	G5AXL0	381	536	1.0962628205128202	155
Q8K1I3	PF07448	67	128	0.017096774193548388	61	G5BRP8	68	130	0.4059206349206349	62
Q6P6P7	PF00644	455	571	0.12623931623931625	116	G5BHB2	467	583	0.12636752136752138	116
P58544	PF00651	67	179	13.047929203539825	112	G5BF05	54	164	12.447378378378382	110
P58544	PF07707	189	289	2.914445544554456	100	G5BF05	174	274	1.4560594059405936	100
P58544	PF08005	338	486	5.356288590604027	148	G5BF05	323	471	5.3322953020134225	148
Q9JJR6	PF15057	91	223	3.2426541353383462	132	G5BUW7	29	161	1.6339022556390974	132
Q8K341	PF05301	8	189	4.669428571428573	181	G5C3B8	9	190	4.476587912087913	181
Q6PAT0	PF00383	173	306	7.620373134328355	133	G5BBB3	175	311	7.272321167883211	136
Q9JIX9	PF06743	240	304	5.028107692307693	64	G5AMT2	268	331	4.168921875	63
Q9JIX9	PF08368	331	395	1.5777538461538465	64	G5AMT2	328	399	0.851402777777778	71
Q9JIX9	PF08373	476	497	0.0	21	G5AMT2	401	422	0.0	21
Q91ZU6	PF00307	35	137	8.950679611650488	102	G5BR15	76	178	8.985543689320389	102
Q91ZU6	PF00307	151	254	10.709240384615383	103	G5BR15	192	295	10.78398076923077	103
Q91ZU6	PF00435	3849	3929	0.06388888888888887	80	G5BR15	4781	4861	0.2529629629629629	80
Q91ZU6	PF00435	4003	4083	0.025061728395061725	80	G5BR15	4935	5015	0.1388641975308642	80
Q91ZU6	PF00435	4444	4552	0.022036697247706426	108	G5BR15	5370	5478	0.0	108
Q91ZU6	PF00435	4556	4661	3.533273584905662	105	G5BR15	5482	5587	3.7821415094339628	105
Q91ZU6	PF00435	4779	4881	0.03975728155339806	102	G5BR15	5705	5807	0.25955339805825245	102
Q91ZU6	PF00435	5256	5319	0.210578125	63	G5BR15	6128	6191	0.0	63
Q91ZU6	PF00435	5326	5423	0.05406122448979591	97	G5BR15	6198	6294	0.2973020833333335	96
Q91ZU6	PF00435	5436	5492	0.7400877192982457	56	G5BR15	1335	1391	0.0	56
Q91ZU6	PF00435	5653	5733	0.015432098765432096	80	G5BR15	6198	6277	0.3486625000000001	79
Q91ZU6	PF00435	5763	5829	0.018970149253731344	66	G5BR15	5233	5297	4.028246153846154	64
Q91ZU6	PF00435	6009	6082	1.0399729729729734	73	G5BR15	5511	5585	0.7962400000000002	74
Q91ZU6	PF00435	6093	6194	0.016313725490196083	101	G5BR15	4911	5015	0.18762857142857145	104
Q91ZU6	PF00435	6200	6299	0.7801600000000001	99	G5BR15	6196	6294	0.2912346938775512	98
Q91ZU6	PF00435	6312	6404	1.6767526881720431	92	G5BR15	6199	6290	0.3102282608695654	91
Q91ZU6	PF00435	6529	6624	0.0	95	G5BR15	6198	6291	0.30362765957446824	93
Q91ZU6	PF00435	6640	6728	0.7079550561797752	88	G5BR15	6199	6287	0.32068539325842715	88
Q91ZU6	PF00435	6755	6847	4.047075268817203	92	G5BR15	5381	5476	0.0	95
Q91ZU6	PF00681	1582	1621	12.15795	39	G5BR15	2535	2574	3.441250000000001	39
Q91ZU6	PF00681	1771	1810	0.25055	39	G5BR15	2724	2763	0.343375	39
Q91ZU6	PF17902	874	940	0.07913432835820895	66	G5BR15	916	982	0.07523880597014923	66
Q91ZU6	PF18373	975	1052	1.7969358974358975	77	G5BR15	1017	1094	1.48648717948718	77
Q9Z0L8	PF07722	35	244	3.824028571428568	209	G5BIT4	1	211	3.2719715639810425	210
Q61205	PF13472	43	201	6.874855345911953	158	G5AZR4	43	201	7.045144654088051	158
Q80UQ2	PF00788	205	288	8.291607142857144	83	G5B5P0	131	214	10.857595238095243	83
Q80UQ2	PF16517	315	329	0.0	14	G5B5P0	222	235	0.0	13
Q8K330	PF00782	332	460	1.7246124031007752	128	G5BSB3	332	460	2.5039767441860468	128
Q8K330	PF08766	268	317	1.7678200000000002	49	G5BSB3	268	317	2.29124	49
Q6NVF0	PF00620	733	872	13.110135714285713	139	G5AU69	716	855	14.955385714285713	139
Q6NVF0	PF03372	243	522	6.365235714285716	279	G5AU69	226	505	6.280657142857142	279
Q6NVF0	PF16726	19	116	1.197265306122449	97	G5AU69	1	98	0.33629591836734685	97
P56501	PF00153	12	103	3.6087065217391316	91	G5AS96	13	104	2.205173913043477	91
P56501	PF00153	110	204	0.12543157894736842	94	G5AS96	111	205	0.4501157894736841	94
P56501	PF00153	211	298	14.64829545454546	87	G5AS96	212	299	14.56145454545455	87
Q9QXP7	PF00386	146	274	14.719217054263572	128	G5AVF8	153	281	14.92293798449612	128
Q9QXP7	PF01391	98	138	0.0	40	G5AVF8	105	145	0.0	40
Q9QUN9	PF04706	145	195	0.0	50	G5C7T7	376	426	0.1928627450980392	50
O88735	PF05672	450	601	0.0	151	G5C1A8	479	623	0.0	144
Q9EQ14	PF16649	29	184	2.214141025641026	155	G5BB75	30	184	3.556754838709677	154
Q8C1A5	PF01432	226	674	2.136770601336305	448	G5BZC8	244	692	1.8063073496659243	448
Q9CQF6	PF01648	124	243	3.0042083333333327	119	G5BA76	118	237	2.602408333333334	119
A2AAX3	PF00651	22	125	17.85807692307693	103	G5BSC1	23	126	17.859567307692313	103
A2AAX3	PF01344	367	408	19.14009523809524	41	G5BSC1	368	409	19.14009523809524	41
A2AAX3	PF01344	476	528	18.33420754716981	52	G5BSC1	477	529	18.339452830188684	52
A2AAX3	PF01344	531	571	2.8640975609756105	40	G5BSC1	532	572	2.8640975609756105	40
A2AAX3	PF07707	145	235	1.7998131868131881	90	G5BSC1	146	236	1.7998131868131881	90
P45481	PF02172	586	665	0.79145	79	G5B1G6	517	596	0.7975125	79
P45481	PF02135	352	428	5.861090909090909	76	G5B1G6	283	359	5.865064935064934	76
P45481	PF02135	1772	1843	0.7908472222222223	71	G5B1G6	1683	1754	0.8014444444444444	71
P45481	PF09030	2020	2078	0.0	58	G5B1G6	2041	2098	0.0	57
P45481	PF00439	1104	1177	7.896567567567568	73	G5B1G6	1034	1107	7.921324324324321	73
P45481	PF06001	1192	1231	0.1532	39	G5B1G6	1122	1161	0.15445	39
P45481	PF08214	1342	1647	4.793728758169935	305	G5B1G6	1253	1558	4.45485294117647	305
P45481	PF00569	1702	1742	0.9279024390243898	40	G5B1G6	1613	1653	0.9352682926829272	40
Q61471	PF07742	0	110	9.98788288288288	110	G5C4K9	1	111	9.988459459459461	110
P06869	PF00089	179	375	4.194467005076142	196	G5C7I1	179	373	4.516625641025644	194
P06869	PF00051	70	151	0.5174756097560975	81	G5C7I1	71	152	0.4634024390243902	81
Q9JLF6	PF00868	109	224	4.430336206896552	115	G5B280	106	221	6.865603448275862	115
Q9JLF6	PF00927	577	681	14.11708571428571	104	G5B280	574	678	15.46409523809524	104
Q9JLF6	PF00927	689	785	10.907628865979383	96	G5B280	686	782	8.752804123711341	96
Q9JLF6	PF01841	366	458	10.18105376344086	92	G5B280	363	455	10.180924731182797	92
Q8R1A4	PF06920	1570	2095	1.4776806083650191	525	G5BSN0	1553	2076	1.4606049618320611	523
Q8R1A4	PF11878	52	160	4.40445871559633	108	G5BSN0	41	149	4.390788990825688	108
Q8R1A4	PF14429	557	734	6.44643820224719	177	G5BSN0	596	773	6.320258426966294	177
Q30KN8	PF13841	25	54	0.0	29	G5C6K7	7	36	0.3719	29
Q9R117	PF07714	590	862	0.8780732600732606	272	G5B225	591	863	0.8278388278388278	272
Q9R117	PF07714	894	1164	3.4564649446494475	270	G5B225	895	1165	4.226549815498154	270
Q9R117	PF17887	289	430	4.5144859154929575	141	G5B225	288	430	2.6547062937062926	142
Q9R117	PF18377	144	268	0.931448	124	G5B225	143	267	1.7486479999999998	124
Q9R117	PF18379	32	126	7.349621052631577	94	G5B225	29	125	4.9256597938144315	96
P47955	PF00428	22	112	0.19582417582417586	90	G5C6T4	23	113	0.1748901098901099	90
Q62523	PF00412	375	430	1.5674285714285714	55	G5C2M2	401	456	1.5637142857142858	55
Q62523	PF00412	435	490	3.721428571428573	55	G5C2M2	461	516	3.6032142857142855	55
Q62523	PF00412	495	559	0.1608153846153846	64	G5C2M2	521	585	0.16033846153846154	64
Q99M01	PF01409	75	197	4.918016260162601	122	G5BAS5	76	198	3.259406504065041	122
Q99M01	PF01409	241	342	4.6761372549019615	101	G5BAS5	242	343	4.516078431372549	101
Q99M01	PF03147	357	406	0.07472000000000001	49	G5BAS5	358	406	0.0	48
Q811L6	PF00069	567	840	7.656259124087591	273	G5C369	433	706	7.605416058394159	273
Q811L6	PF08926	255	528	2.4163941605839416	273	G5C369	128	394	2.4602883895131065	266
Q811L6	PF17820	1173	1217	0.5110666666666667	44	G5C369	1039	1083	0.35015555555555555	44
P59328	PF00400	11	39	1.6226206896551725	28	G5BF78	12	40	0.13448275862068967	28
P59328	PF00400	127	163	3.4252972972972966	36	G5BF78	128	163	1.7896111111111108	35
P59328	PF00505	1005	1060	0.017321428571428567	55	G5BF78	1015	1070	0.017321428571428567	55
P59328	PF12341	423	706	8.590264084507039	283	G5BF78	428	712	5.586789473684209	284
P59328	PF12894	193	281	8.753460674157305	88	G5BF78	194	282	7.598157303370787	88
Q8BU03	PF00400	369	400	8.4798125	31	G5BG18	365	396	7.52878125	31
Q8BU03	PF00400	406	441	16.022666666666666	35	G5BG18	402	437	42.03875000000001	35
Q8BU03	PF00400	491	528	0.14555263157894735	37	G5BG18	487	524	0.15344736842105258	37
Q8BU03	PF04003	769	873	18.151828571428574	104	G5BG18	764	863	6.137209999999999	99
Q8C1B7	PF00735	37	306	2.454781481481483	269	G5BJQ1	64	333	2.4489925925925946	269
Q6P2K6	PF04802	165	356	8.853098958333328	191	G5AZZ9	166	357	8.856812499999998	191
Q7TMF2	PF00929	127	300	1.5616034482758618	173	G5AV61	131	304	1.4810229885057478	173
Q7TMF2	PF02037	72	104	0.0	32	G5AV61	76	108	0.0	32
P60330	PF03568	1718	2064	5.831731988472622	346	G5BIG7	1719	2065	5.747939481268009	346
Q9QZR9	PF01391	56	108	0.0	52	G5C9E9	67	118	0.0	51
Q9QZR9	PF01391	110	165	0.0	55	G5C9E9	106	160	0.008581818181818182	54
Q9QZR9	PF01391	172	226	0.012727272727272726	54	G5C9E9	693	752	0.0	59
Q9QZR9	PF01391	392	446	0.0	54	G5C9E9	883	932	0.0	49
Q9QZR9	PF01391	501	548	0.0	47	G5C9E9	423	470	0.0	47
Q9QZR9	PF01391	601	653	0.0	52	G5C9E9	726	775	0.0	49
Q9QZR9	PF01391	669	723	0.0	54	G5C9E9	715	777	0.0	62
Q9QZR9	PF01391	756	807	0.0	51	G5C9E9	678	729	0.0	51
Q9QZR9	PF01391	854	903	0.0	49	G5C9E9	886	935	0.0	49
Q9QZR9	PF01391	900	952	0.0	52	G5C9E9	893	945	0.0	52
Q9QZR9	PF01391	1010	1062	0.0	52	G5C9E9	886	938	0.0	52
Q9QZR9	PF01391	1072	1129	0.0	57	G5C9E9	705	768	0.0	63
Q9QZR9	PF01391	1124	1181	0.0	57	G5C9E9	1118	1175	0.0	57
Q9QZR9	PF01391	1194	1239	0.0	45	G5C9E9	714	759	0.0	45
Q9QZR9	PF01391	1399	1448	0.0	49	G5C9E9	892	941	0.0	49
Q9QZR9	PF01413	1458	1561	9.102240384615387	103	G5C9E9	1449	1552	7.633346153846157	103
Q9QZR9	PF01413	1566	1679	8.305649122807019	113	G5C9E9	1557	1670	9.806149122807016	113
Q9Z2G6	PF08238	188	213	0.0	25	G5AJR8	192	217	0.0	25
Q9Z2G6	PF08238	216	248	13.796969696969695	32	G5AJR8	220	252	13.785151515151515	32
Q9Z2G6	PF08238	252	282	24.823387096774198	30	G5AJR8	256	286	24.909225806451605	30
Q9Z2G6	PF08238	288	315	2.562642857142857	27	G5AJR8	292	319	2.5102142857142864	27
Q9Z2G6	PF08238	369	404	0.07394444444444444	35	G5AJR8	373	408	0.07363888888888888	35
Q9Z2G6	PF08238	405	441	0.2359189189189189	36	G5AJR8	409	445	0.2351081081081081	36
Q9Z2G6	PF08238	444	476	0.8891818181818179	32	G5AJR8	448	480	0.8859393939393944	32
Q9Z2G6	PF08238	480	513	0.055794117647058834	33	G5AJR8	484	517	2.0245	33
Q9Z2G6	PF08238	518	542	5.134919999999998	24	G5AJR8	522	546	2.3566	24
Q9Z2G6	PF08238	606	621	0.0	15	G5AJR8	610	625	0.0	15
Q9Z2G6	PF08238	624	657	0.16838235294117646	33	G5AJR8	628	661	0.1677352941176471	33
Q9Z2G6	PF08238	659	692	0.029705882352941176	33	G5AJR8	663	696	0.029705882352941176	33
Q9Z2G6	PF00040	122	163	2.4535	41	G5AJR8	126	167	1.8009285714285717	41
Q811Q9	PF01467	79	207	3.1705736434108505	128	G5AUJ1	80	208	3.1722325581395325	128
Q9QXX3	PF00068	29	134	0.05047169811320757	105	G5B4E8	42	147	1.61488679245283	105
P02104	PF00042	7	111	4.521228571428571	104	G5BS35	8	112	5.097619047619047	104
Q61502	PF02319	68	105	0.02947368421052631	37	G5ATX3	1	38	0.029736842105263162	37
Q61502	PF16421	122	218	1.6460515463917529	96	G5ATX3	55	153	2.8917878787878792	98
Q8VH37	PF00850	33	318	5.2233496503496495	285	G5AM90	34	321	5.438142361111112	287
Q9ERZ6	PF00004	521	650	7.933876923076926	129	G5B029	511	640	7.822030769230768	129
Q9ERZ6	PF09336	721	755	0.0	34	G5B029	711	745	0.0	34
A2BE28	PF04031	27	170	10.310812500000004	143	G5B6D6	28	155	11.3195546875	127
Q3UKC1	PF07888	124	408	3.867922807017544	284	G5BD59	250	534	3.0980315789473685	284
Q3UKC1	PF17751	47	119	16.311547945205483	72	G5BD59	173	245	14.160753424657536	72
Q3UKC1	PF18112	752	778	0.0	26	G5BD59	849	875	0.0	26
Q3UKC1	PF18112	779	805	0.0	26	G5BD59	876	902	0.0	26
Q8K3X6	PF00536	357	406	0.27048	49	G5AY57	316	365	0.0543	49
Q8K3X6	PF12796	37	120	11.024619047619051	83	G5AY57	38	121	8.63758333333333	83
B2RUJ5	PF00595	661	743	10.616421686746989	82	G5AVH6	664	746	14.007722891566265	82
B2RUJ5	PF00595	759	823	0.576569230769231	64	G5AVH6	762	826	0.5786	64
B2RUJ5	PF00640	465	622	5.5866835443037965	157	G5AVH6	461	618	5.2894367088607614	157
Q148W8	PF00782	140	275	8.533411764705884	135	G5AQ44	141	276	8.132132352941179	135
P97953	PF00341	126	206	0.5614444444444444	80	G5BXZ7	81	161	0.5607777777777778	80
P97953	PF03128	278	290	0.0	12	G5BXZ7	230	242	0.0	12
P97953	PF03128	326	338	0.0	12	G5BXZ7	278	290	0.0	12
P97348	PF00071	18	189	8.450895348837214	171	G5BSB8	19	190	10.205040697674418	171
Q9WUB3	PF00343	114	827	3.602770308123245	713	G5B6P0	115	829	3.52021678321678	714
Q6PCN3	PF00069	34	263	4.569786956521738	229	G5BNL9	35	264	4.57018695652174	229
Q9D1Q6	PF00085	31	136	2.3165188679245285	105	G5AZ30	32	137	2.3396320754716986	105
Q9D1Q6	PF13848	166	349	3.587739130434782	183	G5AZ30	167	350	3.2981684782608705	183
Q99LU8	PF15130	0	225	8.13998672566372	225	G5BJY8	1	226	8.149008849557523	225
Q9CQL6	PF01632	101	160	0.4063333333333334	59	G5ARM7	102	161	0.013166666666666669	59
Q3TBD2	PF00620	771	940	3.099835294117647	169	G5C5Y5	791	961	1.2732690058479532	170
O35618	PF00641	298	327	0.0	29	G5BMM5	301	330	0.0	29
O35618	PF02201	28	90	0.5467142857142857	62	G5BMM5	29	91	0.6199047619047621	62
O35618	PF13920	433	481	5.2901224489795915	48	G5BMM5	437	485	8.24026530612245	48
Q9JMD1	PF00536	791	853	5.575952380952382	62	G5BUN6	789	851	5.62742857142857	62
Q9JMD1	PF02820	53	122	10.984785714285712	69	G5BUN6	48	117	10.850542857142852	69
Q9JMD1	PF02820	166	234	13.750507246376813	68	G5BUN6	161	229	14.0098115942029	68
Q9JMD1	PF02820	276	348	0.07454794520547943	72	G5BUN6	273	345	2.060219178082192	72
Q9JMD1	PF02820	385	452	9.680514705882354	67	G5BUN6	382	449	8.755352941176474	67
Q9JMD1	PF12140	500	612	8.666566371681416	112	G5BUN6	498	610	8.706796460176992	112
P17141	PF00096	254	276	0.0	22	G5BWR0	287	309	0.0	22
P17141	PF00096	282	304	0.0482608695652174	22	G5BWR0	315	337	0.04782608695652174	22
P17141	PF00096	338	360	0.0	22	G5BWR0	371	393	0.0	22
P17141	PF00096	366	388	0.0	22	G5BWR0	399	421	0.0	22
P17141	PF00096	394	416	0.0	22	G5BWR0	427	449	0.0	22
P17141	PF00096	422	444	0.0	22	G5BWR0	455	477	0.0	22
P17141	PF00096	450	472	0.0	22	G5BWR0	483	505	0.0	22
P17141	PF00096	478	500	0.0	22	G5BWR0	511	533	0.0	22
P17141	PF00096	506	528	0.0	22	G5BWR0	539	561	0.0	22
P17141	PF00096	534	556	0.02586956521739131	22	G5BWR0	567	589	0.02565217391304348	22
P17141	PF00096	562	584	0.0	22	G5BWR0	595	617	0.0	22
P17141	PF01352	15	42	0.0	27	G5BWR0	45	72	0.0665	27
Q8BS40	PF08718	27	177	6.801622516556294	150	G5ATQ4	28	176	6.580744966442951	148
Q8CE50	PF00787	121	204	4.10802380952381	83	G5BWR3	18	101	4.139214285714285	83
Q8CE50	PF03114	294	426	1.842857142857144	132	G5BWR3	191	323	0.6749849624060149	132
P33173	PF00225	10	353	5.050880813953489	343	G5C3Q8	11	399	4.5695244215938295	388
P33173	PF16183	357	514	2.9353481012658222	157	G5C3Q8	403	560	2.9310822784810124	157
P33173	PF00169	1581	1674	4.595989361702127	93	G5C3Q8	1845	1938	4.5980319148936175	93
P33173	PF00498	516	586	0.3908450704225352	70	G5C3Q8	562	632	0.38667605633802815	70
P33173	PF12423	804	850	0.0	46	G5C3Q8	951	997	0.0	46
P33173	PF12473	1193	1299	9.693663551401869	106	G5C3Q8	1412	1520	6.0813853211009175	108
O70551	PF00069	79	225	2.371476190476188	146	G5BEW3	135	281	2.6066122448979607	146
O70551	PF00069	481	645	1.7537818181818172	164	G5BEW3	544	708	1.7404181818181819	164
Q920B0	PF00373	147	259	6.895849557522122	112	G5AVQ3	148	260	6.789955752212388	112
Q920B0	PF09379	62	122	6.861737704918031	60	G5AVQ3	63	123	6.852622950819672	60
Q920B0	PF09380	263	363	9.365871287128718	100	G5AVQ3	264	364	9.354297029702971	100
Q920B0	PF11819	394	528	0.06500740740740743	134	G5AVQ3	395	529	0.049925925925925936	134
Q9WTT4	PF03179	2	105	1.5232500000000004	103	G5C3D9	3	106	1.5238846153846155	103
Q8R4C2	PF01363	536	596	0.7718196721311475	60	G5B7Z6	572	632	0.454032786885246	60
Q8R4C2	PF02759	44	166	11.578829268292685	122	G5B7Z6	80	202	11.511650406504064	122
Q80ZK9	PF00400	41	74	0.0	33	G5AUT0	42	75	0.0	33
Q80ZK9	PF00400	528	564	5.763054054054053	36	G5AUT0	529	565	5.768621621621622	36
Q80ZK9	PF00400	570	607	1.5734736842105264	37	G5AUT0	571	608	1.5734473684210528	37
Q62077	PF00017	549	638	1.7523000000000015	89	G5C9N1	662	751	1.7615333333333338	89
Q62077	PF00017	667	740	0.7536081081081081	73	G5C9N1	780	853	0.7585675675675677	73
Q62077	PF00018	796	842	0.06382978723404255	46	G5C9N1	909	955	0.06493617021276596	46
Q62077	PF00168	1089	1186	4.596561224489797	97	G5C9N1	1202	1299	4.55354081632653	97
Q62077	PF00387	952	1066	3.9742173913043466	114	G5C9N1	1065	1179	3.992660869565216	114
Q62077	PF00388	321	464	0.4437152777777777	143	G5C9N1	434	577	0.4464583333333334	143
Q91ZZ3	PF01387	0	122	2.653455284552848	122	G5BPZ3	77	200	2.597346774193546	123
P59941	PF02146	51	74	0.0	23	G5BZB2	52	75	0.0	23
P59941	PF02146	85	220	4.594992647058826	135	G5BZB2	86	221	1.4833750000000003	135
Q99JZ0	PF00595	192	262	6.191000000000002	70	G5AV73	193	263	7.536957746478873	70
Q99JZ0	PF17820	130	184	14.614563636363638	54	G5AV73	131	185	13.548872727272725	54
Q9Z0U1	PF00595	10	88	2.9888860759493667	78	G5AVH8	34	112	3.495392405063292	78
Q9Z0U1	PF00595	294	361	4.345852941176471	67	G5AVH8	281	348	5.985367647058824	67
Q9Z0U1	PF00595	495	565	11.189957746478873	70	G5AVH8	477	547	11.71630985915493	70
Q9Z0U1	PF00625	757	857	6.348267326732676	100	G5AVH8	737	837	10.169326732673266	100
Q9Z0U1	PF07653	587	646	0.4812666666666667	59	G5AVH8	569	628	0.4670333333333334	59
Q91V81	PF00076	380	450	0.664450704225352	70	G5BXH8	380	450	0.6645633802816902	70
P02340	PF00870	97	284	3.7232978723404258	187	G5B5D6	99	286	3.5757393617021282	187
P02340	PF07710	315	351	0.0945945945945946	36	G5B5D6	317	352	0.09761111111111108	35
P02340	PF08563	8	30	0.2124782608695652	22	G5B5D6	6	27	0.0	21
Q8VDU5	PF00069	15	268	7.280263779527558	253	G5ALY9	16	263	7.446903225806452	247
Q61096	PF00089	29	244	9.71489814814815	215	G5C5X2	21	224	8.524656862745099	203
Q8R3V6	PF02845	51	91	0.0	40	G5C423	104	144	0.0	40
O70338	PF00075	136	279	4.3872222222222215	143	G5C7L3	136	279	4.273062499999998	143
O70338	PF01693	27	69	6.025116279069768	42	G5C7L3	28	70	6.797790697674419	42
Q06507	PF00170	273	334	0.0	61	G5AYV6	276	337	0.0	61
P81069	PF12796	9	100	0.13520652173913045	91	G5AJY9	10	101	0.11756521739130438	91
P81069	PF13637	104	155	11.957384615384614	51	G5AJY9	105	156	13.92859615384616	51
Q80U78	PF00806	852	886	0.02137142857142857	34	G5AY68	755	789	0.03205714285714285	34
Q80U78	PF00806	890	919	11.128433333333335	29	G5AY68	793	822	11.066566666666667	29
Q80U78	PF00806	924	950	3.8857777777777787	26	G5AY68	827	853	3.8847777777777774	26
Q80U78	PF00806	962	993	2.53359375	31	G5AY68	865	896	5.44928125	31
Q80U78	PF00806	998	1032	2.1376	34	G5AY68	901	935	9.727	34
Q80U78	PF00806	1037	1067	0.1823870967741936	30	G5AY68	940	970	0.1895483870967743	30
Q80U78	PF00806	1070	1104	4.612000000000002	34	G5AY68	973	1007	4.479942857142858	34
Q80U78	PF00806	1115	1146	2.74396875	31	G5AY68	1018	1049	2.5748437500000003	31
Q9ER73	PF05625	46	379	3.9923592814371234	333	G5C8K1	47	378	4.518156626506025	331
Q64727	PF01044	2	482	0.5814220374220372	480	G5C7I2	3	483	0.5400478170478171	480
Q64727	PF01044	485	1065	0.4679449225473318	580	G5C7I2	486	1134	0.5040771604938271	648
Q9WV03	PF04921	116	336	0.3716289592760181	220	G5BFL0	117	338	0.342671171171171	221
Q99JR6	PF01467	9	206	2.197075757575757	197	G5AQA6	10	207	1.817191919191918	197
Q9EPU4	PF03178	1071	1405	4.229411940298506	334	G5C5S6	1071	1405	4.08037313432836	334
Q9EPU4	PF10433	91	667	8.163982668977477	576	G5C5S6	92	668	8.171492201039875	576
Q60736	PF00084	33	87	2.2492363636363635	54	G5APA4	30	83	1.4584259259259258	53
Q60736	PF00084	96	152	1.8359122807017545	56	G5APA4	92	148	0.0576140350877193	56
Q60736	PF00084	157	207	24.702156862745102	50	G5APA4	153	202	4.8401999999999985	49
Q60736	PF00084	230	277	0.0409375	47	G5APA4	203	250	11.3025	47
Q60736	PF00084	282	340	0.026033898305084745	58	G5APA4	255	312	2.1886551724137933	57
Q60736	PF00084	349	410	7.9215	61	G5APA4	322	383	1.8831935483870967	61
Q60736	PF00084	465	508	0.2820454545454545	43	G5APA4	206	250	10.287644444444446	44
P07724	PF00273	30	201	3.5424011627906986	171	G5B5P2	31	202	2.7876337209302338	171
P07724	PF00273	222	393	4.956691860465116	171	G5B5P2	223	394	4.626999999999998	171
P07724	PF00273	414	591	0.6525898876404499	177	G5B5P2	415	592	4.432606741573037	177
Q810U5	PF15295	16	127	0.0	111	G5BGU9	1	117	0.0	116
Q3UPC7	PF14906	515	831	6.158984227129338	316	G5BU38	518	834	11.671151419558369	316
Q8VI33	PF02291	9	129	3.8733140495867766	120	G5BVA3	10	130	3.862669421487602	120
O88487	PF00400	445	482	4.4100789473684205	37	G5ANG5	472	509	4.450447368421054	37
O88487	PF11540	106	136	6.760645161290323	30	G5ANG5	133	163	6.7467741935483865	30
Q8K2Y7	PF06984	65	150	7.5914069767441825	85	G5BX64	64	149	7.551093023255817	85
Q8C761	PF00400	633	667	24.499342857142853	34	G5BHJ2	785	819	24.453085714285717	34
Q60778	PF12796	61	147	6.011402298850576	86	G5AMA1	62	148	2.3256781609195407	86
Q60778	PF13637	207	260	0.3453888888888889	53	G5AMA1	205	258	0.1693148148148147	53
P56873	PF06677	36	73	1.017078947368421	37	G5B6K4	37	74	1.0213684210526317	37
Q8CFI5	PF00587	142	353	4.068221698113209	211	G5BXH3	143	354	3.5354716981132066	211
Q8CFI5	PF03129	370	461	9.076489130434783	91	G5BXH3	371	462	6.182619565217391	91
Q9D5U5	PF13419	25	198	2.328752873563218	173	G5B3T3	1	174	5.523149425287355	173
Q8K124	PF00169	20	118	5.48210101010101	98	G5AN75	16	113	0.6439489795918366	97
Q8JZU2	PF00153	24	112	0.3128089887640448	88	G5C052	25	113	0.3128651685393257	88
Q8JZU2	PF00153	123	211	7.180775280898875	88	G5C052	124	212	7.179842696629216	88
Q8JZU2	PF00153	218	305	12.355886363636358	87	G5C052	219	306	17.19213636363637	87
O55201	PF00467	472	498	11.701629629629627	26	G5BJD6	479	505	15.212703703703706	26
O55201	PF03439	175	261	3.4339999999999997	86	G5BJD6	182	268	3.4721839080459755	86
O55201	PF11942	72	169	0.021306122448979597	97	G5BJD6	79	176	0.014183673469387753	97
Q03147	PF00069	65	294	4.062334782608696	229	G5B4C7	1	230	3.329891304347828	229
Q9D820	PF04073	25	152	7.055671875	127	G5B8W6	26	153	6.214937499999998	127
Q7TT00	PF12090	63	153	1.9279120879120888	90	G5B3N0	64	154	1.8693956043956041	90
Q7TT00	PF12090	161	223	1.3235714285714288	62	G5B3N0	162	224	1.1399206349206348	62
D3YXK2	PF00076	430	498	0.6444492753623188	68	G5C0Q8	424	492	0.6074347826086957	68
D3YXK2	PF02037	30	64	0.03565714285714286	34	G5C0Q8	31	65	0.034800000000000005	34
Q60848	PF00176	220	559	5.448679411764704	339	G5B2S9	235	574	5.729623529411764	339
Q60848	PF00271	582	694	8.83805309734513	112	G5B2S9	597	709	7.886955752212389	112
Q61967	PF00096	207	229	0.0	22	G5C694	178	200	0.0	22
Q61967	PF00096	277	299	0.0	22	G5C694	249	271	0.0	22
Q61967	PF00096	305	327	0.0	22	G5C694	277	299	0.0	22
Q61967	PF00096	333	355	0.0	22	G5C694	305	327	0.0	22
Q61967	PF00096	361	383	0.0	22	G5C694	333	355	0.0	22
Q61967	PF00096	389	411	0.0	22	G5C694	361	383	0.0	22
Q61967	PF00096	493	515	0.0	22	G5C694	464	486	0.0	22
Q61967	PF00096	521	543	0.0	22	G5C694	492	514	0.0	22
Q61967	PF00096	549	571	0.0	22	G5C694	492	514	0.0	22
Q61967	PF00096	577	599	0.0	22	G5C694	520	542	0.0	22
Q61967	PF00096	605	627	0.0	22	G5C694	548	570	0.0	22
Q61967	PF01352	12	53	1.6718095238095236	41	G5C694	12	52	0.4123902439024392	40
Q9D7J6	PF03372	53	280	3.5280307017543877	227	G5BFK6	35	266	5.510991379310343	231
Q8VHR5	PF00320	420	453	0.02426470588235294	33	G5BER9	420	453	0.016176470588235296	33
Q8VHR5	PF16563	159	200	0.0	41	G5BER9	159	200	0.0	41
Q8VDD9	PF00400	178	209	14.781593749999995	31	G5BC11	116	147	14.765687499999995	31
Q8VDD9	PF00400	214	251	0.16447368421052633	37	G5BC11	152	189	0.16407894736842105	37
Q8VDD9	PF00400	258	297	10.349625	39	G5BC11	196	235	12.77535	39
Q8VDD9	PF00400	357	391	0.0	34	G5BC11	295	329	0.0	34
Q8VDD9	PF00400	455	494	1.4218250000000006	39	G5BC11	393	432	1.44575	39
Q8VDD9	PF00439	1164	1249	2.354302325581394	85	G5BC11	1102	1187	3.3162674418604654	85
Q8VDD9	PF00439	1324	1404	2.008049382716049	80	G5BC11	1262	1342	1.960691358024691	80
Q8BLB0	PF00096	135	157	0.0	22	G5BW90	130	152	0.0	22
Q8BLB0	PF00096	163	185	0.0	22	G5BW90	158	180	0.0	22
Q8BLB0	PF00096	191	213	0.0	22	G5BW90	186	208	0.0	22
Q8BLB0	PF00096	219	241	0.5715217391304347	22	G5BW90	214	236	0.572391304347826	22
Q8BLB0	PF00096	247	269	0.0	22	G5BW90	242	264	0.0	22
Q8BLB0	PF00096	275	297	0.0	22	G5BW90	270	292	0.0	22
Q8BLB0	PF00096	303	325	0.0	22	G5BW90	298	320	0.0	22
Q8BLB0	PF00096	331	353	0.0	22	G5BW90	326	348	0.0	22
Q8BLB0	PF00096	359	381	0.0	22	G5BW90	354	376	0.0	22
Q8BLB0	PF00096	387	409	0.0	22	G5BW90	382	404	0.0	22
Q8BLB0	PF00096	443	465	0.0	22	G5BW90	438	460	0.04760869565217391	22
Q8BLB0	PF00096	471	493	0.0	22	G5BW90	466	488	0.0	22
Q8R1C6	PF10294	167	325	6.131213836477988	158	G5BSD1	203	361	8.589540880503144	158
Q61216	PF00149	25	248	3.2456741071428565	223	G5BCY4	1	224	3.2716294642857155	223
Q61216	PF04152	294	461	0.6461428571428572	167	G5BCY4	270	436	0.28022754491017965	166
Q60769	PF02338	97	256	5.031493750000001	159	G5C1B8	98	257	8.665387500000003	159
Q60769	PF01754	384	406	3.902086956521739	22	G5C1B8	385	407	3.786913043478261	22
Q60769	PF01754	467	490	0.2783333333333333	23	G5C1B8	476	499	0.28041666666666665	23
Q60769	PF01754	640	662	0.0	22	G5C1B8	576	598	0.0	22
Q60769	PF01754	744	768	0.0	24	G5C1B8	476	499	0.28041666666666665	23
Q3U0V2	PF00531	221	298	0.06307692307692309	77	G5C644	222	299	0.0625	77
Q3U0V2	PF09034	50	159	1.5858181818181811	109	G5C644	51	160	1.1279363636363635	109
P53776	PF00412	29	84	0.6710535714285714	55	G5AYL6	30	85	0.6710535714285714	55
P53776	PF00412	88	145	10.97446551724138	57	G5AYL6	89	146	10.97446551724138	57
P53776	PF00046	157	213	5.907982456140351	56	G5AYL6	158	214	5.907982456140351	56
P50171	PF13561	31	255	3.630933333333332	224	G5BAZ7	205	422	3.812426605504587	217
Q9EP71	PF00023	183	214	1.52509375	31	G5BQ94	184	215	1.5975937500000004	31
Q9EP71	PF12796	22	107	0.2616744186046511	85	G5BQ94	23	107	0.2231882352941177	84
Q9EP71	PF12796	114	181	5.600558823529411	67	G5BQ94	115	182	5.94786764705882	67
Q3UFK8	PF00373	138	272	1.6350962962962965	134	G5B6K7	139	273	1.0495851851851852	134
Q6VVW5	PF00211	851	1036	6.218059139784943	185	G5BKZ1	852	1037	6.185231182795695	185
Q6VVW5	PF01094	44	396	9.62181019830028	352	G5BKZ1	45	397	8.795643059490086	352
Q6VVW5	PF07714	539	782	4.006672131147542	243	G5BKZ1	540	783	2.924721311475411	243
P04426	PF00110	60	368	2.210847896440129	308	G5AU35	61	369	2.2089126213592225	308
Q8K4D7	PF00168	520	617	11.663775510204086	97	G5C2C1	493	590	9.404500000000006	97
Q8K4D7	PF00387	385	498	7.230149122807016	113	G5C2C1	358	470	3.6701681415929235	112
Q8K4D7	PF00388	164	307	7.3926041666666675	143	G5C2C1	157	300	5.571930555555557	143
Q8K4D7	PF09279	71	154	0.01809523809523809	83	G5C2C1	64	147	1.2291071428571427	83
Q8BXF8	PF00022	6	368	5.878925619834706	362	G5AY01	7	372	6.49231780821918	365
Q3UHB8	PF15558	332	704	0.08015549597855227	372	G5BQM6	146	518	0.14420911528150132	372
Q8VDT9	PF10501	60	140	0.2912469135802469	80	G5ANC2	60	140	0.09680246913580244	80
Q8BTZ4	PF12862	238	337	6.6218200000000005	99	G5AWN0	253	352	6.627489999999999	99
Q8BTZ4	PF12862	444	475	3.865375	31	G5AWN0	459	490	3.867	31
Q6PEE2	PF02854	383	577	6.350005128205124	194	G5B881	322	516	6.364292307692302	194
Q3TLP5	PF00378	42	294	1.0791264822134383	252	G5BAL8	39	294	1.3007500000000003	255
Q80TA6	PF06602	316	499	9.715211956521742	183	G5AKD3	394	577	9.284853260869564	183
Q80TA6	PF12578	558	683	0.0	125	G5AKD3	636	760	0.0	124
Q9DAC7	PF07719	91	120	0.0	29	G5AZA9	96	125	0.9192	29
Q8CE46	PF01142	297	696	2.262910000000001	399	G5BX29	297	694	1.9690402010050247	397
O09106	PF00850	27	316	2.8268	289	G5B5L5	108	397	2.8386517241379337	289
Q9WUA1	PF02019	37	171	4.543607407407409	134	G5AY55	38	172	4.235466666666665	134
Q9WUA1	PF12661	217	235	0.03157894736842105	18	G5AY55	218	236	0.2159473684210526	18
Q9WUA1	PF12661	249	266	0.0	17	G5AY55	250	267	0.0	17
Q9WUA1	PF12661	281	299	0.0	18	G5AY55	282	300	0.0	18
Q8VC10	PF13738	236	318	9.47926506024096	82	G5BFX7	232	313	8.064085365853659	81
Q8C2P3	PF01207	20	294	2.739043636363637	274	G5BJ96	21	295	2.212316363636364	274
Q9JHI0	PF00045	292	333	6.969523809523812	41	G5BB99	291	332	8.179309523809524	41
Q9JHI0	PF00045	336	370	0.0526	34	G5BB99	335	368	0.09573529411764704	33
Q9JHI0	PF00045	379	425	0.0	46	G5BB99	378	424	0.0	46
Q9JHI0	PF00045	429	467	4.547333333333333	38	G5BB99	428	465	0.0	37
Q9JHI0	PF00413	104	256	0.0843986928104575	152	G5BB99	103	255	0.06839869281045753	152
Q9JHI0	PF01471	30	80	1.1208627450980393	50	G5BB99	29	79	1.1895686274509805	50
Q9DBR1	PF03159	0	253	4.545086614173232	253	G5CBC2	1	254	4.545314960629921	253
Q9DBR1	PF17846	325	785	4.493340563991321	460	G5CBC2	326	786	4.494900216919735	460
A2AFR3	PF00373	298	423	2.5404365079365085	125	G5BEH8	309	434	2.544626984126984	125
A2AFR3	PF00595	85	150	12.862742424242427	65	G5BEH8	96	161	13.669651515151514	65
Q8K274	PF03881	12	306	0.5220915254237289	294	G5BJB2	13	308	0.570793918918919	295
P43404	PF00017	9	84	6.518592105263159	75	G5BMU3	10	84	6.547106666666667	74
P43404	PF00017	162	237	5.701815789473687	75	G5BMU3	140	215	5.681749999999997	75
P43404	PF07714	340	589	1.1199480000000004	249	G5BMU3	316	565	1.1452559999999998	249
O88685	PF00004	225	357	2.3108721804511285	132	G5BPC9	207	339	2.3070751879699247	132
O88685	PF16450	92	167	2.499499999999999	75	G5BPC9	74	149	2.4088026315789457	75
O88685	PF17862	380	421	0.1111904761904762	41	G5BPC9	362	403	0.1113095238095238	41
Q8BGS3	PF00096	402	424	0.02978260869565217	22	G5AN10	405	427	0.02978260869565217	22
Q8BGS3	PF00096	430	452	0.0	22	G5AN10	433	455	0.0	22
Q8BGS3	PF00096	458	480	0.0	22	G5AN10	461	483	0.0	22
Q8BGS3	PF00096	486	508	0.4821739130434782	22	G5AN10	489	511	0.4834782608695653	22
Q8BGS3	PF00096	514	536	0.0	22	G5AN10	517	539	0.0	22
Q8BGS3	PF01352	224	264	1.492439024390244	40	G5AN10	226	266	1.4688536585365854	40
Q8BGS3	PF02023	51	129	0.4010506329113924	78	G5AN10	51	128	0.4073589743589744	77
Q8BGS3	PF16622	373	395	0.0	22	G5AN10	376	398	0.0	22
Q8CFU8	PF14839	63	216	3.0751818181818185	153	G5BPT1	69	222	0.96961038961039	153
J3QPP8	PF15129	57	125	0.018913043478260876	68	G5BKS6	58	126	0.018913043478260876	68
P54369	PF02100	144	214	9.693985915492958	70	G5BBC6	105	175	17.317056338028163	70
Q62468	PF00626	27	107	8.052246913580246	80	G5AZI8	28	108	8.088753086419754	80
Q62468	PF00626	146	217	11.432055555555555	71	G5AZI8	147	218	7.890569444444443	71
Q62468	PF00626	268	341	0.3866621621621621	73	G5AZI8	269	342	0.2361081081081081	73
Q62468	PF00626	408	488	18.38954320987654	80	G5AZI8	409	489	18.696543209876552	80
Q62468	PF00626	531	594	1.13003125	63	G5AZI8	532	595	1.4302968750000002	63
Q62468	PF00626	637	706	9.981028571428569	69	G5AZI8	638	707	8.962371428571426	69
Q62468	PF02209	791	826	0.0	35	G5AZI8	792	827	0.0	35
Q80XS7	PF07894	20	288	6.495513011152411	268	G5B889	20	289	5.3031555555555565	269
Q5SUR0	PF02769	443	600	1.6482911392405069	157	G5B5F7	444	601	1.1533354430379743	157
Q5SUR0	PF02769	902	981	1.0449875	79	G5B5F7	904	983	1.1074249999999997	79
Q5SUR0	PF13507	1062	1330	4.442059479553902	268	G5B5F7	1064	1332	4.471460966542753	268
Q5SUR0	PF18072	183	231	0.017040816326530612	48	G5B5F7	184	232	0.2179591836734694	48
Q5SUR0	PF18076	83	154	0.5125416666666667	71	G5B5F7	84	155	2.271722222222222	71
Q80XC3	PF00566	103	311	18.77062679425838	208	G5BBE7	127	313	16.831080213903743	186
Q8CGB6	PF00017	1130	1222	1.4789247311827955	92	G5BIH5	1080	1172	1.4803118279569896	92
Q8CGB6	PF08416	1265	1398	7.853238805970151	133	G5BIH5	1215	1348	7.806529850746268	133
Q8CGB6	PF10409	296	422	4.7347559055118085	126	G5BIH5	297	423	1.7909055118110242	126
Q91VR2	PF00231	26	296	5.291590405904059	270	G5AXV6	27	303	6.380880434782611	276
Q9CPX7	PF00886	24	83	2.2337333333333342	59	G5C7G4	25	84	2.19855	59
Q6Q899	PF16739	0	91	7.070641304347825	91	G5C355	1	92	9.862271739130435	91
Q6Q899	PF16739	99	185	0.5996091954022988	86	G5C355	100	186	0.015931034482758618	86
Q6Q899	PF00271	623	733	13.286387387387393	110	G5C355	624	733	12.562763636363636	109
Q6Q899	PF04851	253	410	12.009841772151887	157	G5C355	254	411	12.573025316455693	157
Q6Q899	PF11648	807	922	2.9490862068965518	115	G5C355	807	922	1.4309224137931034	115
Q6Q899	PF18119	460	601	3.832309859154932	141	G5C355	461	602	0.3866549295774649	141
Q1PSW8	PF00630	473	563	11.346879120879118	90	G5BIV3	289	379	5.166692307692308	90
Q1PSW8	PF00643	262	297	0.08008333333333334	35	G5BIV3	78	113	1.4653888888888893	35
Q1PSW8	PF01436	592	619	18.069750000000006	27	G5BIV3	408	435	16.09375	27
Q1PSW8	PF01436	639	666	6.422285714285714	27	G5BIV3	455	482	8.111464285714286	27
Q1PSW8	PF01436	686	711	0.0	25	G5BIV3	502	527	0.0	25
Q1PSW8	PF01436	733	759	0.0	26	G5BIV3	549	575	0.0	26
Q1PSW8	PF01436	780	807	0.0	27	G5BIV3	596	623	0.0	27
Q1PSW8	PF01436	829	854	18.291846153846148	25	G5BIV3	645	670	15.32679999999999	25
Q80Z38	PF00536	1411	1472	0.0	61	G5BSS8	1408	1469	0.0	61
Q80Z38	PF07653	151	203	4.081716981132074	52	G5BSS8	164	216	5.453471698113207	52
Q80Z38	PF17820	286	336	0.2374705882352941	50	G5BSS8	299	349	0.3777843137254902	50
Q8R4F1	PF00053	286	327	0.0	41	G5AT47	287	328	0.0	41
Q8R4F1	PF00053	412	460	7.573591836734695	48	G5AT47	359	407	7.613857142857141	48
Q8R4F1	PF00053	468	510	0.0	42	G5AT47	287	331	0.0	44
Q8R4F1	PF00055	38	284	6.32910931174089	246	G5AT47	39	285	4.756157894736839	246
Q6XUX1	PF07714	651	896	8.528873983739837	245	G5B2D7	573	818	8.542024390243903	245
Q8BLK3	PF07679	49	127	6.806772151898733	78	G5AMW9	1	79	6.83640506329114	78
Q8BLK3	PF13927	130	200	2.677901408450703	70	G5AMW9	82	152	2.667704225352113	70
Q8BLK3	PF13927	217	293	0.08642857142857144	76	G5AMW9	169	245	0.086	76
P10637	PF00418	541	565	0.0	24	G5BMZ1	570	594	0.0	24
P10637	PF00418	566	595	0.0	29	G5BMZ1	595	624	0.03656666666666666	29
P10637	PF00418	597	627	1.2943548387096775	30	G5BMZ1	626	656	1.0325806451612902	30
P10637	PF00418	628	659	0.0	31	G5BMZ1	657	688	0.0	31
Q80YA9	PF00169	572	666	15.466778947368427	94	G5BK50	552	646	15.62444210526316	94
Q80YA9	PF00536	21	70	0.0	49	G5BK50	1	50	0.033319999999999995	49
Q80YA9	PF00595	222	290	1.8250579710144927	68	G5BK50	202	270	2.1944637681159427	68
Q80YA9	PF06663	338	494	0.16801273885350318	156	G5BK50	318	474	0.16810828025477706	156
Q80YA9	PF10534	83	175	4.463591397849459	92	G5BK50	63	155	4.465763440860214	92
O08550	PF00628	1256	1307	0.061711538461538464	51	G5BXN0	1108	1159	0.061442307692307685	51
O08550	PF00628	1342	1399	0.19091379310344828	57	G5BXN0	1194	1251	0.19012068965517245	57
O08550	PF00856	2583	2687	6.000066666666666	104	G5BXN0	2463	2567	5.992390476190474	104
O08550	PF02008	964	1009	0.0	45	G5BXN0	817	862	0.0	45
O08550	PF05964	1738	1785	4.922354166666668	47	G5BXN0	1585	1632	3.5474583333333336	47
O08550	PF05965	2408	2490	5.229337349397591	82	G5BXN0	2288	2370	5.176277108433736	82
O08550	PF13771	1613	1691	0.6376075949367089	78	G5BXN0	1460	1538	0.6349746835443038	78
Q6P069	PF13405	104	131	0.021285714285714286	27	G5C4X8	88	115	0.0	27
Q6P069	PF13833	44	99	4.334910714285715	55	G5C4X8	28	83	5.574857142857144	55
P27601	PF00503	94	365	5.669577205882354	271	G5BLS4	54	325	5.763882352941179	271
P28798	PF00396	71	111	1.4310731707317073	40	G5BIZ8	146	186	0.3645609756097561	40
P28798	PF00396	136	177	0.10269047619047618	41	G5BIZ8	359	399	0.0	40
P28798	PF00396	218	259	0.0	41	G5BIZ8	285	326	0.0	41
P28798	PF00396	292	333	0.0	41	G5BIZ8	359	400	0.0	41
P28798	PF00396	374	413	0.099625	39	G5BIZ8	437	476	0.0	39
P28798	PF00396	452	493	0.0	41	G5BIZ8	514	555	0.0	41
P28798	PF00396	527	568	0.06378571428571428	41	G5BIZ8	591	632	0.0	41
Q8CD91	PF00086	89	152	0.7562656249999999	63	G5BM67	62	125	0.7519843750000001	63
Q8CD91	PF00086	215	280	7.7651515151515165	65	G5BM67	199	264	7.772484848484849	65
Q8CD91	PF07648	39	83	0.0	44	G5BM67	12	56	0.0	44
Q8CD91	PF10591	344	411	1.2608823529411757	67	G5BM67	328	395	1.221485294117647	67
Q8CD91	PF16597	153	213	0.0	60	G5BM67	126	197	12.017222222222221	71
Q6NSV7	PF12516	115	150	0.0	35	G5C7G2	114	150	0.0	36
P21784	PF03089	50	388	4.48322418879056	338	G5B130	51	389	5.062598820058999	338
P21784	PF13341	413	490	1.5204102564102566	77	G5B130	414	491	1.3229487179487178	77
Q8BZ33	PF00017	428	517	0.7304555555555557	89	G5AX75	352	441	1.2597222222222226	89
Q8BZ33	PF08416	562	687	6.882912698412699	125	G5AX75	486	611	5.6184206349206365	125
Q91YI4	PF00339	19	173	7.183761290322577	154	G5BWB1	13	167	7.116393548387094	154
Q91YI4	PF02752	197	348	3.9840131578947378	151	G5BWB1	190	341	3.9824671052631566	151
Q9D394	PF02759	102	224	10.949983739837402	122	G5BN01	103	225	10.884975609756095	122
Q9JK53	PF00560	307	330	0.034208333333333334	23	G5B363	312	335	0.102125	23
Q9JK53	PF13855	98	157	8.15175	59	G5B363	103	162	9.962133333333334	59
Q9JK53	PF13855	167	226	0.07913333333333332	59	G5B363	172	231	0.2013333333333333	59
Q9JK53	PF13855	240	298	2.4570677966101693	58	G5B363	245	303	2.455542372881356	58
Q924X7	PF00069	239	376	7.8185	137	G5B1Q4	1	137	8.53397810218978	136
O54864	PF00385	42	90	0.6696530612244898	48	G5BJH8	37	85	1.0846734693877549	48
O54864	PF00856	254	365	4.5399375	111	G5BJH8	249	360	4.53830357142857	111
O54864	PF05033	140	234	3.4987894736842113	94	G5BJH8	135	229	4.8564105263157895	94
Q8C0J2	PF00400	316	348	0.25103030303030305	32	G5BXG4	383	415	1.2219696969696972	32
Q8C0J2	PF00400	359	392	2.645764705882353	33	G5BXG4	426	459	2.644617647058823	33
Q8C0J2	PF00400	399	435	0.0	36	G5BXG4	466	502	0.0	36
Q8C0J2	PF00400	536	561	18.672384615384615	25	G5BXG4	603	628	22.352269230769227	25
Q8C0J2	PF08614	15	205	0.6172774869109946	190	G5BXG4	16	206	0.4632251308900523	190
Q8BUZ1	PF14705	298	373	17.135355263157898	75	G5AZ79	301	376	17.76013157894737	75
Q8K3I4	PF02318	7	124	9.40857627118644	117	G5ALW8	8	177	5.7618294117647055	169
Q8K3I4	PF04698	152	632	0.5019584199584199	480	G5ALW8	205	673	0.7779573560767591	468
P97372	PF02251	11	66	0.8366071428571423	55	G5B294	12	66	6.949018181818182	54
P97372	PF02252	93	234	11.092338028169014	141	G5B294	115	256	13.419887323943653	141
Q91W53	PF10256	11	122	8.503446428571428	111	G5BYA2	12	123	6.5948214285714295	111
Q61550	PF04824	578	631	8.72988888888889	53	G5AT87	577	630	8.730685185185187	53
Q61550	PF04825	0	102	3.394631067961165	102	G5AT87	1	103	3.39690291262136	102
B1AWI6	PF05825	47	114	0.1853088235294118	67	G5BKZ4	48	115	0.1841911764705882	67
Q8CDJ3	PF10186	42	382	1.421202346041056	340	G5AJQ5	43	380	3.545124260355029	337
Q9EPJ9	PF01412	7	107	11.199217821782176	100	G5C8D6	8	108	11.224653465346535	100
Q6GQX6	PF00023	215	244	6.506333333333332	29	G5AZ19	125	154	3.4370000000000003	29
Q6GQX6	PF00536	779	830	2.4268076923076918	51	G5AZ19	653	704	2.341057692307692	51
Q6GQX6	PF12796	58	129	0.0793611111111111	71	G5AZ19	216	287	8.764583333333327	71
Q6GQX6	PF12796	134	210	9.233857142857136	76	G5AZ19	44	119	7.4196710526315774	75
Q6GQX6	PF12796	288	379	9.347304347826084	91	G5AZ19	198	289	6.878684782608691	91
Q6PFX8	PF08443	109	296	3.524345744680851	187	G5AQI9	110	297	3.446643617021276	187
Q8BMD7	PF07496	421	466	2.8128260869565214	45	G5C3Z3	423	468	2.942304347826087	45
Q8BMD7	PF13589	50	147	2.290520408163265	97	G5C3Z3	51	148	2.3532755102040817	97
Q8BMD7	PF17942	265	399	2.771977777777777	134	G5C3Z3	264	398	2.2219703703703706	134
Q9WTJ8	PF04921	111	331	0.4247330316742081	220	G5BGL6	112	331	0.376509090909091	219
Q9JIK9	PF16053	60	183	1.2737741935483868	123	G5BY67	61	190	0.7981615384615388	129
Q80SU4	PF00143	25	181	5.679356687898091	156	G5C259	26	181	1.4057307692307688	155
Q923Z3	PF01134	55	433	3.1627757255936704	378	G5ALK6	57	450	6.768154822335024	393
Q923Z3	PF13932	436	655	0.8889727272727275	219	G5ALK6	453	672	0.4984318181818183	219
P98083	PF00017	483	554	0.7080972222222224	71	G5BDE0	378	457	0.642025	79
P98083	PF00640	161	316	4.165089743589742	155	G5BDE0	52	207	4.083217948717947	155
P16254	PF02290	3	93	2.8177362637362644	90	G5BLY1	27	117	2.7920219780219786	90
Q6Q783	PF00856	155	217	0.4562222222222223	62	G5BVZ7	156	218	0.4664285714285718	62
P41133	PF00010	41	80	0.328925	39	G5BHY6	42	81	0.43215	39
Q8K3K8	PF16516	410	507	5.823224489795918	97	G5BE21	403	499	5.030381443298968	96
Q8K3K8	PF11577	36	103	0.0	67	G5BE21	37	104	0.01911764705882353	67
Q8K3K8	PF18414	557	582	0.0	25	G5BE21	548	573	0.0	25
Q8BK58	PF13621	35	272	6.419903361344536	237	G5AV97	15	252	4.916718487394953	237
Q8VD46	PF07647	272	332	1.2654262295081968	60	G5B3Q9	273	333	2.271508196721311	60
Q8VD46	PF12796	129	209	10.936469135802476	80	G5B3Q9	130	210	11.081283950617282	80
Q8VD46	PF13637	51	98	2.4209791666666667	47	G5B3Q9	52	99	12.444312500000002	47
P58404	PF00400	434	472	0.06400000000000003	38	G5AUZ8	433	471	0.0644871794871795	38
P58404	PF00400	543	578	2.7052222222222215	35	G5AUZ8	542	577	2.7219722222222216	35
P58404	PF00400	675	713	1.9014615384615383	38	G5AUZ8	679	717	1.9141282051282047	38
P58404	PF00400	718	753	0.09475	35	G5AUZ8	722	757	0.09861111111111108	35
P58404	PF08232	91	191	0.2639009900990099	100	G5AUZ8	24	124	0.3022079207920792	100
Q9CWX9	PF00270	47	214	5.615636904761907	167	G5BYF5	47	214	5.613267857142856	167
Q9CWX9	PF00271	250	357	10.039333333333328	107	G5BYF5	250	357	10.01357407407408	107
Q9QXJ1	PF00397	254	282	0.16965517241379313	28	G5BBR1	254	282	0.17017241379310344	28
Q9QXJ1	PF00640	369	507	2.243237410071942	138	G5BBR1	369	522	2.192688311688312	153
Q9QXJ1	PF00640	577	662	12.149686046511624	85	G5BBR1	592	677	14.55602325581394	85
Q8BI72	PF11952	18	116	1.4477676767676768	98	G5B768	19	124	0.8418584905660381	105
Q00LT2	PF15201	0	47	19.547375	47	G5AQU4	1	48	16.812625	47
Q60935	PF01129	38	268	4.2097748917748925	230	G5AVS6	39	273	4.138068085106384	234
Q9JMH9	PF00063	407	1045	5.998009389671357	638	G5BVJ4	408	1053	6.809352941176472	645
Q9JMH9	PF00063	1081	1168	0.8014204545454546	87	G5BVJ4	1089	1176	0.8293749999999996	87
Q9JMH9	PF00595	221	307	0.20128735632183914	86	G5BVJ4	222	308	0.20122988505747127	86
Q9JMH9	PF01576	1214	1671	0.07008078602620088	457	G5BVJ4	1222	1679	0.05776200873362445	457
Q9D8L0	PF15147	0	126	0.013031496062992124	126	G5CB00	1	126	0.10176	125
Q8BYN3	PF05770	119	316	8.79856060606061	197	G5B2Y0	120	317	8.855363636363641	197
Q8BYN3	PF17927	8	99	0.8518260869565215	91	G5B2Y0	9	100	0.8518260869565221	91
Q9QZS3	PF06311	257	337	0.03833333333333333	80	G5C1P5	258	338	0.012469135802469136	80
Q9QZS3	PF00640	38	170	4.805774436090228	132	G5C1P5	39	171	4.817278195488723	132
Q7TPR4	PF00307	32	134	11.889174757281554	102	G5C7W9	94	196	12.107271844660193	102
Q7TPR4	PF00307	144	249	9.216773584905658	105	G5C7W9	206	311	9.214999999999998	105
Q7TPR4	PF00435	274	382	0.006715596330275229	108	G5C7W9	336	444	0.006715596330275229	108
Q7TPR4	PF00435	393	497	0.05485714285714288	104	G5C7W9	455	559	0.05485714285714288	104
Q7TPR4	PF00435	509	619	1.7630090090090096	110	G5C7W9	571	681	1.7624774774774778	110
Q7TPR4	PF00435	630	731	1.626764705882353	101	G5C7W9	692	793	1.6262843137254899	101
Q7TPR4	PF08726	821	887	0.33016417910447776	66	G5C7W9	905	971	0.35262686567164186	66
Q9CRD4	PF04440	9	137	0.0	128	G5BB15	63	192	0.0	129
Q8K3G5	PF00069	233	421	2.594783068783067	188	G5B8R8	313	500	3.908835106382978	187
Q8K3G5	PF13240	3	25	0.0	22	G5B8R8	52	74	0.0	22
P59509	PF00090	639	687	0.0	48	G5BNU5	609	657	0.0	48
P59509	PF01421	329	545	8.22806912442396	216	G5BNU5	299	515	8.32269585253456	216
P59509	PF01562	165	275	3.1525315315315314	110	G5BNU5	135	245	4.031495495495495	110
P59509	PF05986	792	902	5.580873873873872	110	G5BNU5	762	872	5.390225225225223	110
P59509	PF17771	561	628	1.0708676470588234	67	G5BNU5	531	598	6.59264705882353	67
P59509	PF19030	921	978	0.5322931034482757	57	G5BNU5	891	948	0.23431034482758625	57
P59509	PF19030	982	1038	0.011771929824561402	56	G5BNU5	952	1008	0.023543859649122804	56
P59509	PF19030	1042	1086	0.01491111111111111	44	G5BNU5	1012	1056	0.0	44
P59509	PF19030	1093	1145	0.0	52	G5BNU5	1063	1115	0.0	52
Q8C3Y4	PF10493	487	772	3.862846153846154	285	G5AWR2	417	703	4.839317073170732	286
Q8C3Y4	PF10493	1626	1990	9.707789041095882	364	G5AWR2	1467	1788	9.517732919254652	321
Q9DCV7	PF00038	83	395	0.3066102236421725	312	G5BL96	71	383	0.3996453674121409	312
Q9DCV7	PF16208	52	80	0.02620689655172414	28	G5BL96	40	68	0.02082758620689655	28
Q91VE6	PF00076	48	117	1.2063	69	G5BKC7	52	121	5.838085714285714	69
Q91VE6	PF12196	249	287	0.0	38	G5BKC7	237	275	0.015	38
Q921W4	PF08240	31	123	0.5267204301075268	92	G5AM28	34	126	0.8508064516129032	92
Q8BH93	PF15822	121	238	0.0	117	G5C8Y3	1	119	0.0	118
Q9JJ69	PF13499	178	250	0.6917260273972601	72	G5CAG3	134	206	0.6889178082191781	72
Q9JJ69	PF13833	119	166	14.053729166666665	47	G5CAG3	75	122	18.068229166666665	47
P15655	PF00167	28	147	1.1518583333333334	119	G5C796	9	128	1.1675250000000006	119
O08849	PF00615	83	197	0.2400260869565218	114	G5ASG7	84	198	0.2400260869565218	114
Q8BTI8	PF08312	57	100	0.7838409090909092	43	G5B1K2	58	101	0.7844545454545454	43
Q8BZI6	PF09778	21	210	3.875984210526316	189	G5B629	32	220	3.8633439153439153	188
P35486	PF00676	66	359	0.4920340136054422	293	G5BZ40	58	351	0.4865068027210884	293
Q62048	PF01335	3	83	4.161728395061727	80	G5BWK6	4	84	4.161728395061727	80
Q3UFF7	PF02230	62	225	5.957847560975613	163	G5AT78	17	180	4.528890243902441	163
Q8VE52	PF04664	115	317	5.142443349753695	202	G5ALU4	51	290	4.349324999999999	239
Q99M03	PF05773	7	131	10.490647999999997	124	G5B1C3	49	173	7.3446960000000026	124
Q99M03	PF06544	162	244	0.7662289156626506	82	G5B1C3	204	286	0.8407108433734941	82
Q9CU65	PF06467	325	361	0.0	36	G5BKW1	325	361	0.0	36
Q9CU65	PF06467	367	407	1.083829268292683	40	G5BKW1	367	407	1.0822926829268291	40
Q9CU65	PF06467	419	454	0.0	35	G5BKW1	419	454	0.0	35
Q9CU65	PF06467	461	500	1.33825	39	G5BKW1	461	500	1.275675	39
Q9CU65	PF06467	531	568	0.0	37	G5BKW1	531	568	0.0	37
Q9CU65	PF06467	634	666	0.0	32	G5BKW1	326	357	0.0	31
Q9CU65	PF06467	721	745	0.0	24	G5BKW1	593	616	0.0	23
Q9CU65	PF06467	763	797	0.0	34	G5BKW1	616	650	0.0	34
Q9CU65	PF12012	1190	1357	6.247410714285714	167	G5BKW1	1043	1210	6.3726547619047595	167
Q99PR8	PF00011	69	161	0.6177204301075269	92	G5CB01	70	162	0.7243440860215055	92
Q99PR8	PF00525	17	53	0.07497297297297296	36	G5CB01	18	54	0.07416216216216216	36
A2AGH6	PF09497	107	160	3.3001111111111108	53	G5BW30	76	129	6.519722222222222	53
A2AGH6	PF12144	1820	2026	0.024009661835748798	206	G5BW30	1765	1971	0.026009661835748796	206
A2AGH6	PF12145	286	757	5.295985169491527	471	G5BW30	255	726	5.501463983050847	471
O35066	PF00225	20	256	3.258130801687764	236	G5CBL0	1	237	3.2591223628691983	236
O35066	PF00225	286	366	4.981197530864198	80	G5CBL0	269	349	5.00862962962963	80
Q7TQI3	PF10275	42	270	5.173772925764194	228	G5B6F8	43	271	5.196464912280702	228
Q99N69	PF00412	151	205	0.024272727272727283	54	G5AP48	166	220	0.013545454545454545	54
Q99N69	PF00412	210	264	4.6990181818181815	54	G5AP48	225	279	5.797999999999999	54
Q99N69	PF00412	269	323	0.03534545454545455	54	G5AP48	284	338	0.014454545454545456	54
Q99N69	PF00412	328	382	6.704999999999997	54	G5AP48	343	397	7.7294363636363626	54
Q8CB59	PF10595	171	534	0.03230219780219778	363	G5C1N5	170	534	0.02801369863013699	364
O54941	PF00505	65	132	0.08479411764705884	67	G5AX73	66	133	0.08452941176470588	67
Q62136	PF00102	922	1166	5.662318367346937	244	G5BRE2	845	1089	6.1003061224489805	244
Q62136	PF00373	107	220	0.21728947368421045	113	G5BRE2	108	221	0.2215175438596492	113
Q62136	PF09379	26	89	13.043078125	63	G5BRE2	27	90	13.04234375	63
Q62136	PF09380	225	308	0.8193452380952382	83	G5BRE2	226	309	0.8167261904761903	83
Q3TGF2	PF06625	9	88	0.0	79	G5BAK4	10	88	0.07216666666666667	78
O54950	PF00571	125	175	5.46029411764706	50	G5AU31	126	176	5.170117647058825	50
O54950	PF00571	201	247	19.386404255319157	46	G5AU31	202	248	19.365574468085107	46
O54950	PF00571	274	321	6.040041666666667	47	G5AU31	275	322	6.176208333333332	47
Q80W40	PF00501	65	476	4.830075242718446	411	G5BVA1	66	443	8.816264550264549	377
Q80W40	PF13193	485	565	6.584148148148148	80	G5BVA1	452	491	0.0	39
Q3TDD9	PF10205	10	110	0.0	100	G5ANB9	11	111	0.0	100
Q3TDD9	PF10212	254	770	1.7985222437137318	516	G5ANB9	255	771	4.379636363636365	516
Q6NZL6	PF12796	532	626	0.7758631578947369	94	G5C5S3	531	625	0.7913368421052633	94
Q6NZL6	PF13176	314	341	0.0	27	G5C5S3	315	342	0.0	27
Q6NZL6	PF13516	1088	1106	0.5301052631578947	18	G5C5S3	1088	1106	2.813052631578947	18
Q6NZL6	PF13516	1117	1138	0.10645454545454544	21	G5C5S3	1117	1138	0.3342272727272727	21
B1AY13	PF00443	1861	2035	6.852759999999997	174	G5APQ3	1663	1837	7.720508571428572	174
B1AY13	PF12030	2220	2540	12.218947040498447	320	G5APQ3	2004	2324	13.022295950155769	320
P62761	PF00036	65	89	12.17596	24	G5AZB5	66	90	13.545319999999998	24
P62761	PF13499	97	174	14.996358974358973	77	G5AZB5	98	175	14.996358974358973	77
P48437	PF05044	579	731	5.835261437908495	152	G5BUR7	575	727	5.8323921568627455	152
Q63ZW7	PF00595	134	216	5.34287951807229	82	G5BSM7	138	220	5.110795180722891	82
Q63ZW7	PF00595	253	323	0.9097746478873237	70	G5BSM7	244	314	1.0019718309859154	70
Q63ZW7	PF00595	366	448	1.2496506024096383	82	G5BSM7	360	442	1.4069759036144591	82
Q63ZW7	PF00595	570	628	2.246864406779661	58	G5BSM7	555	613	2.2622033898305083	58
Q63ZW7	PF00595	689	770	3.514768292682924	81	G5BSM7	673	754	3.0557073170731712	81
Q63ZW7	PF00595	1076	1161	7.559186046511628	85	G5BSM7	1013	1098	7.696488372093023	85
Q63ZW7	PF00595	1246	1322	7.436454545454542	76	G5BSM7	1184	1260	10.017558441558442	76
Q63ZW7	PF00595	1473	1550	0.4615	77	G5BSM7	1184	1261	9.889128205128204	77
Q63ZW7	PF00595	1585	1636	5.781307692307693	51	G5BSM7	1519	1569	4.662490196078432	50
Q63ZW7	PF00595	1713	1783	8.221845070422537	70	G5BSM7	1015	1090	1.979565789473685	75
Q63ZW7	PF09045	9	63	3.073945454545453	54	G5BSM7	10	64	4.351654545454545	54
Q8VHS6	PF07525	533	573	0.21982926829268293	40	G5BZQ4	481	521	0.44580487804878055	40
Q8VHS6	PF12796	69	101	0.0	32	G5BZQ4	70	101	0.27759375000000003	31
Q8VHS6	PF12796	147	206	13.933583333333335	59	G5BZQ4	95	154	10.565566666666664	59
Q8VHS6	PF12796	246	335	1.928966666666667	89	G5BZQ4	194	282	1.1890898876404492	88
Q8VHS6	PF13606	382	407	14.834307692307695	25	G5BZQ4	330	355	14.218576923076927	25
A2AHG0	PF06818	464	663	0.3796999999999999	199	G5B4T3	435	634	0.22165	199
P59900	PF07546	56	122	3.0142686567164185	66	G5BCX3	5	71	3.2555522388059686	66
Q8BMG7	PF14655	72	495	6.752181603773577	423	G5AQS9	74	512	6.9478041002277875	438
Q8BMG7	PF14656	777	1343	3.498289241622577	566	G5AQS9	793	1349	2.6085960502693006	556
Q3U1V8	PF00069	138	393	6.331449218750002	255	G5BQL3	113	368	6.402808593749998	255
Q3U1V8	PF14604	51	100	2.8877	49	G5BQL3	24	72	1.9480408163265304	48
Q9JII6	PF00248	16	292	2.4087472924187727	276	G5AX38	17	293	2.8685234657039698	276
Q99PU8	PF00270	466	616	12.091509933774836	150	G5BTG2	403	553	12.080549668874168	150
Q99PU8	PF00271	685	808	1.872104838709676	123	G5BTG2	622	745	1.8743225806451609	123
Q99PU8	PF04408	873	945	19.4786301369863	72	G5BTG2	810	882	19.26435616438356	72
Q99PU8	PF07717	1038	1124	12.811172413793098	86	G5BTG2	972	1058	13.191356321839082	86
Q8CB49	PF12456	69	173	12.444104761904766	104	G5CA60	70	174	15.603133333333346	104
Q8K310	PF13893	388	473	0.6247093023255815	85	G5AZ68	345	430	0.6229767441860466	85
Q8BZ89	PF00096	80	102	0.0	22	G5ARP4	71	93	0.0	22
Q8BZ89	PF00096	136	158	0.0	22	G5ARP4	127	149	0.0	22
Q8BZ89	PF00096	164	186	0.0	22	G5ARP4	155	177	0.0	22
Q8BZ89	PF00096	192	214	0.0	22	G5ARP4	183	205	0.0	22
Q8BZ89	PF00096	220	242	0.3984782608695653	22	G5ARP4	211	233	0.3958695652173913	22
Q8BZ89	PF00096	248	270	0.0	22	G5ARP4	239	261	0.0	22
Q8BZ89	PF00096	276	298	0.0	22	G5ARP4	267	289	0.0	22
Q9WUE4	PF06218	6	274	11.529078066914494	268	G5BZS9	7	275	11.736234200743489	268
Q924T2	PF00318	80	176	5.214319587628865	96	G5B8J4	52	147	6.972989583333334	95
Q924T2	PF00318	184	254	6.963985915492956	70	G5B8J4	156	225	7.234628571428571	69
P99027	PF00428	16	113	0.18051020408163265	97	G5C8G4	17	114	1.1437448979591838	97
Q60592	PF00069	452	725	7.009408759124089	273	G5AX45	356	629	7.0356204379562	273
Q60592	PF08926	140	415	3.854938405797101	275	G5AX45	45	319	3.3400363636363646	274
Q60592	PF17820	1077	1120	0.5061136363636364	43	G5AX45	984	1027	0.4702727272727272	43
Q3UTA9	PF01652	65	224	7.049456249999998	159	G5BPZ4	68	200	7.894037593984969	132
Q00288	PF00292	8	132	0.06772	124	G5B412	33	157	0.06847999999999999	124
Q00288	PF12403	343	455	0.16078761061946906	112	G5B412	370	482	0.1514690265486726	112
Q6PGB8	PF00176	199	468	4.943333333333333	269	G5AU70	138	407	4.7744222222222295	269
Q6PGB8	PF00271	492	603	8.785124999999999	111	G5AU70	431	554	7.991290322580645	123
Q6PGB8	PF09110	749	830	0.014414634146341462	81	G5AU70	700	780	0.014592592592592591	80
Q6PGB8	PF09111	904	1017	6.124508771929822	113	G5AU70	855	968	6.124412280701756	113
Q6PGB8	PF13892	90	114	0.21744	24	G5AU70	29	53	0.21608000000000002	24
Q9CPX9	PF12861	0	83	8.323404761904763	83	G5BJ80	1	84	8.423686746987949	83
Q14AI0	PF09724	49	362	1.8723598726114647	313	G5C9R1	10	323	2.228926751592356	313
P27612	PF00400	56	96	5.740999999999998	40	G5BPW7	57	97	6.2555853658536575	40
P27612	PF00400	103	137	0.19828571428571426	34	G5BPW7	104	138	0.18434285714285714	34
P27612	PF00400	141	178	3.403394736842104	37	G5BPW7	142	179	3.4008421052631554	37
P27612	PF00400	180	216	1.3848648648648647	36	G5BPW7	181	217	1.3836486486486486	36
P27612	PF00400	220	258	6.095179487179488	38	G5BPW7	221	259	5.81574358974359	38
P27612	PF00400	270	296	5.102481481481479	26	G5BPW7	271	297	5.290259259259262	26
P27612	PF08324	534	787	7.768275590551182	253	G5BPW7	535	789	7.424639215686276	254
P27612	PF09070	346	457	7.2011964285714285	111	G5BPW7	347	458	2.0252857142857144	111
P69566	PF00622	138	255	5.899550847457622	117	G5BN45	93	210	5.325491525423726	117
P69566	PF08513	292	316	0.8826800000000001	24	G5BN45	247	271	0.8785599999999999	24
P69566	PF10607	327	631	0.9572852459016392	304	G5BN45	282	586	0.9617901639344266	304
Q9CR41	PF19026	87	127	1.6800243902439018	40	G5BM56	80	120	1.6638536585365855	40
Q9CWV6	PF06658	41	163	0.0	122	G5AXA8	42	163	0.0	121
Q9JHI2	PF02137	62	491	3.2507232558139534	429	G5B5Y5	63	490	3.151189252336449	427
Q91W69	PF01417	50	139	3.7697333333333343	89	G5C4K2	72	161	3.1089555555555553	89
Q91W69	PF02809	201	217	0.6732352941176472	16	G5C4K2	217	233	0.6281176470588234	16
Q91W69	PF02809	228	244	0.3058823529411765	16	G5C4K2	217	232	0.6673749999999999	15
O54988	PF00069	34	291	4.439705426356588	257	G5CAK0	35	292	4.44700387596899	257
O54988	PF12474	849	987	0.0	138	G5CAK0	857	995	0.0	138
O54988	PF12474	1017	1157	0.011418439716312056	140	G5CAK0	1025	1165	0.011453900709219856	140
Q9QZH3	PF00076	7	77	4.852098591549296	70	G5C4Y9	8	78	4.2911971830985935	70
Q9QZH3	PF00160	142	297	0.8388589743589742	155	G5C4Y9	143	298	0.8887564102564101	155
A2AKB4	PF00373	270	400	0.5473053435114503	130	G5C1D7	271	401	0.6757709923664122	130
A2AKB4	PF00595	64	130	13.815671641791049	66	G5C1D7	65	131	13.967014925373135	66
Q8K409	PF10391	99	146	0.02733333333333333	47	G5BT41	100	147	0.0123125	47
Q8K409	PF14716	14	76	0.0193968253968254	62	G5BT41	15	77	0.02311111111111111	62
Q8K409	PF14791	268	332	5.618846153846153	64	G5BT41	269	333	5.414384615384615	64
Q8K409	PF14792	148	261	0.5746578947368424	113	G5BT41	149	262	0.5917192982456136	113
P07744	PF00038	145	457	0.4478051118210863	312	G5BJ36	146	476	1.9958851963746203	330
P07744	PF16208	19	141	0.0	122	G5BJ36	20	142	0.0	122
Q9WUU9	PF03399	627	920	2.070462585034012	293	G5C7V5	635	928	2.263860544217688	293
Q9WUU9	PF16766	1155	1225	0.013	70	G5C7V5	1165	1235	0.2177746478873239	70
Q9WUU9	PF16768	2	285	0.4816373239436623	283	G5C7V5	3	291	0.6123598615916956	288
Q9WUU9	PF16769	1253	1966	3.0966890756302514	713	G5C7V5	1263	1977	4.794212587412587	714
Q3U487	PF00632	583	846	4.404939393939391	263	G5ARU7	538	801	4.396503787878789	263
Q3U487	PF03256	246	377	3.1538636363636368	131	G5ARU7	201	332	3.110007575757576	131
O88574	PF13866	66	132	0.03664179104477612	66	G5B401	1	67	0.037313432835820885	66
O88574	PF13867	152	204	10.826943396226415	52	G5B401	87	139	13.801018867924528	52
Q6P9Z1	PF02201	261	330	3.5048142857142865	69	G5AMT9	160	229	3.5969571428571427	69
O70318	PF00373	293	401	0.7875963302752294	108	G5C773	295	403	0.7934036697247707	108
O70318	PF04382	612	652	0.0	40	G5C773	618	658	0.0	40
O70318	PF05902	874	978	1.2715809523809525	104	G5C773	882	985	0.27971153846153834	103
O70318	PF08736	499	542	0.2136363636363636	43	G5C773	501	544	0.06465909090909093	43
O70318	PF09379	214	277	5.7941093750000014	63	G5C773	216	279	5.7464218749999985	63
O70318	PF09380	405	494	1.2985888888888897	89	G5C773	407	496	1.297966666666667	89
Q68FD7	PF14636	51	157	0.04702803738317757	106	G5BPG3	1	107	0.047196261682243	106
Q68FD7	PF14637	319	548	9.978708695652168	229	G5BPG3	269	498	9.956973913043477	229
Q68FD7	PF14638	974	1159	5.9118924731182805	185	G5BPG3	922	1107	5.862318918918918	185
Q9CZC8	PF03577	88	230	4.1825104895104905	142	G5BRL9	334	476	4.553860139860144	142
P48377	PF02257	421	496	0.7291842105263158	75	G5BYU1	382	457	0.7165394736842104	75
P48377	PF04589	105	170	0.1048030303030303	65	G5BYU1	63	127	0.19869230769230767	64
P48377	PF04589	210	357	0.002351351351351351	147	G5BYU1	167	315	0.0023959731543624165	148
Q9ET01	PF00343	113	827	3.8330643356643352	714	G5BLN4	114	833	4.153586111111116	719
P97855	PF00076	339	393	8.797345454545452	54	G5BN24	345	399	8.71649090909091	54
P97855	PF02136	10	132	5.153097560975612	122	G5BN24	11	137	5.7304015748031505	126
Q9CR78	PF13873	9	86	7.526705128205126	77	G5CAM9	10	87	7.525576923076921	77
Q8BNU0	PF00514	184	223	3.0801	39	G5C5B8	185	224	0.14289999999999994	39
Q8BNU0	PF00514	281	318	17.16281578947369	37	G5C5B8	282	319	15.39042105263158	37
O55038	PF00048	56	87	13.524062499999998	31	G5C1J4	29	62	2.2249411764705878	33
Q6DFW0	PF15019	60	323	5.092727272727275	263	G5BPX3	61	324	4.943867424242425	263
Q8BUR4	PF00018	15	61	1.9819574468085104	46	G5BTH6	1	47	0.0	46
Q8BUR4	PF06920	1113	1608	3.6287822580645175	495	G5BTH6	1163	1658	3.6269334677419343	495
Q8BUR4	PF14429	420	616	7.013355329949238	196	G5BTH6	406	602	7.030588832487309	196
Q8BUR4	PF16172	73	415	3.6420116618075813	342	G5BTH6	59	401	3.628827988338191	342
P08228	PF00080	11	149	0.5955971223021582	138	G5BEA6	12	196	0.921891891891892	184
Q99LB6	PF04321	29	321	4.258904436860068	292	G5B242	30	322	4.299744027303752	292
Q811M1	PF00620	301	449	1.6065570469798656	148	G5AKU6	62	210	2.3083758389261746	148
P62073	PF02953	6	69	0.0	63	G5BLJ2	7	70	0.0	63
Q99MV5	PF13086	746	829	3.3401666666666663	83	G5B2I6	745	828	0.7534047619047618	83
Q99MV5	PF13086	857	927	6.7103943661971845	70	G5B2I6	856	926	3.328788732394367	70
Q99MV5	PF13087	935	1150	9.159490740740738	215	G5B2I6	934	1149	9.152768518518515	215
O35738	PF00096	316	340	0.0	24	G5C633	267	291	0.0	24
O35738	PF00096	346	370	0.0	24	G5C633	267	291	0.0	24
O35738	PF00096	381	398	0.0	17	G5C633	274	291	0.0	17
Q6NV83	PF00076	275	347	2.9445205479452063	72	G5ALG5	276	348	2.9350000000000005	72
Q6NV83	PF01805	428	478	3.292058823529413	50	G5ALG5	429	479	2.950372549019608	50
Q6NV83	PF04818	540	668	2.1755116279069764	128	G5ALG5	541	669	2.1979844961240307	128
Q6NV83	PF08312	837	883	0.0	46	G5ALG5	838	884	0.0	46
Q8CG48	PF02463	1	511	1.484870841487279	510	G5AR32	2	517	4.3396802325581385	515
Q8CG48	PF06470	609	639	21.994967741935486	30	G5AR32	529	559	17.45067741935484	30
Q99J36	PF02926	119	252	13.136089552238808	133	G5BVA0	119	252	13.452701492537315	133
P63154	PF02184	94	124	2.5112903225806447	30	G5CBB9	95	125	2.5156129032258066	30
P63154	PF02184	195	226	3.2503125	31	G5CBB9	196	227	3.2162812500000006	31
Q8K0Z7	PF01709	57	292	4.513411016949154	235	G5BDJ7	58	292	3.7418893617021283	234
Q8VEM9	PF07646	126	173	13.95675	47	G5BNL1	127	174	13.8085625	47
Q8VEM9	PF07646	182	225	0.21059090909090908	43	G5BNL1	183	226	0.21184090909090908	43
Q8VEM9	PF13418	76	116	12.125926829268293	40	G5BNL1	77	117	12.740634146341465	40
Q8VEM9	PF13964	13	61	1.0405714285714287	48	G5BNL1	14	62	1.0414285714285711	48
Q8VEM9	PF13964	238	282	1.4541333333333328	44	G5BNL1	239	283	1.5213333333333323	44
A2ASA8	PF03281	367	486	9.754525	119	G5BMV8	429	548	9.538133333333333	119
Q08639	PF02319	112	192	4.531753086419753	80	G5AVV2	109	189	4.530246913580247	80
Q08639	PF08781	199	337	2.582251798561151	138	G5AVV2	196	334	3.424640287769785	138
P97479	PF00612	768	786	0.08842105263157896	18	G5AW78	840	858	0.08710526315789474	18
P97479	PF00612	814	833	0.0	19	G5AW78	886	905	0.0	19
P97479	PF00612	837	856	28.66179999999999	19	G5AW78	909	928	22.42045	19
P97479	PF00063	66	728	5.983930618401202	662	G5AW78	99	800	5.652933048433051	701
P97479	PF00373	2013	2114	4.382156862745097	101	G5AW78	2052	2153	4.374637254901959	101
P97479	PF00784	1153	1250	8.794142857142857	97	G5AW78	1225	1322	8.748714285714287	97
P97479	PF00784	1793	1894	3.5961666666666665	101	G5AW78	1832	1933	3.595245098039216	101
Q9DBL1	PF00441	279	427	0.21483221476510075	148	G5AKG7	265	413	1.6141342281879183	148
Q9DBL1	PF02770	173	267	10.133389473684211	94	G5AKG7	181	253	8.148534246575341	72
Q9DBL1	PF02771	57	167	6.765153153153149	110	G5AKG7	65	175	5.9484234234234235	110
P47877	PF00086	213	285	0.0	72	G5C2K4	148	220	0.0	72
P47877	PF00219	73	94	0.0	21	G5C2K4	1	22	0.0	21
Q8K212	PF10254	545	955	2.5926909975669115	410	G5BWW9	430	840	2.238931873479319	410
Q9QZS5	PF00069	36	291	6.163269531250003	255	G5BCW8	19	274	6.606039062500002	255
Q9QZS5	PF00433	312	356	1.611333333333333	44	G5BCW8	295	339	1.6518222222222223	44
Q8VIJ6	PF00076	290	354	0.013846153846153843	64	G5C6D8	49	113	0.014538461538461538	64
Q8VIJ6	PF00076	365	424	6.924116666666667	59	G5C6D8	124	183	7.130683333333333	59
Q8VIJ6	PF08075	435	486	0.0	51	G5C6D8	194	245	0.0	51
P16014	PF01271	25	676	0.015611963190184056	651	G5BY77	26	672	0.08533746130030961	646
Q9D842	PF10283	370	395	0.0	25	G5AW05	338	363	0.0	25
Q9D842	PF10283	412	434	0.0	22	G5AW05	338	360	0.0	22
Q9D842	PF17913	32	99	1.7448529411764706	67	G5AW05	1	68	9.157058823529411	67
Q9JLV6	PF08645	164	287	5.088040322580644	123	G5B8R1	172	294	4.4361219512195165	122
Q9JLV6	PF13671	371	397	0.5555185185185186	26	G5B8R1	292	318	2.863851851851852	26
Q9JLV6	PF13671	402	431	0.0	29	G5B8R1	323	351	0.0	28
Q9JLV6	PF17913	10	106	4.612041237113401	96	G5B8R1	11	107	1.3265876288659797	96
P63157	PF00046	178	234	0.0	56	G5AT43	179	235	0.0	56
Q3TGW2	PF12836	34	96	0.3315079365079364	62	G5BAX9	35	97	0.3900158730158728	62
Q3TGW2	PF12836	135	194	1.668216666666667	59	G5BAX9	136	195	3.233483333333332	59
P62996	PF00076	121	189	13.494666666666665	68	G5BT96	122	190	12.937884057971013	68
P51557	PF01852	75	276	4.465123762376236	201	G5B0A4	77	278	4.552396039603957	201
O08842	PF02351	39	112	3.6929594594594586	73	G5B9N9	40	113	3.7359594594594583	73
O08842	PF02351	160	240	0.08045679012345676	80	G5B9N9	223	303	0.08096296296296299	80
O08842	PF02351	250	346	0.3132474226804124	96	G5B9N9	313	409	0.1102783505154639	96
Q8R459	PF00340	37	147	0.4406756756756757	110	G5B415	38	148	2.0293963963963964	110
Q8K2H4	PF00169	266	358	7.593709677419354	92	G5B5B4	267	359	7.475989247311827	92
Q8K2H4	PF01412	407	520	1.5657543859649126	113	G5B5B4	408	521	1.5799561403508782	113
Q8K2H4	PF12796	575	669	0.951115789473684	94	G5B5B4	576	670	0.7653157894736844	94
Q8K2H4	PF16746	4	237	2.7409871794871803	233	G5B5B4	5	238	4.497017094017098	233
Q9DA08	PF07039	157	287	2.1260763358778623	130	G5BRC7	158	288	2.126068702290076	130
Q8BG95	PF12796	63	151	1.7928764044943817	88	G5B383	64	152	1.1086516853932586	88
Q8BG95	PF12796	208	278	0.17921126760563386	70	G5B383	209	278	0.18119999999999994	69
Q8BG95	PF15898	874	975	0.0	101	G5B383	881	988	0.0	107
Q7M6Y3	PF07651	22	282	6.323781609195403	260	G5CAD2	23	283	6.32395019157088	260
Q7TSV9	PF13864	242	337	0.1790729166666667	95	G5C669	260	355	0.17884374999999994	95
Q61211	PF01253	476	552	3.3931428571428586	76	G5BP24	482	558	0.19663636363636364	76
Q61211	PF17832	1	89	5.482483146067415	88	G5BP24	2	90	5.437348314606742	88
Q9DC40	PF10193	512	592	8.758777777777778	80	G5BY74	605	684	10.186212500000002	79
P70122	PF01172	13	100	1.649613636363637	87	G5BIS1	14	101	2.3614090909090897	87
P70122	PF09377	106	223	9.366093220338982	117	G5BIS1	107	224	8.437500000000004	117
P98086	PF00386	115	240	18.272253968253967	125	G5BHZ8	174	300	11.355212598425195	126
P98086	PF01391	61	106	0.0	45	G5BHZ8	120	165	0.0	45
O88879	PF00400	611	641	0.30387096774193545	30	G5BBH4	437	467	0.2361290322580645	30
O88879	PF00400	648	684	0.20308108108108106	36	G5BBH4	474	510	1.5325135135135135	36
O88879	PF00400	688	728	1.6725853658536585	40	G5BBH4	514	554	2.831756097560976	40
O88879	PF00400	734	770	0.0	36	G5BBH4	560	596	0.02837837837837838	36
O88879	PF00400	876	908	0.04566666666666668	32	G5BBH4	702	734	0.04545454545454547	32
O88879	PF00400	1078	1112	0.6020857142857142	34	G5BBH4	904	938	0.0	34
O88879	PF00400	1117	1154	0.4465263157894737	37	G5BBH4	943	980	0.0	37
O88879	PF00400	1175	1203	0.12537931034482758	28	G5BBH4	1001	1029	2.009448275862069	28
O88879	PF00931	175	373	8.058829145728646	198	G5BBH4	1	199	7.661743718592964	198
O88879	PF12894	968	1039	1.1854861111111117	71	G5BBH4	794	865	1.5169861111111107	71
O88879	PF17908	452	586	6.312777777777781	134	G5BBH4	278	412	5.996333333333333	134
Q80VQ1	PF13855	52	93	5.51042857142857	41	G5BKI5	1	42	1.1417380952380949	41
Q80VQ1	PF13855	197	254	11.261482758620687	57	G5BKI5	146	203	0.04318965517241381	57
Q80VQ1	PF13855	266	323	0.0	57	G5BKI5	215	272	0.0	57
Q8C0W1	PF01753	844	884	0.09751219512195122	40	G5BGX3	902	942	0.09570731707317072	40
Q8C0W1	PF02493	15	36	0.0	21	G5BGX3	71	92	0.21445454545454548	21
Q8C0W1	PF02493	60	81	0.4290909090909091	21	G5BGX3	116	137	0.0	21
Q8C0W1	PF12796	622	688	0.6680895522388058	66	G5BGX3	679	745	0.08335820895522388	66
Q8C0W1	PF13637	283	319	6.332648648648648	36	G5BGX3	340	376	12.240945945945946	36
Q99LL5	PF00400	251	283	3.6435454545454538	32	G5BPD9	229	261	3.3206969696969697	32
Q99LL5	PF00400	288	326	0.31205128205128196	38	G5BPD9	266	304	0.3238974358974359	38
Q99LL5	PF00400	374	412	6.922384615384615	38	G5BPD9	352	390	6.229076923076924	38
Q5FWH2	PF00642	285	309	0.5377200000000001	24	G5BXT1	311	335	1.2474000000000005	24
Q5FWH2	PF13920	683	721	0.0	38	G5BXT1	712	750	0.0	38
Q5FWH2	PF18384	24	60	0.12675675675675674	36	G5BXT1	50	85	0.061666666666666675	35
Q6NSQ7	PF04180	14	439	1.1797605633802808	425	G5BL60	24	456	1.7989538106235563	432
Q9JKU8	PF00046	195	251	6.070105263157894	56	G5AQ28	196	252	6.07598245614035	56
Q9JKU8	PF00412	34	88	0.04439999999999999	54	G5AQ28	35	89	0.1147636363636364	54
Q9JKU8	PF00412	93	150	0.6845172413793105	57	G5AQ28	94	151	0.686051724137931	57
Q9D799	PF00551	112	214	5.056330097087378	102	G5AN67	122	224	4.871203883495147	102
Q9D799	PF02911	239	343	0.9134000000000004	104	G5AN67	249	353	0.9991333333333338	104
Q8BHT6	PF02434	110	197	5.692590909090911	87	G5B2P0	21	108	4.126284090909089	87
Q8BHT6	PF02434	254	457	6.378789215686276	203	G5B2P0	165	368	6.291436274509804	203
Q3U962	PF00093	39	94	0.0	55	G5BZG6	41	96	0.0	55
Q3U962	PF01391	123	181	0.08379661016949153	58	G5BZG6	126	184	0.041864406779661016	58
Q3U962	PF01391	213	268	0.0	55	G5BZG6	330	390	0.0	60
Q3U962	PF01391	810	868	0.0547457627118644	58	G5BZG6	813	871	0.0547457627118644	58
Q3U962	PF01391	918	974	0.0	56	G5BZG6	921	977	0.0	56
Q3U962	PF01391	1110	1168	0.0	58	G5BZG6	1113	1171	0.0	58
Q3U962	PF01391	1168	1224	0.0	56	G5BZG6	1171	1227	0.0	56
Q3U962	PF01410	1264	1495	0.6410172413793105	231	G5BZG6	1267	1498	0.6678750000000001	231
Q9ERE7	PF10185	42	193	6.664032894736848	151	G5BEZ0	48	199	6.659138157894738	151
O89098	PF00031	37	119	0.6215301204819277	82	G5BJV8	37	119	1.8265542168674695	82
Q99MZ6	PF00063	66	747	4.894217008797655	681	G5B9V5	61	743	6.406600292825778	682
Q99MZ6	PF00373	1906	2008	0.1145242718446602	102	G5B9V5	1908	2010	0.512009708737864	102
Q99MZ6	PF00612	765	782	0.0	17	G5B9V5	761	778	0.0	17
Q99MZ6	PF00612	786	806	0.10747619047619048	20	G5B9V5	782	802	1.8744761904761904	20
Q99MZ6	PF00612	833	851	0.0	18	G5B9V5	829	847	0.0	18
Q99MZ6	PF00612	855	874	18.53085	19	G5B9V5	851	870	18.8106	19
Q99MZ6	PF00784	1089	1186	14.275693877551017	97	G5B9V5	1089	1186	16.704244897959178	97
Q99MZ6	PF00784	1687	1787	6.530970297029703	100	G5B9V5	1689	1789	5.552217821782176	100
P28063	PF00227	68	249	2.728093406593405	181	G5BB09	20	201	3.273478021978023	181
O08539	PF03114	27	263	0.7974683544303797	236	G5BGN8	15	251	0.7950464135021097	236
O08539	PF14604	521	584	2.6420156250000004	63	G5BGN8	516	579	2.63328125	63
Q9QXK3	PF01602	53	537	8.189921649484535	484	G5BH71	27	511	8.16114226804124	484
Q9QXK3	PF08752	610	755	1.280061643835617	145	G5BH71	584	729	1.731643835616438	145
Q9QXK3	PF16381	757	869	6.49221238938053	112	G5BH71	731	843	6.470486725663718	112
Q8C006	PF00622	355	475	1.757892561983471	120	G5BY95	400	516	2.059897435897436	116
Q8C006	PF00643	97	136	1.3802500000000006	39	G5BY95	99	138	1.0651000000000002	39
Q8C006	PF13765	304	350	0.07702127659574469	46	G5BY95	349	395	0.038297872340425525	46
Q8C006	PF13920	17	61	0.3386	44	G5BY95	19	62	0.7382500000000001	43
Q9QWH1	PF00536	784	847	4.520328125	63	G5B5L0	791	854	4.5194375	63
Q9QWH1	PF16616	661	780	0.3125333333333334	119	G5B5L0	668	787	0.2631	119
Q8BW56	PF00534	276	389	4.336526315789474	113	G5BFA6	383	496	5.3844122807017545	113
Q8BW56	PF12038	2	166	4.634763636363639	164	G5BFA6	57	262	6.958126213592231	205
Q69ZU8	PF12796	139	202	1.6012187499999997	63	G5C8Z9	140	203	3.4829531250000003	63
Q69ZU8	PF12796	204	259	8.630392857142855	55	G5C8Z9	205	260	8.601624999999999	55
Q69ZU8	PF13637	85	127	8.527883720930234	42	G5C8Z9	86	128	6.466953488372092	42
Q69ZU8	PF13857	38	81	8.442	43	G5C8Z9	39	82	8.444159090909093	43
Q8BMC3	PF00017	477	548	0.27966666666666673	71	G5B3R9	374	445	0.2807638888888887	71
Q8BMC3	PF00640	133	284	3.3380065789473665	151	G5B3R9	43	194	3.2038552631578963	151
Q8K3U4	PF13841	23	52	8.722199999999999	29	G5C6L1	24	53	19.816133333333333	29
Q04886	PF00505	102	166	4.7611384615384615	64	G5BXU3	1	65	3.8783230769230763	64
Q9D8X2	PF06244	96	207	1.9508214285714285	111	G5B4E0	98	191	0.5281170212765958	93
Q8BM13	PF02191	191	436	10.115138211382117	245	G5B357	130	375	10.47780081300813	245
Q8BM13	PF12308	62	114	0.0	52	G5B357	1	53	0.0	52
Q91Z69	PF00018	725	770	0.7202826086956521	45	G5ALG1	734	779	0.8912173913043481	45
Q91Z69	PF00611	31	115	6.34914117647059	84	G5ALG1	17	101	6.3485176470588245	84
Q91Z69	PF00620	496	644	5.1816442953020125	148	G5ALG1	505	653	5.179718120805369	148
Q3UZP4	PF15811	18	72	0.0	54	G5AR31	1	55	0.0	54
Q922K7	PF01189	361	569	2.7350909090909092	208	G5CAP9	381	589	3.0956507177033483	208
Q922K7	PF17125	275	358	2.5655714285714284	83	G5CAP9	295	378	2.9338928571428573	83
Q6IR42	PF00855	305	400	3.541885416666668	95	G5AN28	276	373	7.552346938775508	97
Q6IR42	PF07496	246	291	4.192826086956522	45	G5AN28	217	262	2.262326086956522	45
Q61532	PF00069	19	315	2.6365622895622867	296	G5C9D4	20	316	2.7350538720538724	296
Q8BG79	PF04676	787	881	0.05485263157894734	94	G5BA72	672	766	0.0424842105263158	94
Q8BG79	PF04677	656	778	3.7708536585365846	122	G5BA72	541	663	3.6762682926829258	122
Q6NXW6	PF03215	209	242	0.17205882352941174	33	G5C0I4	1	33	0.20063636363636367	32
Q8VDP4	PF14443	339	454	3.2688706896551736	115	G5B9R0	340	454	3.2561565217391304	114
Q8VDP4	PF14444	54	111	20.36179310344828	57	G5B9R0	55	112	20.351206896551727	57
P43081	PF13499	88	159	7.578347222222222	71	G5BNJ5	209	280	7.615791666666671	71
P43081	PF13833	29	79	9.077745098039218	50	G5BNJ5	150	200	10.948529411764708	50
Q8K2D6	PF00383	13	127	10.993095652173913	114	G5CB36	16	130	11.37493913043478	114
Q8BX57	PF00069	197	350	0.8137402597402598	153	G5BUK8	164	317	2.8667272727272732	153
Q8BX57	PF00787	44	120	1.9518051948051949	76	G5BUK8	11	87	1.1893376623376624	76
Q8BX57	PF02205	549	576	0.09792857142857143	27	G5BUK8	510	537	0.09814285714285716	27
Q00519	PF00111	11	70	12.65555	59	G5B3Z0	10	79	3.860371428571428	69
Q00519	PF00941	235	412	3.2785730337078665	177	G5B3Z0	228	405	0.4242022471910112	177
Q00519	PF01315	589	695	7.406897196261682	106	G5B3Z0	582	688	7.525953271028037	106
Q00519	PF01799	90	160	5.728042253521128	70	G5B3Z0	83	153	5.423647887323943	70
Q00519	PF02738	706	1238	1.9884015009380869	532	G5B3Z0	699	1276	1.8045640138408308	577
Q00519	PF03450	420	524	5.139542857142857	104	G5B3Z0	413	517	5.186685714285715	104
Q9QZF2	PF01153	55	539	0.8432391752577322	484	G5BGX2	203	687	0.819280412371134	484
P79621	PF05729	439	608	6.3106529411764685	169	G5BWF4	521	690	5.302917647058823	169
P79621	PF13516	1018	1032	0.0	14	G5BWF4	1101	1115	0.0	14
P79621	PF13516	1041	1060	0.0	19	G5BWF4	1124	1143	0.0	19
P79621	PF13516	1076	1089	0.0	13	G5BWF4	1159	1172	0.0	13
P59325	PF01873	7	126	3.9243416666666655	119	G5AWG9	8	127	3.9221083333333344	119
P59325	PF02020	308	387	0.59465	79	G5AWG9	303	382	0.5931875	79
Q9R0L6	PF15717	1368	1998	0.5707654516640251	630	G5AP75	1388	2019	0.6991756329113925	631
Q921M4	PF15070	380	695	0.09773734177215193	315	G5ASF3	400	703	0.03152631578947368	303
Q921M4	PF19046	952	994	0.33051162790697675	42	G5ASF3	983	1025	0.1296511627906977	42
Q8K1L5	PF07491	36	76	0.0	40	G5AKF1	32	71	0.0	39
Q8K2W6	PF00628	230	274	2.110666666666666	44	G5C557	284	328	1.5735555555555554	44
Q9DAU1	PF11938	47	196	0.2856733333333332	149	G5BNK6	46	195	0.3402399999999999	149
Q9D5R4	PF15743	278	427	3.3973133333333334	149	G5C927	281	430	3.493060402684564	149
Q99MU3	PF00035	456	521	3.5053333333333336	65	G5BDD4	209	274	2.928636363636364	65
Q99MU3	PF00035	567	632	1.5063333333333333	65	G5BDD4	320	385	1.5074090909090911	65
Q99MU3	PF00035	677	740	0.08281249999999997	63	G5BDD4	432	495	0.08651562500000001	63
Q99MU3	PF02137	834	1163	1.2261212121212128	329	G5BDD4	589	918	1.07000303030303	329
Q99MU3	PF02295	157	200	1.1715909090909091	43	G5BDD4	18	61	1.927909090909091	43
Q99MU3	PF02295	248	310	8.968111111111106	62	G5BDD4	1	63	1.5718095238095238	62
A6H684	PF04666	45	239	10.039830769230774	194	G5B380	22	216	8.538789743589739	194
Q9R111	PF01979	73	446	1.3984064171123	373	G5ASH7	69	442	1.9981925133689835	373
Q80TT2	PF00168	159	261	0.03152427184466019	102	G5BXT4	167	269	0.03098058252427185	102
Q80TT2	PF00168	972	1070	6.453282828282827	98	G5BXT4	990	1088	6.435161616161615	98
Q921I9	PF01138	20	151	4.501969696969693	131	G5C5U1	21	163	10.757356643356646	142
Q921I9	PF03725	155	218	1.2084843749999996	63	G5C5U1	167	230	1.1442031249999995	63
Q8CH09	PF01585	996	1038	0.0	42	G5C5B7	1025	1072	1.4139791666666666	47
Q8CH09	PF01805	769	818	0.1527	49	G5C5B7	785	834	0.1557	49
Q80ZU7	PF01273	35	204	2.5172823529411765	169	G5BPV8	35	204	5.2945235294117685	169
Q80ZU7	PF02886	270	466	6.341228426395938	196	G5BPV8	270	465	7.135739795918371	195
Q812A3	PF12796	118	207	1.4001444444444444	89	G5BMU8	117	206	1.4101777777777782	89
Q812A3	PF12796	213	273	4.619901639344262	60	G5BMU8	212	281	3.8983857142857152	69
E9Q9W7	PF00595	86	160	1.9724933333333328	74	G5CAF2	87	161	1.9872266666666671	74
E9Q9W7	PF00595	221	287	6.082925373134327	66	G5CAF2	222	288	3.1855074626865685	66
E9Q9W7	PF00595	867	929	0.1067301587301587	62	G5CAF2	97	156	2.482033333333334	59
Q8R326	PF00076	82	146	0.07946153846153843	64	G5BKW4	24	88	0.08107692307692309	64
Q8R326	PF00076	156	214	7.194847457627117	58	G5BKW4	98	156	7.1981016949152545	58
Q8R326	PF08075	227	278	0.0	51	G5BKW4	169	218	0.0	49
Q8VC98	PF00169	54	151	8.320785714285714	97	G5BAH1	55	152	8.292173469387757	97
Q3UA06	PF00004	174	319	9.28678082191781	145	G5BPH7	170	315	9.309328767123292	145
Q9CSH3	PF00773	466	792	3.856033639143732	326	G5C9E4	490	821	7.54483734939759	331
Q9CSH3	PF13638	67	192	10.123880952380953	125	G5C9E4	68	214	14.616503401360545	146
Q9CSH3	PF17215	846	918	14.049438356164382	72	G5C9E4	875	947	14.034616438356164	72
Q9CSH3	PF17216	226	318	0.6083763440860215	92	G5C9E4	248	342	1.7638210526315794	94
Q9CSH3	PF17849	371	437	6.808000000000002	66	G5C9E4	395	461	6.808074626865673	66
A2AKY4	PF12171	56	83	0.0	27	G5BIN3	57	84	0.0	27
Q80U30	PF09758	50	197	22.14101351351353	147	G5BWF2	51	198	22.127432432432432	147
O88708	PF13191	34	186	6.770535947712416	152	G5B7T9	36	189	8.2365974025974	153
O88708	PF14629	225	410	4.819892473118276	185	G5B7T9	228	413	3.4559301075268807	185
P70398	PF00443	1556	1952	3.3662040302267	396	G5B9K1	1612	1950	3.9258643067846615	338
P70398	PF12030	2097	2474	8.845576719576716	377	G5B9K1	2095	2473	7.976907651715036	378
Q8BZG5	PF13679	132	291	3.4884937500000013	159	G5AR79	133	291	0.6326037735849057	158
B2RUR8	PF01754	797	820	0.0	23	G5BH27	800	822	0.0	22
B2RUR8	PF02338	188	358	6.800871345029244	170	G5BH27	189	359	6.682766081871343	170
Q9EQU3	PF13855	272	317	1.1942391304347826	45	G5AXM8	601	646	0.0	45
Q9EQU3	PF13855	510	555	0.01708695652173913	45	G5AXM8	837	882	0.06232608695652174	45
Q9EQU3	PF18837	392	421	1.264033333333334	29	G5AXM8	721	750	0.3307	29
Q9EQU3	PF01582	871	1020	10.48235333333334	149	G5AXM8	1196	1345	10.62977333333333	149
O89026	PF00041	522	606	7.563811764705881	84	G5BX26	534	618	7.564176470588236	84
O89026	PF00041	647	710	0.10203124999999998	63	G5BX26	659	722	0.10159375	63
O89026	PF00041	738	823	6.440069767441861	85	G5BX26	752	837	4.4526162790697645	85
O89026	PF07679	132	217	1.4149302325581394	85	G5BX26	144	229	1.4153372093023258	85
O89026	PF07679	222	307	0.3471046511627909	85	G5BX26	234	319	0.3472209302325581	85
O89026	PF13927	27	111	6.624258823529412	84	G5BX26	39	123	6.663541176470589	84
O89026	PF13927	310	392	2.2637108433734943	82	G5BX26	322	404	2.294228915662651	82
O89026	PF13927	414	488	3.0933200000000007	74	G5BX26	426	500	3.2193733333333325	74
Q91Z96	PF00069	77	306	6.583943478260868	229	G5C319	1	230	7.024108695652172	229
Q91Z96	PF15282	872	1137	0.09666165413533837	265	G5C319	822	1090	0.0935858208955224	268
Q91YN5	PF01704	45	447	8.231210918114138	402	G5BU49	46	448	10.834560794044666	402
Q69ZK0	PF00610	422	488	6.401283582089554	66	G5BNS3	148	214	6.404507462686567	66
Q69ZK0	PF00610	523	588	0.5357878787878788	65	G5BNS3	249	314	0.5357575757575758	65
P61364	PF11037	0	129	7.445346153846152	129	G5BGV1	1	131	6.768846153846152	130
Q8K2X3	PF01336	63	157	3.094747368421052	94	G5CAJ9	56	146	3.9493296703296688	90
Q8K2X3	PF09170	166	342	2.30480790960452	176	G5CAJ9	156	332	1.4480790960451977	176
Q9CPT4	PF10572	32	160	3.636224806201552	128	G5C0R7	40	167	8.264499999999998	127
Q9DBN5	PF00004	370	507	6.20018115942029	137	G5BT79	330	467	5.691347826086957	137
Q9DBN5	PF02190	12	202	7.075314136125652	190	G5BT79	13	202	7.64537894736842	189
Q9DBN5	PF05362	628	834	5.419357487922706	206	G5BT79	588	794	5.343077294685995	206
Q8BXT1	PF00615	55	121	0.21664179104477616	66	G5BE42	54	119	0.22033333333333333	65
Q3UES3	PF00023	212	241	5.302533333333334	29	G5BV11	213	242	5.3332000000000015	29
Q3UES3	PF00644	962	1155	4.274030927835054	193	G5BV11	963	1156	4.720443298969075	193
Q3UES3	PF07647	876	932	1.2501052631578948	56	G5BV11	877	933	1.1134210526315789	56
Q3UES3	PF12796	27	120	1.8056382978723409	93	G5BV11	28	121	1.8056382978723409	93
Q3UES3	PF12796	246	304	1.0574406779661016	58	G5BV11	247	305	0.3832542372881357	58
Q3UES3	PF12796	367	460	0.6428297872340426	93	G5BV11	368	461	0.6603829787234045	93
Q3UES3	PF12796	472	555	0.12892857142857142	83	G5BV11	473	556	0.12892857142857142	83
Q3UES3	PF12796	558	621	0.9728750000000004	63	G5BV11	559	622	0.9728593750000004	63
Q3UES3	PF13637	124	163	12.777275	39	G5BV11	125	164	12.777225	39
Q3UES3	PF13637	678	731	9.24022222222222	53	G5BV11	679	732	9.27459259259259	53
Q3UES3	PF13857	737	783	4.686382978723403	46	G5BV11	738	784	4.682978723404255	46
Q0GGX2	PF00096	141	161	0.0	20	G5AV16	143	163	0.0	20
Q0GGX2	PF01448	1064	1119	4.481660714285715	55	G5AV16	968	1023	1.196071428571429	55
Q0GGX2	PF13912	167	191	0.0	24	G5AV16	169	193	0.0	24
Q0GGX2	PF13912	1299	1323	0.024600000000000004	24	G5AV16	1203	1227	0.0244	24
P97946	PF00341	115	195	0.04666666666666666	80	G5C237	111	191	0.6286419753086419	80
P97946	PF03128	266	277	0.0	11	G5C237	262	273	0.0	11
Q9QWL7	PF00038	83	387	1.9549999999999987	304	G5B0M4	78	381	1.445546052631579	303
Q69ZS7	PF00009	256	473	11.079316513761471	217	G5C6A8	258	450	12.159347150259066	192
Q69ZS7	PF03143	571	679	5.585816513761469	108	G5C6A8	548	656	5.719256880733947	108
Q69ZS7	PF08938	54	119	5.477909090909091	65	G5C6A8	59	123	4.686184615384615	64
Q8BXL7	PF00025	9	184	7.919471590909091	175	G5C8C2	10	185	8.09394886363637	175
P97351	PF01015	16	220	0.18742926829268292	204	G5C1K3	17	221	0.18742926829268292	204
P12660	PF02188	7	28	2.5679090909090907	21	G5B7I0	10	31	1.6684090909090907	21
P12660	PF02188	47	67	0.0	20	G5B7I0	50	70	0.025285714285714283	20
Q99NG0	PF00176	289	595	2.8781986970684037	306	G5BZU2	245	551	2.8756547231270373	306
Q99NG0	PF00271	725	852	10.653421875000006	127	G5BZU2	681	808	8.624421875000005	127
Q5GAM8	PF00074	26	139	4.6385701754385975	113	G5B5R3	27	140	2.0165	113
P59759	PF02037	383	415	0.0	32	G5B4F2	388	420	0.0	32
P59759	PF02755	85	107	0.0	22	G5B4F2	86	108	0.0	22
P59759	PF02755	129	150	0.0	21	G5B4F2	130	151	0.0	21
Q8CI19	PF00341	249	336	0.11068181818181816	87	G5BLW0	211	298	0.1099431818181818	87
Q8CI19	PF00431	53	159	6.9231401869158855	106	G5BLW0	15	121	7.654757009345797	106
Q9CXT8	PF00675	152	213	0.0	61	G5BI52	97	158	0.0	61
Q9CXT8	PF05193	219	403	5.170043243243244	184	G5BI52	164	348	4.5099027027027025	184
Q5BKP2	PF00443	333	649	2.406886435331231	316	G5BX62	271	587	2.407719242902207	316
Q5BKP2	PF00627	650	687	14.29221052631579	37	G5BX62	588	625	16.684605263157895	37
Q5BKP2	PF00627	723	758	15.742305555555555	35	G5BX62	664	699	15.724611111111116	35
Q5BKP2	PF02148	208	280	0.10064383561643833	72	G5BX62	146	218	0.09773972602739726	72
Q5BKP2	PF17807	63	93	14.18583870967742	30	G5BX62	1	31	3.074935483870968	30
P28867	PF00130	158	208	12.61447058823529	50	G5BUN9	159	209	12.5981568627451	50
P28867	PF00130	230	281	3.289557692307694	51	G5BUN9	231	282	3.5976346153846164	51
P28867	PF00069	347	600	6.5266732283464615	253	G5BUN9	349	623	9.139738181818176	274
P28867	PF00433	621	662	0.11895238095238095	41	G5BUN9	644	685	5.128571428571427	41
Q04690	PF00616	1330	1452	0.5339024390243902	122	G5B511	1343	1444	1.26478431372549	101
Q04690	PF13716	1603	1735	15.15255639097744	132	G5B511	1595	1727	15.151060150375939	132
P70196	PF02176	203	260	2.366620689655172	57	G5B132	206	263	0.1597413793103448	57
P70196	PF13923	68	106	2.7160769230769226	38	G5B132	71	109	2.701743589743589	38
P70196	PF18048	156	182	0.15037037037037038	26	G5B132	159	185	0.16951851851851849	26
Q6PDI5	PF13001	215	516	4.804417218543045	301	G5B5V6	1	302	5.019062913907286	301
Q9CR62	PF00153	22	106	11.246741176470584	84	G5BW99	23	107	11.248494117647061	84
Q9CR62	PF00153	117	210	0.9110744680851064	93	G5BW99	118	211	0.8948404255319148	93
Q9CR62	PF00153	217	307	12.097945054945052	90	G5BW99	218	308	13.113043956043954	90
Q8BX80	PF03644	126	402	9.037509025270758	276	G5AVF9	127	403	8.177588447653426	276
Q3U269	PF00581	293	387	0.14611578947368425	94	G5C1C7	294	388	0.11926315789473685	94
Q3U269	PF12368	395	458	2.474140625000001	63	G5C1C7	396	459	0.2981718750000001	63
Q3U269	PF17773	167	261	8.165705263157893	94	G5C1C7	168	262	7.780884210526316	94
Q9D700	PF00782	68	201	7.149238805970148	133	G5B9U1	69	202	6.849791044776121	133
Q8CG03	PF00233	601	835	6.381331914893622	234	G5B6A8	365	599	7.211731914893616	234
Q8CG03	PF01590	237	290	0.8647407407407407	53	G5B6A8	1	54	0.8617962962962963	53
Q8CG03	PF01590	335	490	9.12441025641026	155	G5B6A8	99	254	9.291544871794873	155
Q2TPA8	PF00106	11	197	2.93185026737968	186	G5BWR7	12	198	2.1832406417112296	186
Q2TPA8	PF02036	389	482	0.8295957446808514	93	G5BWR7	318	411	0.1721808510638298	93
O88351	PF00069	15	289	2.627752727272729	274	G5BT56	16	290	2.6883527272727283	274
O88351	PF12179	705	741	0.030405405405405407	36	G5BT56	706	742	0.07297297297297298	36
O88351	PF18397	388	662	1.9912472727272756	274	G5BT56	389	663	1.762432727272727	274
Q80YS6	PF00169	158	245	6.577522727272728	87	G5B302	159	246	6.488670454545454	87
Q80YS6	PF00169	358	433	2.0520921052631578	75	G5B302	356	431	3.1709342105263154	75
Q9CR58	PF00153	5	96	0.788641304347826	91	G5C906	6	96	0.7950989010989011	90
Q9CR58	PF00153	103	190	17.97113636363636	87	G5C906	104	191	18.744136363636372	87
Q9CR58	PF00153	198	288	12.512890109890108	90	G5C906	199	289	12.771615384615385	90
P56399	PF00443	325	654	3.2112212121212127	329	G5CAR4	326	655	3.210048484848484	329
P56399	PF00627	655	690	6.951361111111112	35	G5CAR4	656	691	6.952805555555559	35
P56399	PF00627	724	758	6.546285714285713	34	G5CAR4	725	759	8.062257142857142	34
P56399	PF02148	198	270	0.04558904109589041	72	G5CAR4	199	271	0.045506849315068494	72
P56399	PF17807	15	77	3.8871428571428566	62	G5CAR4	16	78	3.8843015873015867	62
Q8C2B3	PF00850	527	845	5.309401253918494	318	G5BWD2	484	808	4.912950769230768	324
Q9D706	PF00515	133	166	0.0	33	G5BWC8	133	166	0.0	33
Q9D706	PF00515	202	234	0.0	32	G5BWC8	202	234	0.0	32
Q9D706	PF13176	289	316	0.0255	27	G5BWC8	287	314	0.020714285714285716	27
Q9D706	PF13877	540	630	2.9949560439560434	90	G5BWC8	511	601	2.1449560439560447	90
P51656	PF00106	4	195	3.831973958333335	191	G5B0J6	8	199	3.5304322916666666	191
Q80W14	PF00397	97	122	1.0332307692307692	25	G5AU15	92	117	1.0235384615384615	25
Q80W14	PF00397	136	163	0.0	27	G5AU15	131	158	0.0	27
Q80W14	PF01846	277	326	0.0	49	G5AU15	351	400	0.0	49
Q80W14	PF01846	498	546	0.6777755102040816	48	G5AU15	584	632	3.1486530612244907	48
Q9D787	PF00160	280	431	6.631598684210526	151	G5BKG3	280	445	4.51239156626506	165
Q9JHQ0	PF00191	45	109	7.603676923076922	64	G5AJY3	46	110	10.029153846153848	64
Q9JHQ0	PF00191	117	181	4.958615384615385	64	G5AJY3	118	182	5.804384615384616	64
Q9JHQ0	PF00191	217	263	14.112595744680851	46	G5AJY3	213	259	10.310148936170213	46
Q9JHQ0	PF00191	273	338	0.7914545454545455	65	G5AJY3	269	334	0.34837878787878784	65
Q80TZ9	PF00320	506	540	0.20368571428571425	34	G5C547	507	541	0.2038	34
Q80TZ9	PF01426	103	280	3.4740617977528085	177	G5C547	104	281	3.4745730337078653	177
Q80TZ9	PF01448	285	335	5.1815686274509805	50	G5C547	286	336	5.243019607843137	50
Q80TZ9	PF03154	567	1556	0.0010151515151515154	989	G5C547	568	1538	0.010698249227600414	970
O09051	PF02058	21	105	0.038470588235294124	84	G5AQJ2	30	114	0.03366666666666667	84
Q9D0K2	PF01144	45	270	1.9747787610619447	225	G5C4R0	68	293	2.0906769911504424	225
Q9D0K2	PF01144	302	499	1.9212777777777788	197	G5C4R0	325	522	2.40029797979798	197
Q8K0C5	PF01419	68	157	3.165666666666666	89	G5BYM4	69	158	3.6162777777777784	89
Q9QZD4	PF02732	686	814	0.7336201550387597	128	G5B4F4	647	775	0.7297596899224807	128
Q3TQF0	PF12937	53	97	0.0	44	G5BF20	57	101	0.0	44
Q8VDW4	PF00179	6	139	4.099694029850748	133	G5B5T4	2	135	4.083544776119404	133
Q8R323	PF13177	18	184	4.426059880239524	166	G5BB53	19	185	4.439419161676646	166
Q91YM4	PF06743	367	435	18.41213043478261	68	G5BIL8	369	435	22.527044776119407	66
Q91YM4	PF08368	450	534	0.4940235294117646	84	G5BIL8	451	533	0.6334457831325301	82
Q91YM4	PF08373	567	618	16.80623076923077	51	G5BIL8	566	617	4.080980769230768	51
Q9D4V7	PF08477	14	126	8.819929203539829	112	G5AU88	1	113	8.870778761061946	112
Q3U2I3	PF10257	96	425	8.634954545454532	329	G5BBR6	97	426	8.738115151515151	329
Q6R653	PF00531	413	490	0.0939102564102564	77	G5BNG6	414	491	0.1796666666666667	77
Q6R653	PF00791	107	188	7.715536585365854	81	G5BNG6	108	188	7.779049382716049	80
Q6R653	PF17217	242	345	0.6238557692307694	103	G5BNG6	243	346	2.3886923076923074	103
A2AKB9	PF00400	208	244	0.5225135135135135	36	G5C1D4	55	91	0.5263783783783783	36
A2AKB9	PF00400	252	287	1.7723055555555554	35	G5C1D4	99	134	1.7851944444444443	35
P16110	PF00337	131	259	3.361077519379845	128	G5BF76	65	193	4.861674418604654	128
Q923S9	PF00071	10	167	7.966474683544303	157	G5APK0	11	168	7.432474683544303	157
Q924W7	PF02141	788	969	13.114857142857135	181	G5BUW5	792	973	13.119076923076925	181
Q924W7	PF03455	1051	1099	1.5135714285714283	48	G5BUW5	1055	1103	1.5152244897959182	48
Q924W7	PF03456	712	778	0.675955223880597	66	G5BUW5	716	782	0.6767462686567165	66
Q8BKC5	PF02985	906	934	0.5986896551724139	28	G5C350	904	932	0.7813793103448274	28
Q8BKC5	PF13646	362	465	12.836086538461537	103	G5C350	378	451	15.503459459459464	73
Q8BKC5	PF18808	268	356	2.608078651685393	88	G5C350	284	372	2.6156516853932583	88
Q8BKC5	PF18816	1004	1051	10.103958333333333	47	G5C350	1002	1049	10.101104166666667	47
Q8BKC5	PF18829	764	871	7.014564814814813	107	G5C350	762	869	7.010361111111113	107
Q61207	PF03489	105	137	0.06809090909090909	32	G5C2I8	106	138	0.1596666666666667	32
Q61207	PF03489	237	272	8.166527777777778	35	G5C2I8	284	316	6.65239393939394	32
Q61207	PF03489	358	389	1.39975	31	G5C2I8	402	433	1.4493125	31
Q61207	PF03489	481	514	0.0	33	G5C2I8	507	540	0.0	33
Q61207	PF05184	61	95	0.038285714285714284	34	G5C2I8	62	96	1.3801428571428571	34
Q61207	PF05184	316	351	0.6282777777777776	35	G5C2I8	360	395	12.28191666666666	35
Q61207	PF05184	440	476	12.332459459459459	36	G5C2I8	466	502	1.3398648648648646	36
Q61207	PF02199	22	53	0.0578125	31	G5C2I8	23	54	0.0	31
Q61207	PF02199	525	556	0.0	31	G5C2I8	551	582	0.0	31
P52840	PF00685	33	282	5.661595999999999	249	G5BRC6	38	287	5.452932000000002	249
Q9DBM2	PF00378	8	196	4.237164021164019	188	G5BTB0	9	189	1.8093480662983448	180
Q9DBM2	PF00725	472	576	0.4070380952380953	104	G5BTB0	469	573	1.7186952380952378	104
Q9DBM2	PF00725	613	704	1.4498478260869565	91	G5BTB0	610	701	4.105532608695653	91
Q9DBM2	PF02737	297	469	2.3853121387283243	172	G5BTB0	290	466	3.175322033898306	176
Q8K0T7	PF00130	1093	1142	3.5964199999999997	49	G5B2P5	22	71	3.6022799999999995	49
Q8K0T7	PF00168	1216	1324	5.839321100917433	108	G5B2P5	145	253	5.840045871559637	108
Q8K0T7	PF00168	2057	2166	6.2667454545454575	109	G5B2P5	985	1094	5.7426272727272725	109
Q8K0T7	PF06292	1536	1641	10.536122641509431	105	G5B2P5	465	570	12.962575471698113	105
Q8K0T7	PF10540	1883	2022	8.948150000000004	139	G5B2P5	811	950	4.299457142857143	139
Q3V1D5	PF01734	16	179	5.2137378048780505	163	G5BEW0	17	185	5.295958579881659	168
Q924C1	PF08389	109	270	8.548197530864199	161	G5BNM9	121	282	9.303790123456787	161
Q9D646	PF00038	54	364	0.6722122186495175	310	G5B0N5	87	397	0.09508038585209004	310
Q80SX8	PF05970	214	512	3.1399197324414714	298	G5AN76	21	319	3.7827090301003343	298
Q91XE9	PF00170	236	298	0.010555555555555556	62	G5BZB3	229	291	0.007936507936507936	62
Q8R2N2	PF00400	96	127	0.25965625000000003	31	G5AK50	97	128	1.57740625	31
Q8R2N2	PF00400	471	505	1.7960285714285706	34	G5AK50	472	506	1.7958857142857136	34
Q9JKK7	PF03250	4	145	2.403338028169013	141	G5C9D7	5	146	0.9938943661971832	141
Q8BPG6	PF03781	37	297	0.5646743295019159	260	G5ASS4	30	291	1.2935343511450383	261
Q9ERH7	PF00069	438	524	0.7204482758620686	86	G5B1G1	1	87	1.2541264367816094	86
P18826	PF00723	7	922	6.4979475982532815	915	G5AM89	8	922	7.304236065573773	914
Q7TSY6	PF00076	55	122	2.2741911764705884	67	G5BZ33	221	288	2.290308823529412	67
Q7TSY6	PF00076	153	216	0.4152656249999999	63	G5BZ33	319	382	0.36234375	63
Q7TSY6	PF00076	443	471	1.705413793103448	28	G5BZ33	629	657	3.8014827586206903	28
A0A140LI88	PF00023	542	563	0.0	21	G5AVZ5	545	565	0.04114285714285715	20
A0A140LI88	PF12796	465	536	0.1445972222222222	71	G5AVZ5	468	538	0.3500704225352113	70
A0A140LI88	PF12796	1166	1258	0.2672150537634409	92	G5AVZ5	1148	1239	0.3943586956521739	91
Q9WUZ7	PF04908	0	97	6.5937142857142845	97	G5AM08	1	98	6.6020816326530625	97
Q3TJ91	PF08366	271	371	6.80888118811881	100	G5BNB1	272	372	7.281366336633662	100
Q8K2J0	PF00168	656	759	6.9053942307692315	103	G5BJ13	656	764	1.9081009174311925	108
Q8K2J0	PF00387	523	636	2.23792105263158	113	G5BJ13	521	635	2.1982608695652166	114
Q8K2J0	PF00388	334	478	1.3055448275862067	144	G5BJ13	329	473	0.9256482758620688	144
Q8K2J0	PF14788	196	245	0.0	49	G5BJ13	191	240	2.2105	49
Q80UJ9	PF00856	150	262	4.929300884955749	112	G5BA09	137	249	4.895902654867256	112
Q80UJ9	PF05033	31	131	0.0	100	G5BA09	20	118	0.0	98
Q91YR5	PF01564	499	612	6.857938596491229	113	G5C7N1	500	614	6.757226086956522	114
Q91YR5	PF08241	52	156	5.319333333333331	104	G5C7N1	53	157	4.367838095238095	104
O35084	PF00067	40	502	2.855896328293735	462	G5BEB6	41	502	4.366058441558437	461
Q9QZ08	PF01869	38	274	3.1471476793248954	236	G5B4Z4	21	257	5.970075949367089	236
Q9JK37	PF05556	0	295	0.14874324324324328	295	G5C7H2	1	290	0.15171972318339105	289
Q9Z0E0	PF05536	31	636	11.224404290429046	605	G5C6E3	22	627	10.891894389438939	605
Q07243	PF00096	138	162	0.0	24	G5C6H8	135	159	0.0	24
Q07243	PF00096	168	192	0.7230800000000001	24	G5C6H8	165	189	0.59992	24
Q07243	PF00096	198	222	0.08664	24	G5C6H8	195	219	0.08688000000000001	24
Q07243	PF00096	227	251	3.07916	24	G5C6H8	224	248	3.06592	24
Q07243	PF00096	257	281	0.0	24	G5C6H8	254	278	0.0	24
Q07243	PF00096	287	311	0.0	24	G5C6H8	284	308	0.0	24
A2ASZ8	PF00153	185	271	0.4420344827586208	86	G5BLF4	231	317	0.4415172413793103	86
A2ASZ8	PF00153	277	364	2.5580909090909065	87	G5BLF4	323	410	2.563613636363635	87
A2ASZ8	PF00153	375	462	14.756215909090901	87	G5BLF4	421	508	14.738931818181806	87
A2ASZ8	PF13499	80	137	0.0	57	G5BLF4	114	183	0.0	69
A2ASZ8	PF13833	54	77	0.0	23	G5BLF4	88	111	0.0	23
Q3V016	PF00069	10	346	2.256724035608308	336	G5C9Y0	11	347	2.387685459940652	336
O88200	PF00059	212	325	2.999228070175438	113	G5B8T6	207	320	1.9290438596491235	113
Q80Z37	PF13920	100	147	0.0	47	G5C356	100	147	0.0	47
Q3V1L6	PF06602	211	299	0.5451910112359551	88	G5BH26	179	267	0.01837078651685393	88
Q3V1L6	PF06602	323	486	7.925957317073171	163	G5BH26	291	454	9.998414634146343	163
Q3V1L6	PF12578	551	681	0.4589770992366412	130	G5BH26	519	649	1.029732824427481	130
Q9D975	PF02195	42	129	4.333522727272727	87	G5C6M5	20	107	1.2368977272727273	87
Q62070	PF00069	92	344	9.193549407114627	252	G5BJI8	34	286	9.418541501976284	252
E9Q414	PF01347	79	596	3.235542471042471	517	G5AZB7	204	768	2.7597840707964623	564
E9Q414	PF06448	959	1070	3.197892857142857	111	G5AZB7	1131	1242	0.7397767857142857	111
E9Q414	PF09172	631	936	3.2140457516339844	305	G5AZB7	803	1108	3.228235294117649	305
E9Q414	PF12491	4433	4488	0.8605892857142858	55	G5AZB7	4643	4698	7.825517857142856	55
Q99PT9	PF00225	16	345	1.6604878787878792	329	G5B5N1	17	381	2.959473972602741	364
Q8VEK3	PF00622	332	436	1.3882666666666668	104	G5AM31	127	231	1.3630571428571427	104
Q8VEK3	PF13671	474	618	1.677724137931034	144	G5AM31	269	413	1.3633793103448275	144
Q3TUF7	PF03366	231	311	7.5670370370370375	80	G5BTE9	232	312	7.566049382716049	80
P60335	PF00013	14	75	9.22566129032258	61	G5C6V6	14	75	9.237741935483873	61
P60335	PF00013	98	161	1.96134375	63	G5C6V6	98	161	3.1800468749999995	63
P60335	PF00013	280	343	2.0280625	63	G5C6V6	280	343	2.0317031250000004	63
Q9JJS6	PF03055	6	518	4.494857699805065	512	G5B1X2	7	519	4.496890838206626	512
O35185	PF00010	54	106	1.4603207547169812	52	G5B3I0	55	107	1.5096981132075469	52
O35185	PF07527	140	178	1.0545641025641026	38	G5B3I0	141	179	1.0542820512820512	38
Q8BFV3	PF00581	44	155	8.648455357142858	111	G5AV66	82	193	8.651625	111
Q8BFV3	PF00782	206	335	4.387015384615388	129	G5AV66	244	373	4.276123076923079	129
Q9CQL4	PF00453	14	115	6.840529411764704	101	G5ATP8	15	116	6.506372549019611	101
P63166	PF11976	21	79	0.019322033898305082	58	G5C1S9	19	76	0.020315789473684214	57
Q8VE04	PF03637	34	206	8.145953757225433	172	G5BPX1	35	207	8.203445086705202	172
Q921H9	PF08238	68	101	1.8959117647058827	33	G5AUI9	69	102	5.7494999999999985	33
Q921H9	PF08238	108	145	0.17652631578947367	37	G5AUI9	109	146	0.1556578947368421	37
Q921H9	PF08238	146	182	1.4224054054054056	36	G5AUI9	147	183	0.6881081081081082	36
Q921H9	PF08238	186	207	0.2831818181818182	21	G5AUI9	187	208	0.2122272727272727	21
Q9CPV1	PF07160	14	246	1.3497339055793989	232	G5BVS7	15	247	1.9197811158798284	232
O88452	PF03298	12	213	4.691851485148513	201	G5BGI9	13	213	4.232796019900498	200
Q99LT0	PF05186	51	76	18.1295	25	G5B3Y7	52	76	19.756958333333333	24
Q8R3R8	PF02991	13	115	17.001359223300973	102	G5BDZ9	14	114	17.36049504950495	100
Q99ME3	PF12796	330	404	0.016200000000000003	74	G5AK87	289	363	0.016200000000000003	74
Q99ME3	PF12796	419	485	10.356089552238801	66	G5AK87	378	444	10.356761194029852	66
Q99ME3	PF16700	510	554	2.193955555555556	44	G5AK87	469	513	0.006866666666666668	44
Q8QZR4	PF14941	50	279	1.9271478260869572	229	G5BHQ1	1	230	0.8894260869565217	229
Q9CQL1	PF02792	4	145	5.853119718309858	141	G5BE03	7	148	5.896326241134753	141
A6H5Z3	PF04091	463	659	10.096507614213204	196	G5CBR0	416	611	10.102397959183676	195
O88796	PF01876	20	180	8.68544720496894	160	G5B100	1	160	8.63985625	159
Q6PGH0	PF00240	155	223	9.970608695652174	68	G5BBY0	133	201	9.971985507246378	68
Q6PGH0	PF16455	28	131	0.02325	103	G5BBY0	6	109	0.023480769230769232	103
Q91VR7	PF02991	15	119	10.656933333333333	104	G5BPT3	3	107	10.660238095238093	104
A2A884	PF00096	184	206	0.0	22	G5AQJ3	191	213	0.0	22
A2A884	PF00096	212	234	0.0	22	G5AQJ3	219	241	0.0	22
A2A884	PF00096	1719	1741	0.0	22	G5AQJ3	1750	1772	0.0	22
A2A884	PF00096	1747	1771	0.0	24	G5AQJ3	1778	1802	0.0	24
O88737	PF05715	165	222	0.18717241379310345	57	G5BZW7	95	152	0.18751724137931036	57
O88737	PF05715	463	519	0.016315789473684214	56	G5BZW7	389	445	0.016403508771929826	56
O88947	PF00008	89	119	0.0	30	G5AVW1	224	254	0.0	30
O88947	PF00089	231	458	5.235039473684213	227	G5AVW1	371	598	3.4144035087719304	227
O88947	PF00594	44	84	0.006439024390243903	40	G5AVW1	179	219	0.0	40
O88947	PF14670	128	163	0.1836388888888889	35	G5AVW1	263	298	0.0	35
P70380	PF00340	74	178	8.179609523809521	104	G5CAZ3	73	178	8.062094339622638	105
P41160	PF02024	22	166	0.9987655172413792	144	G5BHA4	23	167	0.7491944444444442	144
Q8R2R6	PF01926	144	243	12.137670000000005	99	G5AVA4	145	244	10.82959	99
Q6GUQ1	PF07546	36	100	0.08770769230769232	64	G5C3I2	37	101	0.08795384615384617	64
Q6GUQ1	PF07645	143	181	1.0864102564102565	38	G5C3I2	144	182	0.016923076923076926	38
Q04888	PF00505	107	171	4.764092307692309	64	G5AYS2	1	65	3.886569230769231	64
Q8BKZ9	PF00198	273	499	2.0577268722466964	226	G5AXU7	274	500	2.0647488986784146	226
Q8BKZ9	PF00364	58	129	5.117861111111111	71	G5AXU7	59	130	2.5901527777777784	71
Q8BKZ9	PF02817	182	216	0.023342857142857144	34	G5AXU7	183	217	0.06694285714285714	34
Q80WQ8	PF09133	335	421	0.9143218390804596	86	G5BUQ9	316	402	2.1717011494252856	86
Q99JX7	PF02136	385	533	10.694919463087247	148	G5AYJ3	383	531	10.213536912751676	148
Q99JX7	PF03943	567	615	0.613938775510204	48	G5AYJ3	565	613	0.0	48
Q99JX7	PF09162	115	196	3.735036585365853	81	G5AYJ3	113	193	2.7360246913580246	80
Q9CY57	PF13865	166	242	0.0	76	G5BER3	167	243	0.0	76
Q9CWK8	PF00787	171	264	0.052319148936170214	93	G5BBF3	172	265	0.051978723404255286	93
Q9CWK8	PF03700	1	74	0.053527027027027024	73	G5BBF3	2	75	0.053148648648648655	73
Q9CWK8	PF09325	282	455	0.6464482758620688	173	G5BBF3	283	459	0.5767853107344632	176
Q61493	PF00136	2542	2991	5.632057777777785	449	G5AUP0	2540	2989	6.355942222222222	449
Q61493	PF03104	45	189	3.445510344827587	144	G5AUP0	46	190	3.4395999999999995	144
Q61493	PF03104	2284	2475	6.0506562499999985	191	G5AUP0	2282	2473	6.0495677083333375	191
Q61493	PF14260	3033	3100	5.909558823529411	67	G5AUP0	3031	3098	6.059617647058822	67
Q61493	PF15735	748	1131	0.07231770833333337	383	G5AUP0	746	1127	0.2502931937172774	381
P25233	PF01454	171	275	11.598980952380948	104	G5C217	132	236	11.629476190476195	104
Q3U2J5	PF10294	145	275	2.9597557251908366	130	G5C9U2	63	193	3.0696488549618324	130
Q6NS45	PF15236	411	559	0.1262953020134228	148	G5ATM6	288	436	0.16249664429530206	148
P58710	PF01565	22	155	6.350880597014926	133	G5BY89	1	134	7.444268656716418	133
P58710	PF04030	179	436	6.656674418604652	257	G5BY89	220	477	6.65868217054263	257
Q9WV70	PF03715	329	622	5.508622448979592	293	G5ATS0	351	641	5.3109278350515465	290
Q9D3G9	PF00071	5	169	5.979090909090909	164	G5C3U1	6	170	5.99997575757576	164
Q91YE7	PF17780	457	507	0.24309803921568626	50	G5BZY2	453	503	0.2433529411764705	50
Q91YE7	PF00076	99	162	1.6499218750000002	63	G5BZY2	95	158	1.6510000000000005	63
Q91YE7	PF00641	180	208	0.0	28	G5BZY2	176	204	0.0	28
Q91YE7	PF01585	742	786	0.0	44	G5BZY2	738	782	0.0	44
Q62267	PF02389	20	150	0.0	130	G5BUZ4	37	166	0.0	129
Q3U034	PF05063	279	453	8.285519999999998	174	G5CAX5	280	454	4.391217142857143	174
Q8CHK2	PF00049	31	140	2.442718181818183	109	G5BYU0	36	144	2.707203703703704	108
A2A761	PF00096	323	345	0.0	22	G5CBJ3	268	290	0.0	22
A2A761	PF00096	351	373	0.0	22	G5CBJ3	296	318	0.0	22
A2A761	PF00096	379	401	0.0	22	G5CBJ3	324	346	0.0	22
A2A761	PF00096	407	429	0.11869565217391305	22	G5CBJ3	352	374	0.113	22
A2A761	PF00096	435	457	0.0	22	G5CBJ3	380	402	0.0	22
A2A761	PF00096	491	513	0.0	22	G5CBJ3	436	458	0.0	22
A2A761	PF00096	547	569	0.0	22	G5CBJ3	492	514	0.0	22
A2A761	PF01352	130	169	0.381325	39	G5CBJ3	74	113	0.242575	39
Q6GQV0	PF15764	149	388	0.6473875000000001	239	G5AQD2	148	394	0.2780364372469634	246
Q3UHX8	PF00046	141	196	0.453875	55	G5C637	141	196	0.4551607142857144	55
P0C090	PF00642	410	436	0.0	26	G5B6X6	411	437	0.0	26
P0C090	PF13445	13	42	0.0	29	G5B6X6	14	43	0.0	29
P0C090	PF18386	267	322	0.035892857142857136	55	G5B6X6	268	323	0.035892857142857136	55
Q8K301	PF00270	189	361	3.738971098265897	172	G5ARC7	51	223	3.9151445086705183	172
Q8K301	PF00271	399	507	14.835422018348632	108	G5ARC7	261	369	14.79687155963303	108
Q61865	PF07653	46	108	9.756793650793652	62	G5C9W8	48	110	8.177238095238094	62
Q99PG2	PF04664	77	281	3.6903707317073184	204	G5C8E4	34	238	3.874980487804879	204
Q8BG92	PF00650	99	250	15.684243421052637	151	G5B3W2	100	251	15.669388157894742	151
Q8BG92	PF03765	47	71	1.6995200000000001	24	G5B3W2	48	72	2.1146	24
Q80Y81	PF12706	507	720	7.06107476635514	213	G5BRA5	467	734	4.639384328358204	267
Q80Y81	PF13691	52	111	12.186216666666674	59	G5BRA5	55	114	10.193716666666667	59
Q91ZE0	PF02668	163	403	4.937161825726137	240	G5BF93	164	404	5.652605809128634	240
Q91ZE0	PF06155	52	132	6.2221358024691344	80	G5BF93	53	133	5.889987654320986	80
Q9D0E3	PF01476	43	84	0.5503571428571428	41	G5AJZ3	44	85	0.5459047619047619	41
Q69ZK7	PF13889	1016	1072	0.008333333333333333	56	G5C9C9	1245	1301	0.0	56
Q69ZK7	PF13915	877	903	0.15655555555555556	26	G5C9C9	1140	1165	0.1571538461538462	25
Q8K0F1	PF00566	47	210	5.457865853658534	163	G5BUU5	127	280	5.800610389610388	153
Q8K0F1	PF00581	331	437	2.202439252336448	106	G5BUU5	328	434	2.1734205607476653	106
Q91XC9	PF08610	9	296	11.153572916666667	287	G5ATB0	10	295	11.598961403508778	285
Q3V3R1	PF00763	102	178	0.5136623376623379	76	G5C0E7	106	182	0.06032467532467532	76
Q3V3R1	PF01268	359	960	5.129184385382064	601	G5C0E7	363	999	4.812574568288851	636
Q3V3R1	PF02882	182	334	3.38721568627451	152	G5C0E7	186	338	2.0821045751633993	152
Q80X73	PF03463	0	128	0.7735503875968992	128	G5BQY2	1	129	0.30413178294573645	128
Q80X73	PF03464	135	267	6.186195488721807	132	G5BQY2	136	259	5.53409677419355	123
Q80X73	PF03465	271	369	1.2936464646464647	98	G5BQY2	263	361	1.3194444444444444	98
Q99LJ8	PF01255	191	295	0.3651619047619048	104	G5BBJ7	189	293	0.3152952380952381	104
Q811B5	PF00642	158	182	0.0	24	G5C3B4	101	125	0.1698	24
Q6P1D7	PF00651	498	602	6.4507238095238115	104	G5B1H0	623	745	3.3362764227642283	122
Q6P1D7	PF09494	1484	1540	0.5945789473684211	56	G5B1H0	1682	1738	4.231491228070176	56
Q9D2C6	PF03876	8	63	20.18932142857143	55	G5BPP7	9	64	20.37467857142857	55
Q9D2C6	PF08292	82	200	0.7946890756302522	118	G5BPP7	83	201	0.9827226890756302	118
Q3UFB7	PF07714	514	783	8.924877777777771	269	G5BGA4	346	607	6.817614503816798	261
Q3UFB7	PF13855	92	149	0.06927586206896551	57	G5BGA4	34	91	0.00956896551724138	57
Q3UFB7	PF16920	150	193	7.939022727272728	43	G5BGA4	92	135	0.10759090909090907	43
Q8CF89	PF00481	69	332	5.221780303030299	263	G5AYV1	60	323	5.270928030303035	263
O35621	PF03332	35	254	3.9667727272727267	219	G5BPP9	36	255	3.8965590909090917	219
Q8BHR2	PF00076	143	198	0.843375	55	G5AV54	144	199	0.7791964285714286	55
P02831	PF00046	192	248	0.0580701754385965	56	G5BD51	181	234	0.011944444444444443	53
P02831	PF13293	378	440	0.11428571428571427	62	G5BD51	364	427	0.375078125	63
P97360	PF02198	40	110	3.63256338028169	70	G5APU4	14	84	3.5927464788732397	70
Q9DBV3	PF00271	377	497	4.237785123966944	120	G5AV11	376	496	4.052471074380166	120
Q9DBV3	PF04408	558	642	15.545623529411767	84	G5AV11	557	641	18.522870588235293	84
Q9DBV3	PF07717	799	910	7.1385982142857145	111	G5AV11	800	911	7.554616071428571	111
O54781	PF00069	78	220	6.023314685314685	142	G5BI41	71	212	8.398823943661977	141
O54781	PF00069	516	678	0.14903680981595088	162	G5BI41	513	675	0.14915337423312885	162
Q3U898	PF15004	0	21	0.0	21	G5BGW9	1	21	0.0	20
Q0P5X1	PF00612	1282	1298	1.3064117647058824	16	G5BJL0	1317	1333	33.41441176470589	16
Q0P5X1	PF00612	1340	1358	0.1268421052631579	18	G5BJL0	1374	1392	26.84752631578947	18
Q0P5X1	PF13855	874	917	8.625409090909091	43	G5BJL0	848	890	13.114604651162793	42
Q0P5X1	PF13855	985	1039	1.074145454545454	54	G5BJL0	1017	1071	0.7716545454545454	54
Q9WUK6	PF00096	369	391	0.0	22	G5AM37	424	446	0.0	22
Q9WUK6	PF00096	437	459	0.0	22	G5AM37	492	514	0.0	22
Q9WUK6	PF00096	465	488	0.0	23	G5AM37	520	543	0.0	23
Q9WUK6	PF00651	13	119	8.136925233644865	106	G5AM37	68	174	8.135158878504674	106
Q9WUK6	PF13894	410	431	0.0	21	G5AM37	465	486	0.0	21
Q3URK3	PF02008	567	606	0.0	39	G5B7Z9	510	549	0.0	39
Q3URK3	PF12851	1527	1930	1.901329207920792	403	G5B7Z9	1494	1927	1.2743179723502298	433
Q9DCU6	PF00573	80	270	1.233214659685863	190	G5B233	83	273	0.6528691099476437	190
Q8BK62	PF02191	139	398	9.008969230769235	259	G5ATD9	140	396	9.362241245136177	256
Q3TUH1	PF09139	12	313	1.2931920529801326	301	G5C222	8	308	2.6272657807308994	300
Q9CR89	PF07970	189	330	8.666690140845075	141	G5BLL1	71	211	8.78005	140
Q9CR89	PF13850	12	74	21.25646031746032	62	G5BLL1	13	74	21.583322580645167	61
Q99MI1	PF10174	153	457	0.09670819672131148	304	G5C5Q2	154	458	0.0977311475409836	304
Q99MI1	PF10174	457	931	0.05061263157894736	474	G5C5Q2	458	927	0.15660767590618335	469
Q6NZQ0	PF14769	129	226	9.905989795918368	97	G5BYK4	129	226	7.289020408163267	97
Q9D6S7	PF01765	98	260	2.6166993865030683	162	G5AJL8	99	261	2.1649693251533746	162
P31428	PF01244	25	350	3.5927668711656486	325	G5API2	26	350	2.1930399999999994	324
Q3TWF6	PF00400	187	212	0.3460769230769231	25	G5BTT6	142	167	0.7471538461538463	25
Q3TWF6	PF00400	336	362	0.7672222222222222	26	G5BTT6	291	317	0.7255185185185186	26
Q3TWF6	PF00400	376	408	0.4472424242424241	32	G5BTT6	331	363	0.4476060606060605	32
Q9EQT3	PF00071	88	221	9.598111940298503	133	G5BQH8	1	134	9.748507462686568	133
Q920C1	PF00093	31	93	4.9444444444444455	62	G5AN03	74	136	4.8158730158730165	62
Q920C1	PF00093	109	166	0.018879310344827583	57	G5AN03	153	209	0.019035087719298245	56
Q920C1	PF00093	254	316	1.5726825396825397	62	G5AN03	290	352	1.5647142857142853	62
Q3UUG6	PF00566	48	252	10.920697560975604	204	G5AQD0	49	253	10.918551219512201	204
Q3UUG6	PF07534	367	555	4.632608465608464	188	G5AQD0	368	556	4.566201058201059	188
O88848	PF00025	10	178	7.067136094674559	168	G5BXD1	11	155	7.12053103448275	144
Q91V93	PF00071	15	206	6.209593750000002	191	G5B9R3	38	229	6.190786458333334	191
Q91V93	PF00651	384	469	5.374767441860465	85	G5B9R3	407	492	5.356220930232559	85
Q91V93	PF00651	490	593	3.5683173076923054	103	G5B9R3	513	608	3.398281249999999	95
Q61703	PF00092	309	491	8.908699453551913	182	G5AXV8	321	461	4.163929078014186	140
Q61703	PF06668	734	920	4.16955614973262	186	G5AXV8	713	889	6.950474576271177	176
Q61703	PF08487	71	182	1.2108214285714278	111	G5AXV8	81	192	0.6450624999999999	111
Q8C2S5	PF01814	55	137	3.2787831325301204	82	G5BGC1	1	83	3.2830963855421693	82
Q8C2S5	PF12937	204	248	12.051911111111114	44	G5BGC1	150	194	12.059533333333333	44
Q8C2S5	PF13516	354	370	0.0	16	G5BGC1	300	316	0.0	16
Q8C2S5	PF13516	381	403	0.0	22	G5BGC1	327	349	0.04304347826086957	22
Q8C2S5	PF13516	624	645	0.18445454545454545	21	G5BGC1	571	592	0.1849090909090909	21
Q9JII5	PF00076	11	68	1.3250000000000004	57	G5AZL0	9	66	0.8862758620689657	57
Q9JII5	PF00076	114	182	16.80826086956522	68	G5AZL0	112	180	16.783768115942028	68
P62915	PF00382	120	190	3.819605633802816	70	G5BGF9	114	184	3.796394366197184	70
P62915	PF00382	214	284	8.098577464788733	70	G5BGF9	208	278	8.097760563380284	70
P62915	PF08271	13	54	0.1078095238095238	41	G5BGF9	7	48	0.1078095238095238	41
Q9D4H9	PF00628	313	371	4.610169491525424	58	G5C732	125	183	3.6677796610169486	58
Q9D4H9	PF00628	720	770	1.4039607843137256	50	G5C732	535	585	1.3623333333333334	50
Q9D4H9	PF13832	376	490	6.79877391304348	114	G5C732	188	302	6.7810956521739145	114
Q8CAI1	PF14923	287	713	7.093185011709593	426	G5AXF3	320	737	7.887834928229668	417
Q9D662	PF00626	633	719	8.965045977011496	86	G5CBB3	635	721	8.960689655172414	86
Q9D662	PF04810	57	97	0.2547073170731708	40	G5CBB3	58	98	0.2635365853658537	40
Q9D662	PF04811	126	391	7.755560150375942	265	G5CBB3	127	393	6.241617977528089	266
Q9D662	PF04815	519	617	2.911171717171717	98	G5CBB3	521	619	2.9828787878787857	98
Q9D662	PF08033	402	505	1.0816923076923075	103	G5CBB3	404	507	1.0893076923076928	103
Q9EQH4	PF07524	29	103	13.485213333333334	74	G5BNJ1	32	106	13.45753333333333	74
Q9EQH4	PF10406	142	190	0.0	48	G5BNJ1	145	193	0.0	48
Q8BHA3	PF02580	10	166	5.1079617834394915	156	G5CAL8	11	167	5.294541401273885	156
P39688	PF00017	148	230	0.3928915662650604	82	G5AUN8	149	231	0.3928915662650604	82
P39688	PF00018	87	134	7.168291666666664	47	G5AUN8	88	135	5.115583333333333	47
P39688	PF07714	270	518	5.675594377510039	248	G5AUN8	271	519	5.674168674698793	248
Q3V1D3	PF00962	293	699	8.200904176904174	406	G5ATE7	280	686	9.336533169533164	406
Q8VHJ5	PF00069	59	310	7.45049603174603	251	G5AQS8	71	322	7.421996031746029	251
Q8VHJ5	PF00627	331	366	22.90533333333333	35	G5AQS8	343	378	25.692750000000004	35
Q8VHJ5	PF02149	752	794	0.030930232558139537	42	G5AQS8	791	833	0.030930232558139537	42
Q68G58	PF03372	4	302	3.2096354515050174	298	G5BHQ5	5	304	2.894613333333335	299
Q68G58	PF06839	464	512	1.8784081632653065	48	G5BHQ5	467	515	0.054285714285714284	48
P49935	PF00112	114	329	5.636458333333333	215	G5B3N9	116	331	5.648550925925932	215
P49935	PF08246	32	86	0.0	54	G5B3N9	34	88	0.0	54
Q99J62	PF00004	73	199	1.2266929133858264	126	G5BT84	74	200	1.2969921259842516	126
Q99J62	PF08542	269	353	0.2884117647058824	84	G5BT84	270	354	6.666047058823531	84
Q9CS72	PF09727	92	202	0.05076576576576578	110	G5AL52	12	121	0.06144545454545456	109
Q9D3V1	PF00612	398	415	3.3134444444444444	17	G5AKW6	402	419	2.9631111111111115	17
P21844	PF00089	35	239	2.2672878048780505	204	G5BRP0	1	205	0.9935463414634144	204
Q8VHG2	PF12240	577	779	0.12722660098522173	202	G5BJG7	578	780	0.561704433497537	202
Q06138	PF08569	2	333	3.8281234939759083	331	G5ASV9	3	334	3.8847590361445783	331
O70167	PF00168	1402	1500	11.215656565656564	98	G5C2C3	1340	1438	19.628474747474748	98
O70167	PF00454	976	1188	9.024248826291084	212	G5C2C3	913	1125	9.220220657276997	212
O70167	PF00613	723	871	4.934999999999998	148	G5C2C3	660	808	4.455838926174496	148
O70167	PF00787	1288	1365	5.136679487179487	77	G5C2C3	1224	1301	6.973358974358975	77
O70167	PF00792	599	645	5.056063829787234	46	G5C2C3	536	582	0.7429148936170213	46
Q8BYW1	PF00169	49	148	0.8799800000000002	99	G5BNY5	1	100	0.8195299999999996	99
Q8BYW1	PF00620	177	325	5.05293288590604	148	G5BNY5	129	277	5.508610738255035	148
Q3UMB5	PF11704	91	221	1.3057709923664125	130	G5BMY0	92	222	1.2907557251908397	130
P14404	PF00096	292	314	0.0	22	G5C8I1	282	304	0.0	22
P14404	PF00096	320	343	0.0	23	G5C8I1	310	333	0.0	23
P14404	PF00096	349	371	0.0	22	G5C8I1	339	361	0.0	22
P14404	PF00096	377	399	0.0	22	G5C8I1	367	389	0.0	22
P14404	PF00096	407	426	0.0	19	G5C8I1	397	416	0.0	19
P14404	PF00096	913	935	0.0	22	G5C8I1	903	925	0.0	22
P14404	PF00096	941	964	0.0	23	G5C8I1	931	954	0.0	23
P14404	PF00096	970	992	0.0	22	G5C8I1	960	982	0.0	22
P14404	PF13912	266	286	0.0	20	G5C8I1	256	276	0.0	20
Q9ESY9	PF03227	74	160	8.221816091954024	86	G5B4D5	2	88	11.498735632183907	86
Q3UR70	PF00780	77	286	14.369014285714279	209	G5CB77	78	287	12.383657142857134	209
Q3UR70	PF10366	447	508	8.974645161290324	61	G5CB77	448	508	5.327295081967212	60
Q9DBR0	PF04988	411	542	0.0	131	G5BYP7	421	552	0.0	131
Q60963	PF03403	50	414	5.725805479452058	364	G5BNG0	52	415	2.804609890109888	363
P70378	PF00167	71	195	7.547336	124	G5B5C1	72	196	7.559632000000001	124
Q8C525	PF03281	110	336	5.010885462555066	226	G5BS74	103	329	5.035268722466962	226
P61953	PF00631	10	71	0.0	61	G5ANK6	11	72	0.0	61
Q14DN9	PF12796	91	155	8.735923076923076	64	G5AK83	4	67	11.106890625	63
Q14DN9	PF12796	163	254	6.481478260869568	91	G5AK83	76	167	3.1058260869565224	91
Q14DN9	PF12796	297	380	1.729	83	G5AK83	256	335	14.342125	79
P80313	PF00118	31	521	5.163973523421593	490	G5CBQ4	35	525	4.515232179226072	490
P48986	PF00010	94	143	4.612419999999998	49	G5ATW0	95	144	6.13532	49
P48986	PF12533	152	271	2.2389083333333333	119	G5ATW0	153	272	2.243941666666666	119
Q8BXA7	PF00481	810	1022	4.466553990610327	212	G5BNU2	813	1025	6.165525821596247	212
Q8BXA7	PF13855	319	376	0.12874137931034482	57	G5BNU2	322	379	0.054310344827586204	57
Q8BXA7	PF13855	500	556	0.04124561403508771	56	G5BNU2	503	559	0.03343859649122806	56
Q8BXA7	PF13855	568	618	3.542627450980392	50	G5BNU2	571	620	3.5965800000000003	49
Q8BXA7	PF13855	640	699	0.0	59	G5BNU2	643	702	0.0	59
P54726	PF00240	4	77	8.849256756756757	73	G5BYW0	5	78	8.694527027027027	73
P54726	PF00627	161	197	3.581594594594596	36	G5BYW0	162	198	3.300783783783784	36
P54726	PF00627	320	354	12.581885714285715	34	G5BYW0	321	355	12.707771428571426	34
P54726	PF09280	231	286	0.045178571428571436	55	G5BYW0	232	287	0.04526785714285714	55
Q91VJ4	PF00069	88	366	3.2499139784946243	278	G5BEV6	89	367	3.2351505376344085	278
Q91VJ4	PF00433	400	444	13.748022222222223	44	G5BEV6	401	445	13.828977777777775	44
O70422	PF03849	21	374	10.390457627118641	353	G5C3C7	22	375	11.110853107344637	353
O70422	PF18307	389	456	7.039220588235294	67	G5C3C7	390	457	7.039220588235294	67
O35855	PF01063	100	350	7.143892430278887	250	G5BAH3	106	356	7.0506215139442245	250
Q8BYM7	PF04712	209	693	2.2348453608247403	484	G5AMZ9	189	671	1.7981573498964811	482
Q8C460	PF00929	146	318	2.9442658959537567	172	G5ARV9	147	319	2.416202312138728	172
Q8C9X6	PF06752	580	812	0.4026008583690987	232	G5BE27	582	836	0.640267716535433	254
Q8C9X6	PF10513	6	147	0.012176056338028169	141	G5BE27	7	148	0.012176056338028169	141
Q9CQ60	PF01182	13	236	4.688919642857143	223	G5B7W0	14	238	4.05144	224
Q0KK55	PF00617	1466	1611	2.5527945205479448	145	G5AVB6	1458	1603	2.4455410958904107	145
Q0KK55	PF00618	1242	1340	11.616828282828285	98	G5AVB6	1234	1332	11.434494949494953	98
Q0KK55	PF16474	36	163	1.2699453125000004	127	G5AVB6	36	163	1.007328125	127
Q02085	PF00096	180	201	0.0	21	G5AZ05	181	202	0.0	21
Q02085	PF00096	207	229	0.0	22	G5AZ05	208	230	0.0	22
Q02085	PF13912	153	175	0.2420869565217391	22	G5AZ05	154	176	0.2420869565217391	22
Q9CYK1	PF00579	35	311	5.08597472924188	276	G5BDM5	70	346	4.361090252707584	276
Q9JMK2	PF00069	8	223	7.523226851851853	215	G5AYS9	9	224	7.523226851851853	215
P29341	PF00076	12	81	0.9783857142857144	69	G5AP00	283	351	2.200202898550724	68
P29341	PF00076	100	167	0.2341911764705883	67	G5AP00	191	258	0.18547058823529405	67
P29341	PF00076	192	260	2.379695652173913	68	G5AP00	283	351	2.200202898550724	68
P29341	PF00076	295	362	3.0327058823529405	67	G5AP00	386	436	1.493921568627451	50
P29341	PF00658	547	613	1.01455223880597	66	G5AP00	621	687	1.03855223880597	66
P70375	PF00008	90	120	18.382838709677422	30	G5AVW2	95	125	0.8841612903225806	30
P70375	PF00089	193	427	8.735846808510637	234	G5AVW2	198	432	7.348961702127656	234
P70375	PF00594	45	84	12.487975	39	G5AVW2	50	89	8.33995	39
P70375	PF14670	131	167	0.0	36	G5AVW2	136	172	0.0	36
Q8BH57	PF00400	70	102	0.4767878787878786	32	G5C5N7	82	114	0.4554545454545454	32
Q8BH57	PF00400	108	144	1.7197837837837842	36	G5C5N7	120	156	1.724054054054054	36
Q8BH57	PF00400	160	195	6.826138888888888	35	G5C5N7	172	207	6.829138888888887	35
Q8BH57	PF00400	202	237	0.0	35	G5C5N7	214	249	0.05263888888888889	35
Q8BH57	PF11816	508	671	0.05210975609756098	163	G5C5N7	520	684	0.05186060606060607	164
P50431	PF00464	19	418	3.2779675000000004	399	G5BMY1	26	425	3.614694999999998	399
Q8VCM3	PF01363	46	99	0.0702037037037037	53	G5AWH6	1	54	0.21744444444444447	53
Q8VCM3	PF16696	107	232	9.246833333333333	125	G5AWH6	62	204	4.4618111888111915	142
Q8C570	PF00400	84	113	0.28340000000000004	29	G5AUN0	85	114	0.28340000000000004	29
Q8C570	PF00400	137	156	0.038	19	G5AUN0	138	157	0.038	19
Q8CG19	PF00683	558	601	0.0	43	G5B3X9	282	325	0.0	43
Q8CG19	PF00683	679	723	0.0	44	G5B3X9	403	447	0.004333333333333333	44
Q8CG19	PF00683	1349	1394	0.0	45	G5B3X9	1072	1117	0.0	45
Q8CG19	PF00683	1526	1568	0.0	42	G5B3X9	1249	1291	0.0	42
Q8CG19	PF07645	617	656	0.0	39	G5B3X9	341	380	0.0	39
Q8CG19	PF07645	865	904	0.35745000000000005	39	G5B3X9	589	628	0.35545	39
Q8CG19	PF07645	906	946	0.1174390243902439	40	G5B3X9	630	670	0.11060975609756098	40
Q8CG19	PF07645	948	980	0.0	32	G5B3X9	672	704	0.031363636363636364	32
Q8CG19	PF07645	989	1024	0.0	35	G5B3X9	713	748	0.0	35
Q8CG19	PF07645	1111	1150	0.0	39	G5B3X9	835	874	0.0	39
Q8CG19	PF07645	1152	1189	0.0	37	G5B3X9	876	913	0.0	37
Q8CG19	PF07645	1193	1233	0.0	40	G5B3X9	917	957	0.0	40
Q8CG19	PF07645	1235	1275	0.0	40	G5B3X9	959	999	0.0	40
Q8CG19	PF07645	1277	1307	0.7693548387096774	30	G5B3X9	1001	1031	0.774032258064516	30
Q8CG19	PF07645	1414	1455	0.0	41	G5B3X9	1137	1178	0.0	41
Q8CG19	PF07645	1457	1496	0.0	39	G5B3X9	1180	1219	0.0	39
Q8CG19	PF07645	1652	1695	0.0	43	G5B3X9	1375	1418	0.0	43
Q8CG19	PF12662	1050	1073	0.0	23	G5B3X9	774	797	0.0	23
Q8C5K5	PF15112	72	313	3.889128099173551	241	G5B9K4	1	248	4.2453709677419385	247
Q6P9Q6	PF00254	192	284	2.7720967741935496	92	G5BWQ8	194	286	4.1261720430107545	92
P42208	PF00735	33	311	4.293813620071689	278	G5C3R7	57	335	4.276082437275985	278
Q8R080	PF15259	9	150	0.28886619718309864	141	G5BVB2	2	142	1.8100780141843973	140
Q9CWV7	PF04434	343	373	1.4641935483870967	30	G5B7P4	341	371	1.4107096774193548	30
Q9EQF5	PF01979	86	446	2.517828254847644	360	G5AZ86	1	361	2.8006842105263168	360
P27786	PF00067	27	490	12.52469827586208	463	G5CAI3	28	497	11.881670212765961	469
Q91YP0	PF01266	61	455	4.500926582278482	394	G5BLM7	51	445	2.846848101265822	394
P06876	PF00249	40	85	0.054565217391304335	45	G5C6A7	55	100	0.05445652173913043	45
P06876	PF00249	91	137	0.12500000000000006	46	G5C6A7	106	152	0.12451063829787233	46
P06876	PF00249	144	186	0.13383720930232554	42	G5C6A7	159	201	0.13348837209302325	42
P06876	PF07988	266	312	0.1320212765957446	46	G5C6A7	281	327	0.10878723404255322	46
P06876	PF09316	401	555	0.0	154	G5C6A7	537	695	0.0	158
Q60988	PF15253	21	425	5.308241975308642	404	G5BI94	33	436	6.273532178217826	403
P32233	PF01926	65	165	7.066970297029704	100	G5BBV0	66	166	7.0668712871287145	100
P32233	PF02824	294	365	9.009305555555557	71	G5BBV0	239	310	8.995388888888892	71
P32233	PF16897	185	242	0.3980517241379311	57	G5BBV0	186	242	0.0	56
Q80XP8	PF16046	5	327	3.6638359133126936	322	G5ANX6	6	328	3.66221052631579	322
Q9D4J7	PF13771	41	131	3.5373956043956047	90	G5BJG5	42	132	3.5417472527472524	90
Q9D4J7	PF13771	238	329	0.0	91	G5BJG5	240	331	0.0	91
Q9DAP0	PF14580	52	172	1.5785950413223138	120	G5BY24	73	193	3.840115702479338	120
Q69ZF3	PF04685	511	876	10.973964480874317	365	G5BKZ6	516	881	11.098213114754104	365
Q69ZF3	PF12215	141	445	4.885072131147541	304	G5BKZ6	143	450	4.139438311688314	307
Q9D0U6	PF09174	24	201	11.064955056179777	177	G5C5T7	25	202	10.56698876404494	177
Q8BK03	PF10265	31	567	6.160927374301673	536	G5ASC7	32	568	6.112245810055871	536
Q8C9H6	PF07923	57	331	14.18881090909091	274	G5BH86	53	326	12.066237226277368	273
Q8C9H6	PF11882	512	634	8.217130081300809	122	G5BH86	507	629	8.226056910569106	122
Q8C9H6	PF11882	635	792	4.053348101265821	157	G5BH86	630	787	4.039588607594937	157
Q9ERK0	PF00069	56	280	5.718253333333332	224	G5BK30	5	229	5.7254088888888885	224
Q9ERK0	PF12796	414	502	0.14106741573033715	88	G5BK30	363	451	0.1772808988764044	88
Q9ERK0	PF12796	504	566	0.0	62	G5BK30	453	515	0.0	62
Q9ERK0	PF12796	630	699	0.5449142857142857	69	G5BK30	579	648	0.0	69
Q9ERK0	PF12796	705	765	0.0	60	G5BK30	654	714	0.0	60
Q9ERK0	PF13637	573	625	0.13890566037735852	52	G5BK30	522	574	0.1699811320754717	52
Q9D8W7	PF07051	32	115	7.939869047619048	83	G5B8C9	14	97	10.751702380952379	83
O35972	PF00276	37	106	0.6071142857142857	69	G5C2F5	38	107	0.6113857142857143	69
Q5SS80	PF00106	37	233	6.4858426395939075	196	G5BVJ0	38	234	5.5670507614213225	196
Q9DAA6	PF10447	94	134	2.2212926829268294	40	G5C0C4	95	135	2.2613902439024387	40
Q9DAA6	PF14382	7	40	1.3756176470588235	33	G5C0C4	8	41	1.3202941176470593	33
Q9D1R9	PF01199	0	95	3.353895833333333	95	G5AQL2	1	96	3.3551041666666666	95
Q9WVE0	PF18772	5	170	9.84498192771084	165	G5BPM7	59	211	7.959143790849673	152
Q8BHL8	PF08577	176	247	0.014583333333333334	71	G5AJQ9	177	248	0.0	71
Q8BHL8	PF11566	11	147	3.2285620437956224	136	G5AJQ9	12	148	3.3051313868613144	136
Q3UWM4	PF02373	268	368	6.397772277227718	100	G5B564	218	318	6.38315841584158	100
Q3UWM4	PF17811	372	475	6.205990384615385	103	G5B564	322	425	5.95375	103
Q99P30	PF00293	40	154	5.408034782608698	114	G5BE16	32	146	3.5975739130434774	114
Q8K419	PF00337	17	148	4.599356060606064	131	G5AMA6	18	149	7.904499999999992	131
Q8K419	PF00337	196	324	0.6332868217054264	128	G5AMA6	186	315	0.1944846153846153	129
Q6ZWS8	PF00651	192	295	3.821576923076924	103	G5C4P5	193	296	3.821576923076924	103
Q6ZWS8	PF00917	64	160	9.007051546391752	96	G5C4P5	65	161	9.008546391752576	96
Q05AA6	PF00397	356	382	0.0	26	G5C2S3	359	385	0.0	26
Q05AA6	PF00435	110	178	0.18021739130434786	68	G5C2S3	111	179	3.2934492753623186	68
Q05AA6	PF00435	232	336	0.031180952380952382	104	G5C2S3	235	339	0.025714285714285717	104
Q05AA6	PF00569	604	644	0.0753170731707317	40	G5C2S3	607	647	0.07500000000000001	40
Q05AA6	PF09068	386	503	3.3773898305084753	117	G5C2S3	389	506	3.5278135593220354	117
Q05AA6	PF09069	508	597	7.607111111111112	89	G5C2S3	511	600	9.006477777777778	89
Q9EQI8	PF11788	42	138	0.2632164948453608	96	G5CA79	45	143	0.37101010101010107	98
Q8BWD8	PF00069	68	334	10.36071535580524	266	G5ARK3	19	311	9.117389078498297	292
Q8C7G5	PF01442	52	255	0.3151568627450981	203	G5BQH2	57	260	0.07080392156862746	203
Q60662	PF05716	294	513	1.4287	219	G5BXQ5	284	499	3.0389675925925923	215
Q60662	PF05716	526	726	5.950497512437805	200	G5BXQ5	511	712	3.1246138613861416	201
Q60662	PF05716	749	848	2.764809999999999	99	G5BXQ5	738	837	2.6051818181818183	99
Q60662	PF10522	214	232	7.400894736842106	18	G5BXQ5	202	219	5.4318333333333335	17
Q9JJF3	PF08007	176	488	2.309942492012776	312	G5C1P3	201	513	3.0088019169329057	312
P35492	PF00221	120	584	2.580348387096777	464	G5C0S9	121	585	2.772468817204302	464
P35492	PF12053	12	78	1.9601791044776116	66	G5C0S9	13	79	7.428388059701492	66
Q9D2Y4	PF07714	265	445	4.779552486187843	180	G5B5W9	168	342	5.445085714285714	174
P58064	PF01250	29	94	2.6937575757575765	65	G5AM24	1	66	2.7307272727272727	65
Q61805	PF01273	37	208	2.460273255813953	171	G5B813	38	210	2.9838208092485536	172
Q61805	PF02886	241	477	11.30591561181435	236	G5B813	243	479	9.295957805907172	236
Q8VCC8	PF00027	267	346	9.802475	79	G5BWD0	477	556	9.766762499999997	79
Q8VCC8	PF00610	115	183	1.6323623188405796	68	G5BWD0	325	393	1.620478260869565	68
Q8VCC8	PF00617	667	837	4.594614035087718	170	G5BWD0	854	1042	4.140941798941803	188
Q8VCC8	PF00618	387	494	5.211064814814813	107	G5BWD0	597	721	5.152695999999999	124
Q9CQA3	PF13085	43	148	0.2898584905660377	105	G5BZN6	40	145	0.2917924528301888	105
Q9CQA3	PF13534	186	259	0.09470270270270267	73	G5BZN6	182	255	0.08591891891891892	73
Q9CXF4	PF00566	332	467	4.6341985294117665	135	G5BSX6	334	468	4.685051851851854	134
Q9CXF4	PF12068	9	207	7.560231155778893	198	G5BSX6	11	209	7.121924623115581	198
Q9R1K9	PF13499	30	92	3.810000000000001	62	G5C715	30	92	4.42179365079365	62
Q9R1K9	PF13499	103	166	0.0	63	G5C715	103	166	0.0	63
Q61670	PF00046	275	329	0.5325454545454544	54	G5AQS5	127	181	0.5474727272727272	54
Q8BSN9	PF06743	410	477	0.05013235294117647	67	G5AX03	410	477	1.8639117647058816	67
Q8BSN9	PF08368	491	580	11.658188888888883	89	G5AX03	491	580	18.244022222222217	89
Q8BSN9	PF08373	594	649	0.7421607142857143	55	G5AX03	594	648	0.5186727272727272	54
Q05BC3	PF00400	260	307	0.7572291666666665	47	G5B4A9	256	303	0.7553541666666668	47
Q05BC3	PF00400	537	569	0.3731818181818181	32	G5B4A9	533	565	0.3916969696969697	32
Q05BC3	PF00400	630	651	11.91531818181818	21	G5B4A9	626	647	12.419136363636365	21
Q05BC3	PF00400	663	697	1.0888571428571427	34	G5B4A9	659	693	1.2422571428571427	34
Q05BC3	PF00400	774	810	0.0	36	G5B4A9	770	806	0.0	36
Q05BC3	PF03451	183	257	16.898519999999998	74	G5B4A9	179	253	17.150413333333336	74
Q8BTW9	PF00069	327	573	9.293757085020236	246	G5AM93	325	571	8.469983805668015	246
Q8BTW9	PF00786	9	62	0.0199074074074074	53	G5AM93	10	63	0.02	53
Q923D2	PF13460	9	190	11.03697802197802	181	G5C9X6	10	200	10.693900523560206	190
Q9CXT6	PF13621	192	412	3.462846153846155	220	G5BAL0	179	405	2.16968281938326	226
Q9WTJ6	PF03638	334	369	0.0	35	G5BTU9	138	173	0.0	35
P70288	PF00850	28	317	2.8430310344827583	289	G5BUR4	31	289	3.1755250965250954	258
Q9QXW0	PF12937	105	153	17.31602040816327	48	G5C5S9	112	170	7.97335593220339	58
P70444	PF06393	2	191	6.93392105263158	189	G5BWN8	3	193	6.411392670157067	190
Q8K2I9	PF12937	209	248	9.571875000000002	39	G5BP97	163	202	4.23505	39
Q8K2I9	PF13245	455	679	3.69224	224	G5BP97	378	602	3.6965733333333333	224
Q8K2I9	PF13361	867	932	11.487515151515153	65	G5BP97	790	855	11.116030303030305	65
Q9CR16	PF00160	22	181	2.9019874999999997	159	G5AXY0	23	182	2.1206000000000005	159
Q9CR16	PF13176	225	251	0.0	26	G5AXY0	226	252	0.0	26
Q9Z148	PF00856	1101	1207	0.2287476635514019	106	G5C3G9	1168	1274	0.2277009345794392	106
Q9Z148	PF05033	979	1082	0.0	103	G5C3G9	1046	1149	0.0	103
Q9Z148	PF12796	707	792	6.9215813953488405	85	G5C3G9	756	840	6.9534117647058835	84
Q9Z148	PF12796	800	867	2.4613235294117644	67	G5C3G9	849	934	2.129372093023255	85
Q9Z148	PF12796	872	932	8.776704918032786	60	G5C3G9	939	999	8.88481967213115	60
Q8JZU0	PF00293	200	305	5.921745283018866	105	G5C7G0	201	306	5.238009433962263	105
Q8JZU0	PF09296	48	161	5.044964912280701	113	G5C7G0	49	162	2.449640350877193	113
Q8JZU0	PF09297	165	194	0.0364	29	G5C7G0	166	195	0.10716666666666666	29
Q6PCX9	PF00643	89	131	9.11246511627907	42	G5AXY7	90	132	9.110813953488373	42
Q6PCX9	PF00917	286	398	6.040663716814157	112	G5AXY7	270	382	6.050867256637166	112
Q3UH06	PF00096	96	118	0.0	22	G5BAT0	97	119	0.0	22
Q3UH06	PF00096	124	146	0.0	22	G5BAT0	125	147	0.0	22
Q3UH06	PF00096	1252	1272	0.0	20	G5BAT0	1230	1250	0.0	20
Q3UH06	PF00096	1547	1569	0.0	22	G5BAT0	1568	1590	0.0	22
Q3UH06	PF13909	668	692	0.0912	24	G5BAT0	668	692	0.09079999999999996	24
Q3UH06	PF13912	312	335	0.7889166666666667	23	G5BAT0	315	338	0.0	23
Q3UH06	PF13912	1520	1541	0.0	21	G5BAT0	1541	1562	0.0	21
A2ABU4	PF00041	375	459	0.9328235294117646	84	G5BHX6	377	461	5.100435294117646	84
A2ABU4	PF00041	502	587	2.2021162790697684	85	G5BHX6	505	590	3.0321046511627903	85
A2ABU4	PF00041	603	686	6.521107142857143	83	G5BHX6	606	689	9.41447619047619	83
A2ABU4	PF00041	702	787	4.015209302325581	85	G5BHX6	705	790	3.963895348837209	85
A2ABU4	PF00041	805	889	0.1519294117647059	84	G5BHX6	808	892	0.2566117647058824	84
A2ABU4	PF07679	155	244	9.6056	89	G5BHX6	157	246	0.18813333333333326	89
A2ABU4	PF07679	271	360	4.059488888888889	89	G5BHX6	273	362	4.672377777777778	89
A2ABU4	PF07679	1341	1425	7.659505882352941	84	G5BHX6	1363	1447	8.012258823529411	84
Q80W49	PF00030	361	398	7.4393157894736825	37	G5BXD3	380	417	7.427447368421053	37
Q80W49	PF00030	439	481	0.20576744186046514	42	G5BXD3	458	500	0.4242093023255814	42
Q80W49	PF00030	512	596	7.137858823529411	84	G5BXD3	531	615	7.195047058823527	84
Q80W49	PF00030	606	688	4.7440000000000015	82	G5BXD3	625	706	5.115597560975613	81
Q80W49	PF00030	704	779	8.460171052631576	75	G5BXD3	722	796	3.2083200000000005	74
Q80W49	PF00030	788	867	5.079675000000002	79	G5BXD3	805	884	5.042624999999998	79
Q80W49	PF00652	873	999	0.8313385826771652	126	G5BXD3	890	1016	0.8214645669291338	126
O70374	PF07531	106	194	8.984157303370788	88	G5BPU8	87	187	7.916564356435642	100
O70374	PF01753	497	533	0.0	36	G5BPU8	490	526	0.0	36
O70374	PF08788	321	387	0.0	66	G5BPU8	314	380	0.0	66
D3Z7P3	PF04960	248	534	6.311581881533098	286	G5BGK6	121	407	6.325780487804879	286
D3Z7P3	PF17959	143	226	9.106178571428572	83	G5BGK6	17	99	9.31421686746988	82
D3Z7P3	PF12796	561	650	10.577844444444443	89	G5BGK6	434	523	7.505111111111113	89
Q9CYI0	PF15053	37	389	5.396470254957509	352	G5BVM0	38	393	5.487441011235952	355
Q8BT14	PF00076	129	186	4.203810344827587	57	G5BS13	130	187	4.213568965517239	57
Q8BT14	PF14570	13	59	0.0	46	G5BS13	14	60	0.0	46
Q8BG60	PF00339	9	152	3.6286805555555546	143	G5BBN4	10	152	3.6251188811188815	142
Q8BG60	PF02752	175	298	6.450709677419353	123	G5BBN4	175	298	5.207862903225808	123
Q80TY4	PF01530	364	390	0.0	26	G5BKS8	337	363	0.0	26
Q80TY4	PF01530	408	436	0.0	28	G5BKS8	381	409	0.0	28
Q80TY4	PF01530	720	748	0.0	28	G5BKS8	693	721	0.0	28
Q80TY4	PF01530	764	792	0.0	28	G5BKS8	737	765	0.0	28
Q80TY4	PF01530	812	840	0.0	28	G5BKS8	785	813	0.0	28
Q80TY4	PF01530	866	892	0.8633703703703703	26	G5BKS8	839	865	0.8642592592592594	26
Q80TY4	PF08474	478	711	2.3421111111111106	233	G5BKS8	451	683	2.9153948497854065	232
Q08509	PF00018	537	579	0.0	42	G5BV42	457	499	0.0	42
Q08509	PF08416	63	121	7.547203389830506	58	G5BV42	66	125	6.9787500000000025	59
Q08509	PF18016	717	776	0.7194500000000005	59	G5BV42	637	696	0.7346166666666666	59
Q9ESG9	PF00069	100	347	4.117270161290322	247	G5B1J6	165	412	4.492758064516129	247
Q9CQN7	PF09809	12	124	0.0	112	G5BG00	13	125	0.0	112
Q9DAK2	PF10274	53	188	1.476073529411765	135	G5B0X7	70	204	1.866081481481482	134
Q8BP47	PF00152	236	551	2.2505569620253167	315	G5BCD2	226	541	3.3315506329113913	315
Q8BP47	PF01336	138	217	9.25655	79	G5BCD2	128	207	14.586112500000004	79
Q3UIR3	PF13923	568	606	0.15920512820512828	38	G5AV78	556	594	0.0	38
Q3UIR3	PF18102	614	746	1.0322030075187971	132	G5AV78	602	734	5.415270676691729	132
Q9WTK8	PF03533	1	43	0.5182325581395348	42	G5AUN1	2	44	0.4876976744186047	42
Q9WTK8	PF04406	108	169	1.7620322580645158	61	G5AUN1	109	170	1.6194193548387097	61
Q9WV89	PF00397	501	530	0.025333333333333333	29	G5BPA2	486	515	0.4081666666666666	29
Q9WV89	PF00595	26	92	0.1958059701492537	66	G5BPA2	12	78	0.4143283582089552	66
Q9D3N2	PF00036	69	94	0.7584615384615384	25	G5BHT0	70	95	3.716307692307692	25
Q9D3N2	PF13499	102	175	0.12924324324324327	73	G5BHT0	103	177	0.1246	74
P13707	PF01210	4	171	6.154559523809523	167	G5AU03	5	172	5.984654761904767	167
P13707	PF07479	193	338	4.778246575342464	145	G5AU03	194	339	4.782047945205479	145
P58929	PF01342	89	161	0.009726027397260271	72	G5C8C6	90	162	0.009726027397260271	72
Q059U7	PF19031	309	419	6.436477477477476	110	G5AKY2	313	423	10.856837837837837	110
Q059U7	PF19032	517	635	11.071504201680677	118	G5AKY2	521	639	10.418529411764704	118
Q059U7	PF19033	795	935	7.005971631205674	140	G5AKY2	803	943	8.334567375886527	140
P42227	PF02865	1	118	1.0103898305084744	117	G5B0J9	2	119	1.011661016949152	117
P42227	PF00017	583	673	10.037241758241755	90	G5B0J9	589	679	9.47826373626374	90
P42227	PF01017	140	311	0.07216860465116279	171	G5B0J9	141	317	0.11527118644067795	176
P42227	PF02864	325	463	2.2528705035971224	138	G5B0J9	331	469	2.7694244604316545	138
Q6YGZ1	PF03662	150	361	6.737462264150943	211	G5AT15	144	355	5.52829716981132	211
Q9QXM1	PF15871	225	572	2.9207528735632198	347	G5AST9	133	480	2.919500000000001	347
Q8K1A6	PF00168	653	755	1.94004854368932	102	G5BYU4	660	762	1.0227864077669906	102
O09130	PF11976	341	409	4.8731884057971016	68	G5BRB1	350	418	4.88	68
Q8C9W3	PF00090	566	615	0.0	49	G5C7B9	505	554	0.0	49
Q8C9W3	PF01421	297	470	5.2319310344827565	173	G5C7B9	236	409	4.350557471264366	173
Q8C9W3	PF01562	182	210	0.03913793103448275	28	G5C7B9	1	29	0.03931034482758621	28
Q8C9W3	PF05986	723	837	5.441408695652175	114	G5C7B9	662	773	6.206312499999997	111
Q8C9W3	PF17771	482	551	0.2647714285714285	69	G5C7B9	421	490	0.2691000000000001	69
Q8C9W3	PF19030	858	913	0.0	55	G5C7B9	794	849	0.02848214285714285	55
Q8C9W3	PF19030	918	975	0.07343103448275863	57	G5C7B9	854	911	0.05453448275862069	57
Q8C9W3	PF19030	979	1028	0.0	49	G5C7B9	915	964	0.0	49
Q8R555	PF07593	458	512	0.7882727272727273	54	G5BE37	450	504	0.7879999999999999	54
Q8R555	PF07645	559	605	0.3998297872340426	46	G5BE37	551	597	0.015446808510638297	46
Q8R555	PF13517	62	131	3.866971428571431	69	G5BE37	54	123	6.2326142857142885	69
Q8R555	PF13517	299	362	1.36640625	63	G5BE37	291	354	1.658734375	63
P31360	PF00046	356	412	1.5301228070175443	56	G5AY38	145	201	1.5768245614035088	56
P31360	PF00157	268	337	1.0129142857142854	69	G5AY38	57	126	1.0484714285714292	69
O88809	PF03607	70	130	8.280311475409835	60	G5AMR0	140	200	7.130393442622952	60
O88809	PF03607	197	239	0.0	42	G5AMR0	267	308	0.0	41
Q8BFY9	PF03810	43	108	9.437409090909087	65	G5B204	54	119	9.437393939393935	65
Q8BFY9	PF13513	418	471	10.324203703703708	53	G5B204	429	482	10.309777777777782	53
Q6DID3	PF00076	478	543	2.8453636363636368	65	G5BQ77	454	519	2.33489393939394	65
Q6DID3	PF04818	25	130	0.958481132075471	105	G5BQ77	1	106	0.9562924528301888	105
O88816	PF00583	44	170	7.6914251968504015	126	G5AQU7	47	173	6.969692913385823	126
Q8CI32	PF02179	22	83	0.20251612903225796	61	G5AWH2	175	235	0.532049180327869	60
Q8CI32	PF02179	204	256	3.875830188679246	52	G5AWH2	1	53	1.3584905660377362	52
Q8CI32	PF02179	278	347	6.546971428571428	69	G5AWH2	75	144	0.08918571428571427	69
Q8CI32	PF02179	376	439	0.5478593749999999	63	G5AWH2	173	236	0.5071093750000001	63
Q8R124	PF00651	34	139	17.374858490566034	105	G5BJF1	35	140	10.445792452830187	105
Q8R124	PF01344	331	381	19.634098039215687	50	G5BJF1	333	383	19.69449019607843	50
Q8R124	PF01344	390	427	5.209868421052631	37	G5BJF1	392	429	4.9019736842105255	37
Q8R124	PF01344	483	529	0.038936170212765964	46	G5BJF1	485	531	0.3260212765957447	46
Q8R124	PF01344	536	576	7.178902439024394	40	G5BJF1	538	577	7.291256410256407	39
Q8R124	PF07707	147	247	1.9118811881188118	100	G5BJF1	148	248	0.7612475247524754	100
O54974	PF00337	31	133	2.2547378640776694	102	G5AMA8	5	107	5.049281553398057	102
Q9CQ18	PF08615	28	158	3.3216412213740467	130	G5B6J3	29	157	5.878992248062018	128
Q9WVH9	PF07645	41	68	0.0	27	G5ASH3	106	133	0.0	27
Q9WVH9	PF07645	126	163	0.15526315789473685	37	G5ASH3	191	228	0.155	37
Q9WVH9	PF12662	186	209	0.0	23	G5ASH3	251	274	0.0	23
Q9WVH9	PF12662	267	290	0.311875	23	G5ASH3	332	355	0.2958333333333333	23
Q9R207	PF00498	23	99	4.756142857142857	76	G5BBN9	106	182	5.7442987012987015	76
Q9R207	PF08599	680	727	0.0	47	G5BBN9	714	760	0.0	46
Q9R207	PF16508	216	324	9.120633027522931	108	G5BBN9	299	407	9.870614678899079	108
Q64732	PF00250	11	97	3.02648275862069	86	G5AWC3	12	98	3.02648275862069	86
Q8CJ67	PF00035	8	69	0.2307903225806451	61	G5B5T5	9	70	0.16590322580645164	61
Q8CJ67	PF00035	142	178	17.21872972972973	36	G5B5T5	143	179	17.212432432432436	36
Q8CJ67	PF00035	209	271	3.1372539682539684	62	G5B5T5	210	272	6.337952380952381	62
Q8CJ67	PF00035	307	372	1.3693030303030298	65	G5B5T5	308	373	1.4171969696969695	65
Q8CJ67	PF16482	458	511	0.00948148148148148	53	G5B5T5	459	511	0.0	52
Q9EPX5	PF12937	5	48	0.3669772727272727	43	G5B354	6	49	0.7024772727272727	43
Q64237	PF01082	217	342	3.4740079365079364	125	G5B8I2	217	342	2.9992063492063497	125
Q64237	PF03351	62	173	3.404991071428572	111	G5B8I2	62	173	7.076910714285711	111
Q64237	PF03712	363	519	4.585777070063691	156	G5B8I2	363	519	5.885394904458604	156
Q8K3W3	PF09405	140	244	1.3724571428571428	104	G5BRV7	67	171	1.3713047619047618	104
O70479	PF02214	29	119	5.821285714285714	90	G5BVN5	30	120	5.828219780219783	90
Q3UHC0	PF10427	811	935	0.01584	124	G5AVE1	1130	1255	0.0653968253968254	125
Q3UHC0	PF12938	1022	1247	0.07448230088495575	225	G5AVE1	1334	1561	0.060460526315789485	227
Q3UHC0	PF16608	1257	1433	0.0	176	G5AVE1	1571	1747	0.0	176
Q3UHC0	PF16608	1434	1511	0.0021923076923076926	77	G5AVE1	1748	1825	0.008115384615384616	77
Q8R1G2	PF01738	30	243	11.486500000000007	213	G5B709	31	244	9.347663551401856	213
Q8CHC4	PF02383	59	339	5.339135231316732	280	G5BE96	68	348	5.213046263345199	280
Q8CHC4	PF03372	537	858	5.097661490683227	321	G5BE96	546	867	5.091720496894409	321
Q8CHC4	PF08952	866	1005	9.065885714285713	139	G5BE96	875	1014	7.118621428571429	139
Q8BJD1	PF00092	294	454	14.076304347826081	160	G5ARR2	295	455	12.295819875776393	160
Q8BJD1	PF06668	715	907	8.429000000000002	192	G5ARR2	716	908	7.643450777202071	192
Q8BJD1	PF08487	51	158	7.6495000000000015	107	G5ARR2	52	159	10.810925925925927	107
Q99ML2	PF07714	117	374	5.299306201550389	257	G5B5B5	118	375	7.3489961240310135	257
P23463	PF00046	195	251	0.11026315789473684	56	G5BU18	62	118	0.16210526315789475	56
Q9JK84	PF00564	18	96	1.5770506329113927	78	G5AKB0	19	97	1.579544303797468	78
Q9JK84	PF00595	166	237	1.3424166666666664	71	G5AKB0	167	238	1.344666666666667	71
Q9QYY0	PF00169	24	114	5.880395604395603	90	G5BRR4	1	91	5.87632967032967	90
Q03160	PF00017	433	514	5.149353658536584	81	G5BRX6	446	527	4.17359756097561	81
Q03160	PF00169	229	336	4.963111111111111	107	G5BRX6	246	349	1.9153173076923082	103
Q03160	PF00788	101	182	0.04274390243902439	81	G5BRX6	118	199	0.01628048780487805	81
Q03160	PF08947	367	414	0.052083333333333336	47	G5BRX6	380	427	0.0515625	47
Q99KG3	PF00076	131	189	1.7252881355932204	58	G5AZF8	127	185	1.704118644067797	58
Q99KG3	PF00641	214	240	0.0	26	G5AZF8	210	236	0.0	26
Q99KG3	PF01585	858	901	0.0	43	G5AZF8	865	908	0.0	43
Q99KG3	PF17780	567	617	0.20852941176470588	50	G5AZF8	574	624	0.2087254901960784	50
Q91WK7	PF13857	127	181	1.552563636363636	54	G5AYR7	61	115	1.5486	54
Q70KY4	PF00250	89	170	0.1713292682926829	81	G5AQJ5	90	171	0.060804878048780486	81
Q70KY4	PF16675	362	388	0.05685185185185185	26	G5AQJ5	362	387	0.0	25
Q70KY4	PF16676	497	536	0.0	39	G5AQJ5	495	534	0.0	39
Q9D1E4	PF10631	0	140	0.006808510638297872	140	G5BFY8	1	144	0.008958333333333334	143
Q4VA44	PF00096	2	24	0.0	22	G5AWU3	3	25	0.0	22
Q4VA44	PF00096	58	80	0.0	22	G5AWU3	59	81	0.0	22
Q4VA44	PF00096	86	108	0.0	22	G5AWU3	87	109	0.0	22
Q4VA44	PF00096	114	136	0.0	22	G5AWU3	115	137	0.0	22
Q4VA44	PF00096	142	164	0.0	22	G5AWU3	143	165	0.0	22
Q4VA44	PF00096	170	192	0.0	22	G5AWU3	171	193	0.0	22
Q4VA44	PF00096	198	220	0.0	22	G5AWU3	199	221	0.0	22
Q4VA44	PF00096	226	248	0.0	22	G5AWU3	227	249	0.0	22
Q8R1W8	PF01390	238	315	2.4069487179487177	77	G5AL57	87	157	5.047929577464789	70
Q8R1W8	PF01390	579	667	4.0620112359550555	88	G5AL57	425	513	1.8933258426966293	88
Q69ZR2	PF00632	2238	2616	2.1576490765171497	378	G5CAM0	2234	2608	2.1549093333333333	374
Q69ZR2	PF06701	1281	1339	0.0	58	G5CAM0	1277	1335	0.0	58
Q69ZR2	PF07738	1114	1243	2.1938846153846168	129	G5CAM0	1110	1239	2.078661538461537	129
Q69ZR2	PF12796	400	480	4.478197530864199	80	G5CAM0	400	480	4.4604691358024695	80
Q69ZR2	PF18410	1896	1963	5.876147058823527	67	G5CAM0	1892	1959	5.870985294117648	67
Q8BW00	PF01195	21	192	1.1614360465116276	171	G5BLG8	38	207	1.9542352941176468	169
Q02591	PF00046	160	216	0.1783157894736842	56	G5B489	55	111	0.18610526315789472	56
Q8CD60	PF15252	51	278	0.16421929824561404	227	G5BRF4	52	269	0.4110504587155962	217
Q56A08	PF00467	243	272	12.914766666666665	29	G5BJJ7	241	270	15.391933333333332	29
Q56A08	PF12656	154	208	0.4843454545454547	54	G5BJJ7	152	205	0.45003703703703707	53
Q91YL2	PF13639	229	271	0.0	42	G5C5W6	286	338	0.0	52
Q91YL2	PF14369	25	39	0.0	14	G5C5W6	82	96	0.0	14
P62818	PF01023	4	45	12.343523809523811	41	G5BEQ8	21	62	16.416785714285712	41
E9Q2M9	PF00400	2975	3008	32.60194117647057	33	G5B0W4	2949	2982	34.342147058823514	33
E9Q2M9	PF00400	3053	3098	0.8493913043478262	45	G5B0W4	3027	3072	0.6202173913043478	45
E9Q2M9	PF02138	2537	2818	5.023460992907799	281	G5B0W4	2512	2793	4.4150460992907785	281
E9Q2M9	PF14844	2446	2504	8.079644067796611	58	G5B0W4	2421	2479	9.76306779661017	58
Q8CIK8	PF13639	287	331	0.0	44	G5B5W8	370	414	0.11386666666666664	44
Q9CZT6	PF14617	102	258	5.2283057324840785	156	G5BUU8	59	217	5.280572327044026	158
Q0VBB0	PF04707	29	171	1.0130349650349646	142	G5BR35	1	156	4.775967948717951	155
Q9JM96	PF00786	25	69	0.05488888888888888	44	G5B5M7	26	69	0.0	43
Q9JM96	PF14957	109	217	0.4693302752293578	108	G5B5M7	112	227	0.3769396551724137	115
Q8R1P4	PF03987	70	203	6.829097014925375	133	G5AT26	2	135	5.698985074626867	133
Q9DA17	PF14994	19	271	0.6610988142292491	252	G5BH70	19	270	0.8147063492063494	251
E9Q309	PF01302	2485	2549	10.049107692307693	64	G5AYL8	2291	2355	9.123384615384618	64
E9Q309	PF14309	2943	3075	0.4285939849624058	132	G5AYL8	2753	2885	1.6817368421052634	132
Q8BX37	PF00149	134	336	3.1401724137931035	202	G5AM94	131	332	3.219118811881188	201
Q8BX37	PF14008	361	422	0.014435483870967743	61	G5AM94	357	418	0.01435483870967742	61
Q8BX37	PF16656	31	123	0.9954838709677416	92	G5AM94	28	119	1.7543913043478263	91
B9EJV3	PF15782	0	1130	5.086522546419094	1130	G5BTS1	1	1130	4.734008849557521	1129
Q6AXC6	PF06733	228	411	0.7319728260869567	183	G5B7J1	281	440	2.8966812499999994	159
Q6AXC6	PF13307	689	877	7.799566137566138	188	G5B7J1	718	927	7.476919047619044	209
Q8C7E9	PF00076	17	87	5.686183098591548	70	G5CAC2	18	88	5.676183098591549	70
Q8C7E9	PF14304	587	627	11.827390243902444	40	G5CAC2	598	638	11.827560975609753	40
Q8C7E9	PF14327	112	190	3.2743924050632915	78	G5CAC2	113	191	3.274050632911393	78
Q8VIG6	PF13639	6	49	2.157272727272727	43	G5BZX6	7	50	2.1282727272727278	43
Q9Z179	PF13229	429	566	4.519021739130435	137	G5C3N7	507	643	5.918620437956204	136
Q9D0J4	PF00025	3	174	6.6800348837209285	171	G5B6M8	4	175	6.685965116279073	171
Q8VCG4	PF00061	47	183	9.176664233576645	136	G5BEI6	48	188	10.214368794326246	140
Q9CR56	PF00071	5	168	9.031908536585366	163	G5B0L0	6	169	9.05357926829268	163
Q80TP3	PF00632	2493	2790	5.198335570469799	297	G5C0H1	2476	2773	5.257134228187919	297
Q80TP3	PF00658	2385	2442	8.233241379310346	57	G5C0H1	2368	2425	8.24048275862069	57
Q80TP3	PF11547	178	229	0.32334615384615384	51	G5C0H1	159	210	0.3237307692307692	51
P62046	PF00307	591	684	0.3431808510638298	93	G5C1E9	613	705	2.093032258064516	92
P62046	PF13855	92	144	0.3772264150943397	52	G5C1E9	102	154	3.7540377358490566	52
P62046	PF13855	156	212	0.1985964912280702	56	G5C1E9	166	222	0.19596491228070176	56
Q2PFD7	PF01369	570	723	1.150071428571428	153	G5ARF2	562	716	1.487058064516129	154
P49135	PF04851	315	470	3.003320512820513	155	G5B9U9	284	439	3.1363205128205123	155
P49135	PF13625	75	200	9.42996031746032	125	G5B9U9	76	170	8.51405263157895	94
P49135	PF16203	496	736	6.0626846473029055	240	G5B9U9	465	705	6.065925311203316	240
Q9R013	PF00112	249	458	5.111433333333336	209	G5BWY7	270	479	3.2849904761904782	209
Q9R013	PF08246	164	221	0.5457758620689654	57	G5BWY7	185	242	0.39084482758620703	57
E9Q2Z1	PF00439	424	502	1.8526329113924047	78	G5BWN4	408	486	1.5640632911392407	78
Q8BH50	PF15303	24	237	0.0	213	G5BL83	25	238	0.0	213
Q8C0V9	PF00373	122	233	9.699285714285724	111	G5BLN8	123	234	9.35535714285713	111
Q8C0V9	PF09379	19	81	10.433492063492066	62	G5BLN8	20	82	8.44806349206349	62
Q8C0V9	PF09380	243	328	0.9268023255813956	85	G5BLN8	244	329	0.8198023255813949	85
Q8VC66	PF11559	62	213	3.649631578947368	151	G5C925	63	214	3.6798749999999982	151
P0C8B4	PF15387	2	95	0.5235851063829788	93	G5B2X8	3	98	0.00671875	95
B9EJ57	PF02536	57	370	6.022872611464968	313	G5C9K5	95	408	5.646452229299363	313
P55302	PF06400	23	132	0.4140909090909091	109	G5BLK2	2	111	0.11033636363636362	109
P55302	PF06401	148	359	0.05231603773584905	211	G5BLK2	128	339	0.030644549763033182	211
P22389	PF00322	41	68	5.009500000000001	27	G5AQJ4	45	72	3.3389285714285712	27
Q9CUN6	PF00168	18	100	1.7183855421686745	82	G5AX86	85	167	1.647433734939759	82
Q9CUN6	PF00397	235	264	2.0846333333333336	29	G5AX86	302	331	2.091266666666667	29
Q9CUN6	PF00397	281	310	0.0306	29	G5AX86	348	377	0.0308	29
Q9CUN6	PF00632	422	729	4.477240259740261	307	G5AX86	489	794	4.216650326797383	305
Q9JHI5	PF00441	271	417	5.3958367346938765	146	G5BLY9	267	413	5.331680272108844	146
Q9JHI5	PF02770	161	258	11.045367346938775	97	G5BLY9	157	254	11.398795918367348	97
Q9JHI5	PF02771	43	157	0.421513043478261	114	G5BLY9	46	153	0.4502685185185185	107
Q99JT2	PF00069	23	273	3.0267011952191227	250	G5AJW2	75	306	1.3429913793103458	231
Q8CIG8	PF05185	296	463	3.616130952380951	167	G5ASJ6	297	464	3.612827380952383	167
Q8CIG8	PF17285	36	289	2.2250590551181118	253	G5ASJ6	37	290	2.9690511811023623	253
Q8CIG8	PF17286	466	634	0.37062721893491135	168	G5ASJ6	467	635	0.24107100591715944	168
Q5SV66	PF13863	43	160	0.1934237288135593	117	G5B5G4	44	161	0.06794915254237288	117
Q80U95	PF00632	779	1082	3.4159078947368435	303	G5C8S0	769	1059	5.235655172413789	290
Q9ERL9	PF00211	471	642	6.9526162790697725	171	G5BLV3	472	643	7.580686046511634	171
Q9ERL9	PF07701	276	346	2.8537746478873234	70	G5BLV3	277	346	2.6888714285714292	69
Q9ERL9	PF07701	357	465	8.860385321100912	108	G5BLV3	358	466	8.784623853211007	108
P43241	PF00046	186	241	0.03357142857142857	55	G5ATU8	188	243	0.031875	55
P43241	PF04731	12	173	0.05098148148148148	161	G5ATU8	13	174	0.054567901234567916	161
Q8BR27	PF13889	479	535	2.9942631578947365	56	G5BXC3	480	536	2.5767894736842107	56
Q8BR27	PF13915	347	400	8.064592592592591	53	G5BXC3	348	401	8.07461111111111	53
A6H6E2	PF00386	828	939	10.724196428571432	111	G5ATF5	681	792	7.017866071428574	111
A6H6E2	PF07546	55	126	11.14286111111111	71	G5ATF5	56	127	3.3414305555555566	71
P42586	PF00046	128	184	0.4288596491228069	56	G5CBC3	129	185	0.4288596491228069	56
P97352	PF01023	8	50	20.38997674418605	42	G5BER1	9	51	19.291860465116283	42
Q8BTM9	PF00130	540	591	1.6925769230769232	51	G5AMB4	593	644	1.6417115384615384	51
Q8BTM9	PF00617	203	377	1.9710514285714285	174	G5AMB4	210	384	1.7205028571428582	174
Q8K285	PF00611	14	85	0.7631666666666664	71	G5B4E4	6	77	0.1897638888888889	71
Q8K285	PF10291	610	870	2.177819923371647	260	G5B4E4	588	848	2.6871417624521077	260
P61406	PF10373	749	1102	7.362545197740107	353	G5BCU3	753	1106	7.814471751412432	353
P61406	PF10374	637	741	2.1845047619047633	104	G5BCU3	641	745	2.18164761904762	104
P61406	PF13638	1246	1406	2.454	160	G5BCU3	1250	1410	2.4281366459627334	160
Q9WU78	PF03097	3	377	3.7925759999999977	374	G5BIU2	63	405	3.639816326530614	342
Q9WU78	PF13949	412	700	2.227802768166093	288	G5BIU2	440	728	1.7537681660899664	288
Q2UY11	PF00092	47	223	13.180734463276831	176	G5BRY6	48	224	10.710903954802255	176
Q2UY11	PF00092	798	972	9.93808	174	G5BRY6	802	976	8.939828571428574	174
Q2UY11	PF01391	533	587	0.0	54	G5BRY6	534	588	0.0	54
Q8C147	PF06920	1536	2058	2.074395793499044	522	G5BXE0	1520	2041	2.148429118773945	521
Q8C147	PF11878	56	164	1.6436330275229356	108	G5BXE0	41	149	1.8108899082568808	108
Q8C147	PF14429	556	738	3.9486830601092886	182	G5BXE0	540	722	3.919404371584697	182
Q8CFB4	PF02263	20	279	10.231207692307693	259	G5BGF1	67	325	11.26190347490348	258
Q8CFB4	PF02841	282	548	2.4399588014981277	266	G5BGF1	328	593	1.63903007518797	265
P17439	PF02055	96	387	2.7194452054794507	291	G5BDF5	108	399	4.047560137457044	291
Q9DCT5	PF02815	32	125	0.01670212765957447	93	G5BVH9	33	126	0.01670212765957447	93
P97471	PF03165	36	136	1.2634851485148508	100	G5BVT2	37	137	1.2633267326732671	100
P97471	PF03166	319	528	3.484809523809524	209	G5BVT2	321	530	3.4841714285714285	209
Q9D7F7	PF03357	24	191	0.0	167	G5BAK1	25	192	0.0	167
P15375	PF00010	93	144	0.35401923076923075	51	G5BH16	94	145	1.6215961538461534	51
P15375	PF01586	2	92	5.791274725274726	90	G5BH16	3	93	5.793043956043955	90
Q9CYQ5	PF15226	1	115	0.0	114	G5B1J2	2	137	0.031389705882352945	135
Q9QZN4	PF04300	69	247	5.162854748603352	178	G5C512	101	279	2.2338324022346367	178
Q9QZN4	PF12937	3	50	2.5460625	47	G5C512	35	81	2.7748936170212763	46
Q9JLV2	PF12463	406	712	4.313065146579803	306	G5C6I9	407	720	4.449506369426753	313
Q9DCU9	PF00701	28	311	4.6893697183098615	283	G5C0B9	35	318	5.819753521126763	283
Q8VC52	PF00076	26	87	15.546548387096774	61	G5AN77	5	66	15.485338709677418	61
P0C5K0	PF00069	42	277	4.848677966101691	235	G5BVY6	43	277	3.3289744680851068	234
Q8K214	PF00536	594	659	0.8825303030303031	65	G5AQJ6	596	661	0.8779242424242425	65
Q8K214	PF02820	61	128	6.2606764705882325	67	G5AQJ6	62	129	6.2475441176470605	67
Q8K214	PF02820	170	235	3.34110606060606	65	G5AQJ6	171	236	3.327772727272728	65
Q8K214	PF12140	356	464	8.298155963302754	108	G5AQJ6	358	466	8.0357247706422	108
Q8K214	PF17208	269	319	0.0	50	G5AQJ6	271	320	0.0	49
P60904	PF00226	15	76	0.07448387096774194	61	G5C8B4	16	77	0.0644516129032258	61
Q6BCL1	PF14603	582	662	0.02703703703703703	80	G5B4L6	533	612	0.027625	79
Q91ZJ9	PF01630	53	382	5.543045454545457	329	G5BZZ2	40	369	4.195869696969697	329
A1L3C1	PF12480	97	156	7.628733333333334	59	G5B8S7	86	144	7.860593220338986	58
Q8VC31	PF15266	203	370	0.0	167	G5AV08	204	371	0.0	167
Q9CWY3	PF00856	73	285	5.9174835680751166	212	G5AUH0	87	299	6.325394366197183	212
Q9CWY3	PF09273	336	464	2.8247209302325578	128	G5AUH0	350	478	2.7404961240310075	128
Q9CR09	PF08694	6	159	0.17534415584415586	153	G5BWI5	7	160	0.12092207792207793	153
Q8CIG3	PF01593	404	822	3.758217183770885	418	G5AXT9	403	823	4.440133016627078	420
Q8CIG3	PF04433	298	368	16.156690140845065	70	G5AXT9	298	368	16.26607042253521	70
Q8CIG3	PF07496	137	189	0.056698113207547175	52	G5AXT9	138	189	0.04721153846153848	51
Q80Y98	PF00536	393	439	9.860234042553186	46	G5B0A7	394	440	4.502170212765957	46
Q80Y98	PF02825	42	111	4.826028571428573	69	G5B0A7	43	112	4.9202	69
Q80Y98	PF02862	483	686	6.581053921568627	203	G5B0A7	496	705	6.379547619047616	209
Q5SPW0	PF07928	736	865	15.146146153846159	129	G5C8M5	737	866	15.170361538461545	129
Q5SPW0	PF10475	206	354	0.8805637583892618	148	G5C8M5	207	355	0.9053758389261748	148
Q91ZJ5	PF01704	55	472	2.0151004784689	417	G5C8M4	45	462	2.4653660287081345	417
Q9R0L7	PF04988	414	549	0.04857352941176472	135	G5BYP6	454	589	0.048654411764705884	135
Q9DA19	PF10197	12	48	0.0	36	G5C938	13	49	0.0	36
Q8BHK9	PF00176	115	335	6.446375565610861	220	G5BGW3	59	278	8.181172727272726	219
Q8BHK9	PF00271	466	576	11.451648648648643	110	G5BGW3	409	519	8.528342342342341	110
P46638	PF00071	12	172	9.789894409937887	160	G5B4L9	13	173	9.593167701863353	160
Q9D2D9	PF01344	20	65	1.8473478260869565	45	G5BZV7	21	66	3.2824347826086955	45
Q9D2D9	PF01344	67	113	10.633765957446807	46	G5BZV7	68	114	10.632021276595744	46
Q9D2D9	PF01344	163	208	0.40745652173913055	45	G5BZV7	164	209	0.4231521739130435	45
Q9D2D9	PF01344	270	315	2.7638043478260874	45	G5BZV7	271	316	1.175239130434783	45
Q9D174	PF05030	13	70	12.3215	57	G5ALX8	14	71	12.319810344827586	57
Q8BYZ1	PF07815	96	157	3.2491774193548384	61	G5C4N8	89	149	0.4141147540983605	60
Q8BYZ1	PF14604	316	363	4.868333333333334	47	G5C4N8	292	338	4.760085106382979	46
Q920G9	PF00651	96	191	12.434885416666665	95	G5C6W1	58	152	7.898263157894736	94
Q920G9	PF07707	223	280	2.7158620689655173	57	G5C6W1	187	244	2.746637931034482	57
Q8BTG3	PF05794	77	501	6.288880000000003	424	G5AN91	73	497	5.89206823529412	424
Q8K0T4	PF00004	241	377	3.610058394160584	136	G5B269	245	381	3.5866934306569336	136
Q8K0T4	PF09336	446	485	0.0	39	G5B269	450	489	0.0	39
Q8K0T4	PF17862	399	436	0.0	37	G5B269	403	440	0.0	37
Q62356	PF07648	51	95	0.0	44	G5AU91	53	97	0.0	44
Q62356	PF09289	28	49	0.2128181818181818	21	G5AU91	30	51	0.1471818181818182	21
Q60929	PF00319	18	56	14.744102564102556	38	G5ARY4	149	187	20.148538461538454	38
Q60929	PF12347	96	150	0.05705454545454545	54	G5ARY4	239	339	0.05536633663366338	100
A6H694	PF13855	435	491	8.927929824561406	56	G5C1E7	377	432	16.06244642857143	55
Q8C4P0	PF12012	532	682	4.547668874172186	150	G5BWR6	520	668	3.11013422818792	148
Q32Q92	PF04775	77	140	0.4308906250000001	63	G5C1P1	1	66	0.989121212121212	65
Q32Q92	PF08840	202	408	6.810082125603866	206	G5C1P1	132	340	4.777837320574162	208
Q8CJF9	PF02170	246	365	0.3476916666666667	119	G5C6F2	248	368	0.3968099173553719	120
Q8CJF9	PF02171	517	817	7.244013289036538	300	G5C6F2	520	820	6.912053156146174	300
Q8CJF9	PF08699	176	226	6.318627450980396	50	G5C6F2	178	228	6.3115490196078445	50
Q8CJF9	PF16486	27	166	0.26760714285714304	139	G5C6F2	29	168	0.2693428571428571	139
Q8CJF9	PF16487	429	510	5.679939024390245	81	G5C6F2	432	513	5.6772439024390255	81
Q8CJF9	PF16488	374	420	0.0	46	G5C6F2	377	423	0.0	46
Q80TE0	PF08620	371	436	0.964469696969697	65	G5BM17	355	420	0.4835757575757577	65
Q80TE0	PF08621	224	266	8.492488372093021	42	G5BM17	225	266	2.2257380952380954	41
Q9WVL4	PF00069	192	442	7.765996015936254	250	G5AVV0	193	443	8.632219123505982	250
Q9WVL4	PF00615	57	173	2.653059829059829	116	G5AVV0	58	174	0.4279145299145299	116
O08918	PF00134	21	152	13.084196969696968	131	G5BJP9	22	153	12.9283106060606	131
O08609	PF00010	129	187	1.7850338983050846	58	G5B0J4	118	176	1.7808813559322034	58
Q9D1H8	PF10780	19	70	0.21130769230769214	51	G5AXF4	20	71	0.7598846153846153	51
Q9ERS5	PF00169	9	111	7.761786407766992	102	G5B0B3	7	109	7.726990291262137	102
Q9ERS5	PF00169	199	295	4.122958762886595	96	G5B0B3	197	293	3.8691649484536086	96
A2ACJ2	PF15146	447	878	2.8333449074074064	431	G5BJ65	300	737	2.262070938215104	437
P20029	PF00012	30	635	0.7720841584158419	605	G5B6V7	30	635	0.7646072607260731	605
Q99M74	PF00038	116	427	1.1264775641025648	311	G5B3P7	116	427	0.9214583333333334	311
Q99M74	PF16208	67	113	0.0	46	G5B3P7	67	113	0.0	46
Q8K245	PF10186	274	457	7.681000000000003	183	G5BEL5	1	184	7.870951086956521	183
Q05A36	PF00013	243	286	10.96968181818182	43	G5BVT3	9	52	10.98434090909091	43
Q05A36	PF00013	320	380	7.50695081967213	60	G5BVT3	86	146	7.529606557377051	60
Q05A36	PF13920	597	645	1.940489795918368	48	G5BVT3	363	411	1.9648775510204084	48
Q9R0B7	PF12874	73	94	4.732954545454545	21	G5BPZ9	98	118	14.978380952380952	20
Q9R0B7	PF12874	134	157	0.0	23	G5BPZ9	167	190	0.0	23
Q9R0B7	PF12874	185	208	0.029166666666666667	23	G5BPZ9	218	241	0.02316666666666667	23
Q9R0B7	PF12874	240	262	1.979434782608696	22	G5BPZ9	273	295	1.9667391304347823	22
Q8BHN9	PF15045	188	267	0.099425	79	G5AWJ2	207	286	6.886762499999998	79
Q8QZR8	PF00134	36	137	10.691892156862744	101	G5B4X1	1	102	12.061019607843145	101
Q920A7	PF00004	336	467	4.867174242424241	131	G5APH0	277	408	5.451295454545455	131
Q920A7	PF01434	553	734	3.136648351648351	181	G5APH0	494	672	3.1259497206703872	178
Q920A7	PF06480	147	231	18.063176470588232	84	G5APH0	65	172	14.827333333333339	107
Q920A7	PF17862	499	537	1.8914358974358976	38	G5APH0	440	478	1.9097692307692309	38
Q8CHZ8	PF15760	27	207	0.09367403314917128	180	G5BKP5	28	220	0.08890155440414513	192
Q9CPX5	PF04970	120	235	3.0624568965517227	115	G5AYK2	54	170	2.2673846153846147	116
E9Q3T6	PF00856	293	355	6.944619047619049	62	G5BGR3	297	359	5.8235873015873	62
E9Q3T6	PF00096	452	472	0.0	20	G5BGR3	458	478	0.0	20
E9Q3T6	PF00096	478	500	0.0	22	G5BGR3	484	506	0.0	22
Q8BHG1	PF00675	211	324	2.405061403508771	113	G5AUH5	128	240	3.5473008849557512	112
Q8BHG1	PF05193	483	556	11.589527027027025	73	G5AUH5	294	367	12.242148648648643	73
Q8BHG1	PF05193	849	1028	4.024733333333333	179	G5AUH5	660	838	4.512418994413408	178
Q8BHG1	PF16187	563	844	6.627170212765959	281	G5AUH5	374	655	6.2489184397163084	281
Q791N7	PF01096	82	117	11.029805555555555	35	G5AKF2	85	119	4.098264705882353	34
Q80YC5	PF00008	97	128	0.0	31	G5BQ09	99	130	0.07781249999999999	31
Q80YC5	PF00008	177	205	0.06055172413793102	28	G5BQ09	179	207	0.0	28
Q80YC5	PF00039	134	169	0.0	35	G5BQ09	136	171	0.0	35
Q80YC5	PF00040	46	87	0.03266666666666666	41	G5BQ09	48	89	0.017619047619047618	41
Q80YC5	PF00051	216	294	6.274000000000001	78	G5BQ09	218	296	5.423848101265823	78
Q80YC5	PF00089	354	590	6.430320675105486	236	G5BQ09	373	612	6.802604166666666	239
O08791	PF01833	262	344	18.84007228915662	82	G5BTI3	282	364	19.737204819277114	82
O08791	PF16422	96	246	5.577847682119205	150	G5BTI3	125	275	5.5662052980132435	150
O08791	PF16423	347	390	1.7285909090909093	43	G5BTI3	367	410	0.06454545454545453	43
O54839	PF00907	270	457	3.3400638297872343	187	G5BNZ7	263	450	3.3455904255319147	187
O54839	PF16176	483	704	1.4003873873873875	221	G5BNZ7	476	697	0.8801846846846847	221
A4Q9F0	PF03133	89	380	3.5802431506849333	291	G5C933	87	378	3.5064246575342444	291
O35906	PF00178	174	255	12.973487804878047	81	G5B8S6	171	252	10.2885243902439	81
Q9CYT6	PF01213	5	63	0.06866101694915254	58	G5AXT3	6	64	0.0	58
Q9CYT6	PF08603	320	472	3.5959738562091514	152	G5AXT3	321	473	3.781477124183007	152
Q8C5T4	PF02493	37	55	0.0	18	G5AWN4	38	56	0.0	18
Q8C5T4	PF02493	61	78	0.0	17	G5AWN4	62	78	0.09576470588235296	16
Q8C5T4	PF02493	113	134	0.0	21	G5AWN4	114	135	0.0	21
Q8C5T4	PF02493	136	158	0.0	22	G5AWN4	137	159	0.0	22
Q8C5T4	PF02493	159	174	0.0	15	G5AWN4	160	175	0.0	15
Q3UHX9	PF02598	74	364	4.607130584192442	290	G5ASD6	75	365	4.682463917525774	290
A2AWA9	PF00566	564	766	18.561857142857136	202	G5B6X3	570	772	18.565039408866987	202
A2AWA9	PF00640	184	263	4.4154125	79	G5B6X3	190	269	4.416812500000002	79
A2AWA9	PF12473	301	430	9.402946153846157	129	G5B6X3	307	436	11.174515384615386	129
Q9QYJ3	PF00226	3	64	0.027177419354838712	61	G5BYS4	4	65	0.027177419354838712	61
Q9QYJ3	PF01556	163	322	3.6212812499999982	159	G5BYS4	164	323	3.6213624999999987	159
P11859	PF00079	102	472	7.632075471698116	370	G5BQI5	103	473	6.547223719676555	370
Q9D1I5	PF13669	50	161	5.6839821428571415	111	G5B6I2	39	150	5.709241071428571	111
O08529	PF00648	76	341	2.9501917293233086	265	G5C191	104	342	3.3755606694560703	238
O08529	PF01067	362	501	3.944385714285717	139	G5C191	363	498	4.151279411764708	135
O08529	PF13833	544	601	9.01944827586207	57	G5C191	541	598	9.021827586206898	57
Q8C5L3	PF04153	397	520	9.291056451612906	123	G5BSZ0	398	521	9.291056451612906	123
P86793	PF00048	29	89	0.17070491803278692	60	G5B067	30	90	0.1733606557377049	60
Q9Z1Z0	PF04869	346	627	13.409542553191493	281	G5B1B6	288	532	11.569277551020392	244
Q9Z1Z0	PF04871	825	939	3.957226086956522	114	G5B1B6	698	811	3.8355964912280696	113
Q9Z1Z0	PF18770	269	325	2.9095789473684213	56	G5B1B6	220	275	7.614035714285714	55
Q9QYH6	PF01454	474	639	11.317668674698794	165	G5B3S9	549	714	11.30676506024097	165
Q9WVC6	PF00069	97	354	7.97905426356589	257	G5AS59	193	453	7.557888888888888	260
Q9WVC6	PF00433	375	422	6.219520833333332	47	G5AS59	474	521	6.056375000000003	47
Q8VDC1	PF01363	1131	1187	4.397929824561404	56	G5ANN7	1140	1196	4.507228070175438	56
Q8VDC1	PF02759	58	164	0.6762710280373834	106	G5ANN7	93	199	0.29557009345794405	106
Q6DIA9	PF00646	21	65	22.12313333333333	44	G5AM95	25	69	22.43111111111111	44
Q6DIA9	PF04300	101	274	4.446908045977009	173	G5AM95	105	278	0.5321206896551721	173
Q8BKK4	PF05395	1	92	1.7808695652173914	91	G5BIQ6	2	101	1.62782	99
Q99MB7	PF13920	151	194	0.0	43	G5BFH1	152	195	0.0	43
P70662	PF17916	335	363	0.393103448275862	28	G5CAG6	330	358	0.388448275862069	28
P70662	PF01803	68	218	4.586642384105959	150	G5CAG6	65	215	4.5866225165562895	150
P70662	PF01803	219	270	6.749903846153847	51	G5CAG6	216	267	6.7527884615384615	51
Q5U5Q9	PF18282	71	127	2.8522456140350867	56	G5BPZ8	70	126	2.8663508771929824	56
P11862	PF00307	35	156	4.0582131147541	121	G5AR30	35	156	4.059081967213117	121
P11862	PF02187	202	271	2.445157142857143	69	G5AR30	202	271	2.4457714285714287	69
Q9CR83	PF00076	26	97	1.4044166666666666	71	G5AJL7	27	98	1.3926805555555557	71
O35904	PF00454	772	988	7.9856820276497675	216	G5C538	797	1013	7.842764976958525	216
O35904	PF00613	512	680	7.774875739644965	168	G5C538	536	705	7.194941176470591	169
O35904	PF00792	338	446	9.231660550458717	108	G5C538	304	411	10.390240740740738	107
O35904	PF00794	183	260	0.7282820512820509	77	G5C538	184	260	0.8418831168831171	76
O35904	PF02192	32	106	4.357906666666667	74	G5C538	33	107	4.425213333333334	74
B1AUC7	PF00620	223	377	13.45128387096774	154	G5BC50	223	399	11.957785310734463	176
P55258	PF00071	9	169	8.343242236024848	160	G5C2V3	10	170	7.822888198757763	160
P35505	PF01557	123	411	2.0592006920415216	288	G5BEY2	124	412	2.459771626297579	288
P35505	PF09298	14	117	0.8821826923076921	103	G5BEY2	15	118	0.8677596153846158	103
P99028	PF02320	25	81	0.0	56	G5AX55	28	83	0.0	55
Q8K382	PF02141	93	272	9.193511111111107	179	G5B6X0	66	245	9.152783333333332	179
Q8K382	PF03455	336	387	0.0	51	G5B6X0	309	360	0.0	51
Q8K382	PF03456	30	87	7.407086206896553	57	G5B6X0	3	60	7.407724137931035	57
Q9CWZ7	PF14938	9	253	0.457730612244898	244	G5C069	10	254	0.447330612244898	244
Q9D3R6	PF00004	290	421	6.14673484848485	131	G5C614	272	403	6.1259924242424235	131
Q9D3R6	PF08513	26	52	25.415925925925933	26	G5C614	9	35	25.451259259259267	26
Q9D3R6	PF17862	456	491	6.504027777777778	35	G5C614	438	473	0.8191111111111111	35
Q9WUV0	PF13191	8	154	9.52144897959184	146	G5BI45	9	155	9.302979591836733	146
Q9WUV0	PF14630	177	421	18.405200000000004	244	G5BI45	178	421	18.49832510288067	243
P17182	PF00113	142	429	0.581517361111111	287	G5C546	143	430	0.627496527777778	287
P17182	PF03952	2	133	2.299825757575757	131	G5C546	3	134	2.294818181818181	131
A7RDN6	PF01593	104	233	6.2285692307692315	129	G5BT06	104	232	4.7817421875	128
A7RDN6	PF13450	5	79	6.6994533333333335	74	G5BT06	6	79	9.167864864864868	73
Q8R4I1	PF08313	318	379	0.0	61	G5C228	172	233	0.0	61
P61922	PF00202	65	495	5.210454756380514	430	G5BSD0	43	473	5.176533642691417	430
Q91W34	PF04884	68	299	13.569327586206901	231	G5BYB7	72	302	16.695770562770562	230
Q99LF4	PF01139	67	504	0.5812694063926945	437	G5BPE1	68	505	0.5825995423340966	437
Q01514	PF02263	18	278	13.308839080459773	260	G5BGF6	19	279	11.432846743295018	260
Q01514	PF02841	281	553	2.2010439560439568	272	G5BGF6	282	553	3.1697380073800723	271
P31245	PF00046	139	195	0.3026315789473684	56	G5BD50	120	176	0.3026315789473684	56
Q8C3J5	PF00018	13	60	1.7843333333333338	47	G5B465	14	61	1.4741458333333333	47
Q8C3J5	PF06920	1117	1612	4.2630483870967755	495	G5B465	1209	1704	4.095522177419354	495
Q8C3J5	PF14429	418	614	6.899781725888325	196	G5B465	419	615	7.787796954314723	196
Q8C3J5	PF16172	72	413	5.719307017543862	341	G5B465	73	414	5.4614941520467815	341
E9Q5Z5	PF11107	0	334	3.217065671641792	334	G5AR29	1	342	6.092467836257305	341
O54910	PF12796	126	213	7.7726931818181875	87	G5BNP0	104	191	3.1678295454545435	87
O54910	PF12796	237	325	3.215595505617977	88	G5BNP0	215	303	3.0055842696629216	88
Q3UEG6	PF00202	86	503	5.1030430622009595	417	G5BQ90	87	504	4.1815406698564574	417
Q7TQI7	PF00023	608	632	18.27856	24	G5AXV2	369	393	18.27012	24
Q7TQI7	PF00651	836	944	10.733853211009178	108	G5AXV2	598	706	8.024642201834865	108
Q7TQI7	PF12796	514	593	10.8660875	79	G5AXV2	275	354	10.847262500000005	79
O35954	PF02121	0	248	0.2439116465863455	248	G5BSA0	1	249	0.23817269076305225	248
O35954	PF02862	684	813	4.585530769230769	129	G5BSA0	686	815	4.5708538461538515	129
O35954	PF02862	820	877	10.424448275862071	57	G5BSA0	822	879	10.483827586206896	57
Q9CZJ9	PF00226	81	142	2.9541129032258064	61	G5AZ74	267	328	3.5445	61
Q9CZJ9	PF09320	248	348	0.4328613861386138	100	G5AZ74	435	535	0.24736633663366345	100
Q9D8C6	PF10280	7	108	0.5286176470588236	101	G5BWB0	8	109	0.7373627450980393	101
Q9CT10	PF00638	313	421	2.156798165137615	108	G5C0P4	382	490	2.1571651376146788	108
Q6P4S8	PF12432	351	431	1.4306172839506168	80	G5BUG2	350	430	0.8532345679012349	80
Q08874	PF00010	311	364	0.0	53	G5AVQ1	311	364	0.0	53
Q08874	PF11851	396	510	0.0587391304347826	114	G5AVQ1	396	509	0.007543859649122806	113
Q08874	PF15951	55	193	0.1302230215827338	138	G5AVQ1	55	193	0.13066187050359715	138
Q8BYC6	PF00069	25	276	2.3609285714285715	251	G5AKT8	26	277	2.323789682539683	251
Q9CXE6	PF08423	77	340	0.9229848484848486	263	G5AWH5	78	344	1.3752097378277155	266
P97477	PF00069	125	373	3.5238554216867466	248	G5AW12	132	380	3.5257510040160622	248
P51612	PF03835	493	617	2.6895520000000013	124	G5ANS4	437	561	2.6328240000000003	124
P51612	PF10403	624	673	0.8993599999999998	49	G5ANS4	568	617	0.9015799999999999	49
P51612	PF10404	677	736	0.0	59	G5ANS4	621	680	0.0	59
P51612	PF10405	743	815	4.657643835616439	72	G5ANS4	687	758	4.310791666666668	71
Q8C6K9	PF00092	25	180	6.712756410256411	155	G5AM64	28	183	7.132653846153848	155
Q8C6K9	PF00092	227	395	7.54821301775148	168	G5AM64	230	398	7.966763313609469	168
Q8C6K9	PF00092	434	603	4.291905882352939	169	G5AM64	437	606	6.053029411764705	169
Q8C6K9	PF00092	620	787	14.09070238095238	167	G5AM64	623	790	14.020607142857141	167
Q8C6K9	PF00092	807	978	13.952406976744175	171	G5AM64	810	981	15.193622093023247	171
Q8C6K9	PF00092	998	1166	8.332242603550295	168	G5AM64	1001	1169	8.078023668639053	168
Q8C6K9	PF00092	1756	1901	10.190321917808216	145	G5AM64	1741	1886	7.164479452054795	145
Q8C6K9	PF00092	1965	2140	7.2008125000000005	175	G5AM64	1950	2125	8.634181818181819	175
Q8C6K9	PF01391	1390	1448	0.0	58	G5AM64	1393	1450	0.0	57
Q61656	PF00270	117	287	3.9365847953216377	170	G5BVF2	118	288	3.936362573099416	170
Q61656	PF00271	326	434	6.310055045871562	108	G5BVF2	327	435	6.3097889908256874	108
Q61656	PF08061	497	531	0.0	34	G5BVF2	498	532	0.0	34
Q61656	PF08061	550	582	0.13418181818181818	32	G5BVF2	552	584	0.10063636363636363	32
Q9CQR2	PF01249	0	78	0.0	78	G5C8F1	1	79	0.013354430379746835	78
Q7TPV4	PF04931	69	834	7.355318537859013	765	G5B921	80	849	7.532433766233777	769
Q9QXK2	PF02037	247	280	1.4048235294117648	33	G5BX95	233	266	1.0813235294117645	33
Q9QXK2	PF13923	23	62	9.8966	39	G5BX95	9	48	2.13315	39
Q99KK2	PF02348	43	282	4.9161791666666685	239	G5BEG5	66	305	4.5957874999999975	239
O08648	PF00069	1332	1588	5.288805447470816	256	G5BC52	1088	1344	5.262346303501944	256
Q9DC04	PF00595	18	90	7.136054794520549	72	G5B200	223	295	8.125602739726027	72
Q9DC04	PF00615	840	954	3.6401304347826113	114	G5B200	993	1107	4.4097217391304335	114
Q9CWH4	PF15165	19	253	4.2479063829787265	234	G5BRF1	21	259	4.6297322175732205	238
Q62141	PF02671	53	96	4.240636363636362	43	G5C2W5	21	64	4.231909090909091	43
Q62141	PF02671	172	226	0.512	54	G5C2W5	141	195	0.5091818181818182	54
Q62141	PF02671	312	356	2.3333555555555567	44	G5C2W5	282	326	2.3330444444444445	44
Q62141	PF08295	385	480	0.05276041666666666	95	G5C2W5	355	479	0.15284	124
Q62141	PF16879	711	1010	6.133533333333335	299	G5C2W5	734	1032	5.571220735785952	298
Q6PHS9	PF00092	293	459	5.779526946107785	166	G5BZT2	239	405	5.769970059880242	166
Q6PHS9	PF08399	143	267	2.977616	124	G5BZT2	79	202	2.9934758064516114	123
Q6PHS9	PF08473	672	1046	6.825805333333332	374	G5BZT2	611	984	6.632281501340481	373
P28700	PF00104	308	446	6.479064748201437	138	G5B8I7	458	596	6.43271942446043	138
P28700	PF00105	138	206	0.2060869565217391	68	G5B8I7	211	279	0.18121739130434786	68
P28700	PF11825	19	131	0.08946902654867256	112	G5B8I7	119	204	0.0	85
P63013	PF00046	94	150	0.7596315789473685	56	G5BUS3	17	73	0.7489824561403509	56
P63013	PF03826	218	234	0.0	16	G5BUS3	141	157	0.0	16
Q8BI99	PF00096	204	225	0.0	21	G5C7C0	164	185	0.0	21
Q8BI99	PF00096	231	253	0.0	22	G5C7C0	191	213	0.0	22
Q8BI99	PF00096	259	281	2.256	22	G5C7C0	219	241	2.2732173913043483	22
Q8BI99	PF00096	287	309	0.0	22	G5C7C0	247	269	0.0	22
Q8BI99	PF00096	315	337	0.0	22	G5C7C0	275	297	0.0	22
Q8BI99	PF00096	343	365	0.0	22	G5C7C0	303	325	0.0	22
Q8BI99	PF00096	371	393	0.04847826086956522	22	G5C7C0	331	353	1.3854782608695653	22
Q8BI99	PF00096	399	421	0.0	22	G5C7C0	359	381	0.0	22
Q8BI99	PF00096	455	477	0.0	22	G5C7C0	415	437	0.0	22
Q8BI99	PF00096	483	505	0.0	22	G5C7C0	443	465	0.0	22
Q8BI99	PF00096	511	533	0.0	22	G5C7C0	471	493	0.0	22
Q8BI99	PF00096	539	561	0.0	22	G5C7C0	499	521	0.0	22
Q8BI99	PF01352	42	53	27.15675	11	G5C7C0	1	12	15.217416666666667	11
Q9D924	PF01521	24	124	0.08734653465346534	100	G5ARL7	51	151	0.09577227722772276	100
Q05CL8	PF00076	120	181	5.4602419354838725	61	G5BMD7	123	184	5.4872741935483855	61
Q05CL8	PF05383	31	88	7.759758620689656	57	G5BMD7	34	91	7.763844827586206	57
Q05CL8	PF08777	441	539	4.552393939393941	98	G5BMD7	449	547	1.110030303030303	98
Q91ZU1	PF07525	369	407	0.7115128205128205	38	G5ASC1	321	359	2.369974358974359	38
Q91ZU1	PF13857	100	132	25.40072727272728	32	G5ASC1	76	107	23.5625	31
Q6WBX7	PF04139	13	270	9.8820503875969	257	G5AWM1	2	265	11.540530303030307	263
P62242	PF01201	0	189	2.3836210526315798	189	G5ARV4	1	190	2.3905473684210534	189
Q9QUM7	PF00488	587	774	17.34791489361702	187	G5C3G1	569	756	17.204749999999994	187
Q9QUM7	PF05190	396	494	4.399060606060608	98	G5C3G1	378	476	4.4049696969696965	98
Q9QUM7	PF05192	224	395	6.107523255813953	171	G5C3G1	206	377	3.8740697674418607	171
Q6P5E8	PF00130	84	102	0.0	18	G5BCK1	50	67	0.0	17
Q6P5E8	PF00130	179	228	0.8795999999999999	49	G5BCK1	145	194	0.8804000000000001	49
Q6P5E8	PF00609	733	884	2.5817302631578958	151	G5BCK1	645	796	2.5831381578947377	151
Q6P5E8	PF00781	627	685	5.6621016949152505	58	G5BCK1	539	597	5.154627118644067	58
Q6P5E8	PF00788	387	482	2.218583333333333	95	G5BCK1	357	452	2.586020833333333	95
Q05895	PF02412	491	526	0.0	35	G5BDF3	492	527	0.0	35
Q05895	PF02412	550	585	0.0	35	G5BDF3	551	586	0.0	35
Q05895	PF02412	586	608	0.0	22	G5BDF3	587	609	0.0	22
Q05895	PF02412	609	646	0.0	37	G5BDF3	610	647	0.0	37
Q05895	PF02412	648	686	0.0	38	G5BDF3	649	687	0.0	38
Q05895	PF02412	687	721	0.0	34	G5BDF3	688	722	0.0	34
Q05895	PF05735	740	937	4.545469696969696	197	G5BDF3	741	938	4.543358585858585	197
Q05895	PF07645	315	348	0.0	33	G5BDF3	316	349	0.0	33
Q05895	PF07645	369	410	0.0	41	G5BDF3	370	411	0.0	41
Q05895	PF11598	225	269	18.973066666666668	44	G5BDF3	226	270	18.96488888888889	44
Q08879	PF07645	233	261	0.0	28	G5BVB8	329	357	0.0	28
Q08879	PF07645	263	304	0.0	41	G5BVB8	359	400	0.0	41
Q08879	PF07645	309	355	0.0	46	G5BVB8	405	451	0.0	46
Q08879	PF07645	357	398	0.8044047619047621	41	G5BVB8	453	494	0.24940476190476196	41
Q08879	PF12662	422	445	0.0	23	G5BVB8	518	541	0.0	23
Q08879	PF12662	461	485	0.00976	24	G5BVB8	557	581	0.00484	24
Q08879	PF12662	505	529	0.0	24	G5BVB8	601	625	0.0	24
Q3KNL4	PF15092	0	73	1.0131756756756756	73	G5B0X1	1	73	0.9873424657534252	72
Q924H9	PF04408	441	511	1.8710281690140844	70	G5AXE8	444	514	6.391633802816902	70
Q8K4F5	PF12697	60	299	5.357879166666665	239	G5BG83	56	295	4.398254166666665	239
Q7TMF5	PF00079	51	410	5.192794444444445	359	G5B493	54	413	5.895902777777777	359
Q6PGE4	PF00096	340	361	0.0	21	G5BF47	775	796	0.0	21
Q6PGE4	PF00096	369	389	0.0	20	G5BF47	804	824	0.0	20
Q6PGE4	PF00096	395	417	0.0	22	G5BF47	830	852	0.0	22
Q6PGE4	PF00096	423	445	0.07608695652173911	22	G5BF47	858	880	0.05065217391304348	22
Q6PGE4	PF00096	451	473	0.0	22	G5BF47	886	908	0.0	22
Q6PGE4	PF00096	708	728	0.0	20	G5BF47	776	796	0.0	20
Q6PGE4	PF00096	736	756	0.08761904761904762	20	G5BF47	832	852	0.0	20
Q6PGE4	PF00096	762	784	0.0	22	G5BF47	830	852	0.0	22
Q6PGE4	PF00096	790	812	0.4864782608695652	22	G5BF47	858	880	0.05065217391304348	22
Q6PGE4	PF00096	851	868	0.0	17	G5BF47	1062	1079	0.0	17
Q6PGE4	PF00096	874	896	0.0	22	G5BF47	1085	1107	0.0	22
Q6PGE4	PF00096	902	924	0.38326086956521743	22	G5BF47	1113	1135	0.3789130434782609	22
Q6PGE4	PF00096	930	952	0.0	22	G5BF47	1141	1163	0.0	22
Q6PGE4	PF01352	152	193	10.855166666666667	41	G5BF47	586	627	10.81590476190476	41
Q9Z0H0	PF00069	51	199	5.0243154362416105	148	G5ASI5	58	206	1.8155436241610738	148
Q9Z0H0	PF00069	355	558	3.8391764705882365	203	G5ASI5	365	567	3.9796798029556655	202
Q9D009	PF03099	75	174	0.4683	99	G5AS90	76	175	0.35034999999999983	99
Q9CXC9	PF00178	368	447	8.975737500000003	79	G5BT95	374	453	8.761737499999999	79
Q9CXC9	PF04621	0	365	0.023426229508196724	365	G5BT95	1	371	0.040495956873315364	370
P11680	PF00090	76	127	0.11544230769230768	51	G5B0C5	78	129	0.0	51
P11680	PF00090	135	185	0.0	50	G5B0C5	137	187	0.0	50
P11680	PF00090	194	249	0.0	55	G5B0C5	196	251	0.0	55
P11680	PF00090	256	307	0.0	51	G5B0C5	258	309	0.0	51
P11680	PF00090	315	370	0.0	55	G5B0C5	317	373	0.0	56
P11680	PF00090	377	402	0.1578846153846154	25	G5B0C5	382	406	0.16572000000000006	24
P11680	PF18487	23	72	0.5877400000000003	49	G5B0C5	25	74	0.63188	49
Q8C042	PF00113	356	573	3.5819541284403664	217	G5ARG7	359	575	3.5334147465437797	216
Q6ZPU9	PF12309	243	599	3.3929495798319333	356	G5B804	194	549	3.6336797752808985	355
Q8BZ34	PF00096	277	299	0.0	22	G5BEP5	278	300	0.0	22
Q8BZ34	PF00096	306	327	0.0	21	G5BEP5	307	328	0.0	21
Q8BZ34	PF00096	355	377	0.0	22	G5BEP5	358	380	0.0	22
Q8BZ34	PF01352	93	134	5.8963809523809525	41	G5BEP5	94	135	5.711119047619048	41
Q3U2P1	PF00626	962	1035	12.206837837837837	73	G5BN17	629	702	15.22697297297297	73
Q3U2P1	PF04810	424	460	1.7332162162162164	36	G5BN17	91	127	3.991486486486487	36
Q3U2P1	PF04811	497	735	4.414050209205025	238	G5BN17	164	402	4.452234309623432	238
Q3U2P1	PF04815	835	935	8.545910891089111	100	G5BN17	502	602	13.93878217821782	100
Q3U2P1	PF08033	740	824	1.3673764705882352	84	G5BN17	407	491	1.408035294117647	84
Q9DBU2	PF00583	31	154	13.70985483870968	123	G5B1H4	32	155	13.682693548387086	123
Q61425	PF00725	237	312	0.0	75	G5AQL0	323	452	0.008584615384615385	129
Q61425	PF02737	40	213	2.250195402298851	173	G5AQL0	39	212	3.237494252873561	173
Q8R3N6	PF00531	571	650	4.3884875	79	G5BTS4	445	524	4.364062500000001	79
Q8R3N6	PF11957	172	537	3.8817295081967207	365	G5BTS4	85	411	4.152559633027523	326
Q9CR27	PF10152	29	166	3.6631231884057986	137	G5BIV5	30	166	2.215459854014598	136
Q99J83	PF04106	78	269	0.4427395833333333	191	G5BMN2	79	270	0.8743281249999996	191
Q3TY86	PF00355	70	153	0.832559523809524	83	G5C032	71	154	0.4022857142857143	83
Q3TY86	PF07992	195	492	5.198906040268455	297	G5C032	206	503	5.405976510067111	297
Q3TY86	PF14759	511	582	9.850111111111117	71	G5C032	522	593	9.302347222222222	71
O35493	PF00069	158	474	6.591053627760254	316	G5BCA9	159	475	6.599189274447946	316
P12246	PF00354	26	219	4.1183711340206175	193	G5BWM2	26	219	1.4964896907216492	193
O70468	PF07679	10	84	1.8485066666666663	74	G5BPC6	11	85	0.15962666666666667	74
O70468	PF07679	173	217	0.4002444444444444	44	G5BPC6	80	116	0.18554054054054053	36
O70468	PF07679	360	434	0.07744000000000001	74	G5BPC6	200	273	0.060932432432432425	73
O70468	PF07679	451	524	0.9787567567567568	73	G5BPC6	367	440	0.5392162162162162	73
O70468	PF07679	543	611	0.021956521739130437	68	G5BPC6	459	527	0.04204347826086957	68
O70468	PF07679	650	763	9.301622807017539	113	G5BPC6	566	681	9.25162931034483	115
O70468	PF07679	976	1057	12.082573170731711	81	G5BPC6	894	975	11.702841463414636	81
O70468	PF07679	1176	1265	1.4576	89	G5BPC6	1108	1197	5.717055555555558	89
O70468	PF00041	768	853	5.676790697674423	85	G5BPC6	686	771	6.904162790697675	85
O70468	PF00041	867	949	0.03024096385542168	82	G5BPC6	785	867	2.889120481927711	82
O70468	PF00041	1062	1142	5.78427160493827	80	G5BPC6	980	1073	1.7469255319148946	93
O70468	PF18362	315	337	0.0	22	G5BPC6	155	177	0.0	22
P54310	PF06350	6	313	2.9655616883116864	307	G5AZR9	139	443	4.386029508196721	304
P54310	PF07859	344	491	6.01472972972973	147	G5AZR9	475	622	6.067783783783787	147
P54310	PF07859	663	726	1.7693906250000004	63	G5AZR9	792	855	2.019078124999999	63
Q3U3N6	PF01417	38	130	8.546806451612905	92	G5BJ60	38	130	9.748344086021506	92
Q8C8U0	PF00536	604	666	0.2031587301587303	62	G5BLK5	651	713	3.6989047619047617	62
Q8C8U0	PF00536	679	738	2.511049999999999	59	G5BLK5	726	785	2.662033333333333	59
Q8C8U0	PF07647	763	831	0.8065072463768114	68	G5BLK5	810	878	0.9753768115942028	68
A2APF3	PF00096	312	335	0.5904166666666667	23	G5AUM8	321	344	0.5786250000000002	23
A2APF3	PF00096	427	450	0.2700416666666667	23	G5AUM8	436	459	0.341125	23
A2APF3	PF00096	547	565	0.0	18	G5AUM8	556	574	0.0	18
Q9CR92	PF13870	394	568	0.18284	174	G5B2Z7	359	533	0.09889142857142848	174
Q8C208	PF00096	186	208	0.0	22	G5BB92	187	209	0.0	22
Q8C208	PF00096	214	236	0.0	22	G5BB92	215	237	0.0	22
Q8C208	PF00096	247	270	0.0	23	G5BB92	248	271	0.0	23
Q9D9T8	PF06565	86	189	5.151480769230768	103	G5BC76	87	190	6.6260865384615375	103
Q9D9T8	PF06565	231	350	12.050225	119	G5BC76	232	351	9.781375	119
Q9D9T8	PF06565	410	510	15.365287128712867	100	G5BC76	410	510	15.277188118811884	100
Q8BIL5	PF05622	185	717	0.9457073170731708	532	G5APN6	127	657	0.9511676082862524	530
Q8BIL5	PF19047	42	162	2.900785123966941	120	G5APN6	1	104	3.239355769230769	103
Q14DK4	PF01553	190	289	9.03961	99	G5APT8	199	298	10.381600000000002	99
P60521	PF02991	12	115	19.037778846153852	103	G5B5Y4	2	105	19.034403846153843	103
Q05793	PF00008	3165	3193	0.3555862068965517	28	G5BI06	3960	3988	0.2341379310344828	28
Q05793	PF00008	3424	3454	0.0	30	G5BI06	4220	4250	0.0	30
Q05793	PF00052	594	728	4.020577777777777	134	G5BI06	615	749	2.6380222222222227	134
Q05793	PF00052	989	1123	1.3495851851851854	134	G5BI06	1010	1144	1.409829629629629	134
Q05793	PF00052	1395	1527	1.8678195488721816	132	G5BI06	1508	1640	3.4280075187969925	132
Q05793	PF00053	763	806	0.0	43	G5BI06	784	827	0.018977272727272728	43
Q05793	PF00053	813	868	0.0	55	G5BI06	834	889	0.0	55
Q05793	PF00053	1123	1148	0.0	25	G5BI06	1144	1169	0.0	25
Q05793	PF00053	1158	1205	0.0	47	G5BI06	1179	1226	0.0	47
Q05793	PF00053	1208	1262	0.0	54	G5BI06	1229	1283	0.0	54
Q05793	PF00053	1274	1321	0.0	47	G5BI06	1295	1342	0.14852083333333332	47
Q05793	PF00053	1528	1550	0.06895652173913044	22	G5BI06	1641	1663	0.06895652173913044	22
Q05793	PF00053	1562	1609	0.0	47	G5BI06	1675	1722	0.0	47
Q05793	PF00053	1612	1667	0.0	55	G5BI06	1725	1780	0.0	55
Q05793	PF00054	3012	3146	2.8080296296296297	134	G5BI06	3804	3941	2.7244347826086956	137
Q05793	PF00054	3275	3404	3.604769230769233	129	G5BI06	4071	4200	2.73036153846154	129
Q05793	PF00054	3550	3676	5.3320944881889725	126	G5BI06	4346	4473	3.588515625	127
Q05793	PF00057	198	233	0.0	35	G5BI06	218	253	0.0	35
Q05793	PF00057	284	318	0.0	34	G5BI06	305	339	0.0	34
Q05793	PF00057	323	358	0.0	35	G5BI06	344	379	0.0	35
Q05793	PF00057	367	402	0.0	35	G5BI06	388	423	0.0	35
Q05793	PF07679	405	485	3.6359259259259264	80	G5BI06	426	506	0.13687654320987655	80
Q05793	PF07679	1864	1948	0.0	84	G5BI06	1978	2062	0.05416470588235293	84
Q05793	PF07679	2150	2231	4.028085365853658	81	G5BI06	2942	3023	4.025768292682926	81
Q05793	PF07679	2252	2330	0.026253164556962024	78	G5BI06	3044	3122	6.681582278481012	78
Q05793	PF07679	2343	2429	5.547931034482759	86	G5BI06	3135	3221	5.696908045977012	86
Q05793	PF07679	2441	2522	0.01676829268292683	81	G5BI06	3233	3314	0.5623170731707319	81
Q05793	PF07679	2532	2615	0.6941190476190476	83	G5BI06	3324	3407	0.6324642857142857	83
Q05793	PF07679	2722	2803	0.3318170731707317	81	G5BI06	3514	3595	0.03697560975609756	81
Q05793	PF07679	2818	2892	6.391333333333334	74	G5BI06	3610	3684	8.292626666666667	74
Q05793	PF13927	1677	1748	3.206930555555556	71	G5BI06	1791	1862	3.8124444444444467	71
Q05793	PF13927	1774	1842	9.039811594202902	68	G5BI06	1888	1956	8.994376811594199	68
Q05793	PF13927	1954	2024	0.0	70	G5BI06	2743	2813	0.260774647887324	70
Q05793	PF13927	2053	2119	0.38073134328358205	66	G5BI06	2842	2908	0.0	66
Q05793	PF13927	2618	2689	0.5824444444444444	71	G5BI06	3410	3481	0.01527777777777778	71
Q05793	PF13927	2896	2965	0.09808571428571428	69	G5BI06	3688	3757	0.09605714285714284	69
Q62261	PF00435	302	410	8.484834862385316	108	G5B8V8	303	411	8.485779816513762	108
Q62261	PF00435	422	524	5.641019417475728	102	G5B8V8	423	525	5.641669902912621	102
Q62261	PF00435	529	635	1.6167009345794394	106	G5B8V8	530	636	1.604869158878505	106
Q62261	PF00435	638	741	0.9469326923076926	103	G5B8V8	639	742	0.8811538461538461	103
Q62261	PF00435	744	846	1.7701941747572814	102	G5B8V8	745	847	1.8575145631067957	102
Q62261	PF00435	849	951	0.6135242718446602	102	G5B8V8	850	952	0.6127669902912621	102
Q62261	PF00435	956	1059	0.4723269230769229	103	G5B8V8	957	1060	0.4264519230769229	103
Q62261	PF00435	1062	1165	0.2280961538461539	103	G5B8V8	1063	1166	0.22825000000000004	103
Q62261	PF00435	1169	1258	0.2094444444444445	89	G5B8V8	1170	1259	0.20961111111111114	89
Q62261	PF00435	1275	1375	0.1499009900990099	100	G5B8V8	1276	1376	0.15	100
Q62261	PF00435	1380	1481	0.4339901960784314	101	G5B8V8	1381	1473	0.010806451612903226	92
Q62261	PF00435	1485	1589	2.275047619047619	104	G5B8V8	1477	1581	2.9213904761904756	104
Q62261	PF00435	1591	1695	0.1520952380952381	104	G5B8V8	1583	1687	0.15219047619047618	104
Q62261	PF00435	1697	1800	0.030519230769230774	103	G5B8V8	1689	1790	0.029627450980392163	101
Q62261	PF00435	1804	1906	0.00766990291262136	102	G5B8V8	1794	1896	0.0	102
Q62261	PF00435	1913	2013	1.6899306930693068	100	G5B8V8	1903	2003	1.7268910891089102	100
Q62261	PF00435	2017	2096	0.0810875	79	G5B8V8	2007	2086	0.05665000000000001	79
Q62261	PF15410	2199	2300	3.034	101	G5B8V8	2190	2291	3.0407941176470583	101
Q62261	PF00307	54	157	10.137817307692305	103	G5B8V8	55	158	10.141855769230766	103
Q62261	PF00307	173	277	13.8398	104	G5B8V8	174	278	13.840704761904767	104
Q5STE3	PF13927	255	321	18.244238805970152	66	G5BN07	172	238	11.01553731343284	66
Q5STE3	PF13927	338	415	0.08564102564102566	77	G5BN07	255	332	0.08485897435897434	77
Q9WTZ8	PF04538	13	124	0.0	111	G5C3P8	14	123	0.053818181818181834	109
Q7TSJ6	PF00069	626	775	4.868840000000001	149	G5BKV1	481	630	4.906633333333332	149
Q7TSJ6	PF00069	823	930	6.101805555555552	107	G5BKV1	680	787	6.236277777777777	107
Q99N57	PF00130	138	185	0.15960416666666674	47	G5BJW2	139	186	0.15908333333333333	47
Q99N57	PF02196	56	127	0.1825	71	G5BJW2	57	128	0.18458333333333332	71
Q99N57	PF07714	350	604	7.061780392156862	254	G5BJW2	371	625	6.954098039215685	254
Q8C3F7	PF01344	366	407	0.1447142857142857	41	G5BHH3	130	171	0.12083333333333332	41
Q91VY5	PF02373	175	291	3.2228888888888902	116	G5C0R1	176	292	2.870213675213676	116
Q91VY5	PF02375	15	49	10.357714285714287	34	G5C0R1	16	50	10.40422857142857	34
Q91VY5	PF13831	741	776	0.021111111111111112	35	G5C0R1	720	754	0.06642857142857142	34
Q91VY5	PF13832	783	893	9.137261261261258	110	G5C0R1	762	872	5.593324324324322	110
Q91VY5	PF18104	909	943	0.9504571428571428	34	G5C0R1	888	922	4.084399999999999	34
Q91VY5	PF18104	967	1001	10.723714285714284	34	G5C0R1	946	980	0.19322857142857144	34
V9GXG1	PF04326	194	306	11.146584070796463	112	G5B752	203	315	10.115920353982304	112
Q99K48	PF00076	77	141	0.09463076923076924	64	G5BW26	76	140	0.0947384615384616	64
Q99K48	PF00076	151	211	7.362655737704919	60	G5BW26	150	210	7.36544262295082	60
Q99K48	PF08075	222	273	0.0	51	G5BW26	221	272	0.0	51
O88477	PF00013	197	261	2.0910461538461536	64	G5C4N4	198	262	2.0910461538461536	64
O88477	PF00013	279	343	0.10273846153846153	64	G5C4N4	280	343	0.10434375	63
O88477	PF00013	408	470	2.7912222222222214	62	G5C4N4	409	471	2.661555555555556	62
O88477	PF00013	489	553	0.03089230769230768	64	G5C4N4	490	554	0.032738461538461536	64
O88477	PF00076	3	67	0.6999846153846154	64	G5C4N4	4	68	0.6877076923076924	64
O88477	PF00076	84	149	2.302984848484848	65	G5C4N4	85	150	2.302984848484848	65
O35348	PF01391	94	152	0.0	58	G5BUL3	162	219	0.0	57
O35348	PF01391	214	247	0.0	33	G5BUL3	216	248	0.0	32
P04401	PF02025	24	131	0.3031203703703704	107	G5ASP7	26	133	4.746700934579442	107
Q8BHN0	PF00481	132	343	3.09917924528302	211	G5C1U4	1	212	3.2692783018867937	211
Q8BW75	PF01593	91	450	8.005144444444442	359	G5BPF5	10	369	7.3988499999999915	359
O54818	PF04201	9	186	0.04241573033707865	177	G5BJ21	8	185	0.16905056179775282	177
P84084	PF00025	6	174	11.777899408284027	168	G5BHA8	7	174	11.73333928571429	167
Q8BSQ9	PF00439	66	137	0.4586527777777778	71	G5BUM7	67	138	0.4581944444444445	71
Q8BSQ9	PF00439	197	273	3.4063636363636363	76	G5BUM7	198	274	3.402402597402597	76
Q8BSQ9	PF00439	401	472	0.016597222222222218	71	G5BUM7	402	473	0.016597222222222218	71
Q8BSQ9	PF00439	541	611	0.03204225352112676	70	G5BUM7	542	612	0.037704225352112666	70
Q8BSQ9	PF00439	677	748	5.463958333333332	71	G5BUM7	678	749	5.659138888888887	71
Q8BSQ9	PF00439	801	865	0.0	64	G5BUM7	804	868	0.008492307692307693	64
Q8BSQ9	PF00505	1381	1429	3.114673469387756	48	G5BUM7	1384	1431	3.1751875	47
Q8BSQ9	PF01426	956	1073	10.489618644067793	117	G5BUM7	959	1076	10.487406779661015	117
Q8BSQ9	PF01426	1156	1271	2.9306637931034483	115	G5BUM7	1159	1274	2.747853448275866	115
Q03173	PF00568	13	106	1.7117659574468085	93	G5B4B0	1	93	9.992935483870971	92
Q03173	PF08776	764	791	0.0	27	G5B4B0	403	429	0.0	26
Q80X41	PF00069	41	267	1.5194361233480176	226	G5B4A2	42	268	1.6332775330396478	226
O88522	PF16516	248	336	0.0	88	G5BFL6	196	266	0.0	70
O88522	PF11577	62	110	0.0	48	G5BFL6	3	51	0.0	48
O88522	PF18414	385	410	0.0	25	G5BFL6	313	338	0.0	25
Q9QZ28	PF00046	132	183	0.061519230769230764	51	G5C5H7	228	279	0.0611153846153846	51
Q9QZ28	PF16878	8	122	1.4348347826086951	114	G5C5H7	104	218	1.4267478260869566	114
Q8BHX3	PF10444	19	74	0.5146607142857142	55	G5C6H4	20	75	0.18421428571428566	55
Q8BHX3	PF10512	176	282	0.07376635514018692	106	G5C6H4	165	271	0.08212149532710282	106
Q91XA8	PF01344	45	65	0.0	20	G5BX41	1	21	0.0	20
Q91XA8	PF01344	67	108	2.912761904761905	41	G5BX41	23	64	2.849785714285713	41
Q91XA8	PF01344	266	312	0.7342127659574469	46	G5BX41	228	274	0.736404255319149	46
Q91XA8	PF13964	163	209	0.8525744680851062	46	G5BX41	125	171	0.8446808510638295	46
Q91YS8	PF00069	21	275	8.402035294117644	254	G5BX88	22	276	8.425462745098036	254
O55131	PF00735	45	316	5.42445955882353	271	G5BAX8	101	337	8.227097046413501	236
Q9DAM9	PF12796	213	307	10.050336842105263	94	G5BE50	264	358	7.9716421052631565	94
Q9DAM9	PF13637	158	195	1.0575000000000003	37	G5BE50	209	246	0.5359999999999999	37
Q9D9V4	PF04712	227	273	10.6211914893617	46	G5BNN3	265	311	4.844425531914894	46
Q8BQP8	PF09457	593	633	13.71021951219512	40	G5B510	516	556	13.709073170731704	40
Q9CZU4	PF01926	114	236	6.848512195121947	122	G5BVI8	115	237	7.547073170731705	122
Q9CZU4	PF07650	362	430	0.6599855072463768	68	G5BVI8	363	431	0.16491304347826086	68
Q8CHV6	PF04433	373	439	0.4664925373134327	66	G5ARC4	368	434	0.4223333333333334	66
Q8CHV6	PF00249	73	116	0.0	43	G5ARC4	68	111	0.0	43
Q8R3F9	PF00076	57	109	10.635754716981133	52	G5AYH3	58	110	12.648924528301885	52
Q8R3F9	PF03828	495	551	3.2735964912280693	56	G5AYH3	473	529	14.253263157894745	56
Q8R3F9	PF12874	15	39	0.0	24	G5AYH3	16	40	0.0	24
Q8R3F9	PF19088	360	454	11.423589473684212	94	G5AYH3	334	432	11.771373737373738	98
Q8R322	PF07817	408	648	6.951489626556016	240	G5ASE5	412	662	5.2208685258964165	250
Q9D6Y9	PF00128	223	310	9.52894318181818	87	G5BA56	224	311	9.651022727272727	87
Q9D6Y9	PF02806	602	696	11.432842105263159	94	G5BA56	603	695	11.284505376344088	92
Q9D6Y9	PF02922	75	160	0.14977906976744187	85	G5BA56	76	161	0.32244186046511625	85
Q8BGQ1	PF04840	174	274	10.837930693069305	100	G5B675	177	277	16.88559405940595	100
Q6VN19	PF00622	101	219	5.887058823529412	118	G5C672	102	220	5.304126050420168	118
Q6VN19	PF08513	256	278	2.4869565217391307	22	G5C672	257	279	2.4341304347826083	22
Q6VN19	PF10607	290	599	2.322235483870967	309	G5C672	291	600	2.3210354838709684	309
P63058	PF00104	214	373	5.544356249999997	159	G5BRV5	215	410	5.239301020408163	195
P63058	PF00105	51	120	0.4194428571428572	69	G5BRV5	52	121	0.06261428571428572	69
Q99LI9	PF06807	312	422	14.462612612612608	110	G5BLJ7	313	423	14.45933333333333	110
Q99LI9	PF16573	15	106	6.0873152173913025	91	G5BLJ7	16	107	6.106119565217392	91
Q99LI9	PF16575	120	306	3.3061497326203213	186	G5BLJ7	121	307	3.3723903743315518	186
Q62432	PF03165	40	170	0.035381679389312984	130	G5B883	41	141	0.040148514851485136	100
Q62432	PF03166	272	442	3.766152046783626	170	G5B883	198	368	3.496058479532164	170
A4Q9F1	PF03133	370	613	4.791930327868855	243	G5B2I8	184	392	6.566186602870817	208
Q60773	PF13857	92	145	5.238851851851853	53	G5BUH4	93	146	5.423537037037038	53
Q3UJC8	PF15016	451	540	5.760666666666667	89	G5BCR3	445	534	3.5442888888888886	89
Q3UJC8	PF15025	8	153	0.7694383561643835	145	G5BCR3	7	152	1.2875136986301368	145
Q8R4U1	PF13873	19	95	0.01012987012987013	76	G5AUY5	6	82	0.010051948051948052	76
P50544	PF00441	327	473	3.9532789115646265	146	G5B5A2	337	483	2.4048231292517013	146
P50544	PF02770	213	315	11.293407766990287	102	G5B5A2	191	325	8.438592592592592	134
P50544	PF02771	96	208	0.6659646017699116	112	G5B5A2	74	186	1.20758407079646	112
Q8K0D5	PF00009	45	318	4.642014598540149	273	G5BVR1	48	333	4.613867132867129	285
Q8K0D5	PF00679	644	729	1.0366976744186045	85	G5BVR1	651	736	0.7469883720930229	85
Q8K0D5	PF03144	365	431	0.8829104477611941	66	G5BVR1	381	438	1.0156206896551725	57
Q8K0D5	PF03764	520	639	2.4476750000000007	119	G5BVR1	527	646	1.0627416666666667	119
Q8K0D5	PF14492	445	518	2.8702432432432423	73	G5BVR1	452	525	2.8578783783783783	73
Q9ESE1	PF06469	1921	2050	1.069953846153846	129	G5C1K2	1669	1798	1.6658153846153845	129
Q9ESE1	PF13385	294	375	19.95517073170732	81	G5C1K2	180	272	19.92156989247312	92
Q9ESE1	PF14844	2076	2115	0.8026500000000001	39	G5C1K2	1880	1918	0.5949230769230768	38
Q9ESE1	PF15787	446	716	16.646974169741686	270	G5C1K2	343	592	16.285948	249
P70340	PF03165	30	130	0.009257425742574259	100	G5C7E2	31	131	0.009257425742574259	100
P70340	PF03166	268	440	3.590317919075144	172	G5C7E2	269	441	3.590317919075144	172
O70469	PF00169	8	113	8.908811320754717	105	G5B9P0	9	114	4.7432075471698125	105
O70469	PF02174	150	247	2.5617551020408165	97	G5B9P0	152	249	3.8136938775510223	97
Q9Z1J2	PF00069	8	260	5.008158102766796	252	G5BUN1	9	261	5.016762845849803	252
O35685	PF04969	170	247	0.14335897435897435	77	G5AUS6	171	248	0.14452564102564106	77
O35685	PF14050	8	58	13.100019607843144	50	G5AUS6	9	59	13.08629411764706	50
O35685	PF16273	95	145	0.0	50	G5AUS6	96	145	0.0	49
Q9JM90	PF00169	26	112	8.577000000000002	86	G5B221	27	113	8.375494252873558	86
P09633	PF00046	192	248	10.121105263157897	56	G5BIE4	193	249	10.121105263157897	56
P09633	PF04617	0	178	0.05362569832402235	178	G5BIE4	1	179	0.05362569832402235	178
P49710	PF00018	434	479	1.2111521739130435	45	G5BBK4	425	470	1.307391304347826	45
P49710	PF02218	81	116	0.0	35	G5BBK4	82	117	0.0	35
P49710	PF02218	118	153	0.0	35	G5BBK4	119	154	0.0	35
P49710	PF02218	155	190	0.0	35	G5BBK4	156	191	0.0	35
P49710	PF02218	192	215	0.0	23	G5BBK4	193	216	0.049375	23
Q8K2Q0	PF07258	119	195	0.09746753246753248	76	G5B134	103	179	0.4672337662337662	76
O35980	PF00633	186	210	0.0	24	G5BY48	185	209	0.97324	24
O35980	PF00730	122	185	4.13496875	63	G5BY48	121	184	4.118218750000001	63
Q9R123	PF00583	145	215	6.103845070422535	70	G5BZZ1	140	210	8.240971830985918	70
Q32KI9	PF00884	46	358	5.538162939297121	312	G5C393	48	359	5.433541666666665	311
Q8BPP1	PF03281	62	342	4.812391459074732	280	G5C1K1	63	343	4.812391459074732	280
P10493	PF07474	426	618	3.3990103626942987	192	G5APM0	421	613	3.4394715025906737	192
P10493	PF00058	989	1027	6.332307692307693	38	G5APM0	984	1022	1.301	38
P10493	PF00058	1032	1070	2.6665641025641027	38	G5APM0	1027	1065	0.019230769230769232	38
P10493	PF00058	1073	1114	0.08761904761904761	41	G5APM0	1068	1109	0.08726190476190476	41
P10493	PF00086	846	916	1.001112676056338	70	G5APM0	841	911	1.1881408450704225	70
P10493	PF06119	175	265	10.108681318681317	90	G5APM0	176	266	12.73707692307693	90
P10493	PF07645	707	747	0.0	40	G5APM0	702	742	2.0250243902439027	40
P10493	PF12662	781	802	0.0	21	G5APM0	776	797	0.0	21
P10493	PF12947	669	705	0.0	36	G5APM0	664	700	0.02432432432432432	36
P10493	PF12947	806	836	0.0	30	G5APM0	801	831	0.0	30
P10493	PF14670	1209	1234	0.0	25	G5APM0	1204	1228	0.0	24
Q497K5	PF00339	14	139	11.2115	125	G5C0R3	15	140	12.046666666666667	125
Q497K5	PF02752	170	303	10.127425373134326	133	G5C0R3	171	304	5.24870895522388	133
Q925S4	PF00726	34	176	8.513937062937059	142	G5BP18	45	195	11.769728476821196	150
Q9DCL4	PF01795	70	403	2.1865718562874252	333	G5BA63	72	403	1.607518072289156	331
Q9CQ40	PF05046	83	165	0.07110843373493975	82	G5B6L5	84	166	0.060426829268292674	82
P28658	PF09759	369	459	8.152725274725274	90	G5BVC0	370	518	5.453080536912753	148
Q78TU8	PF06625	24	132	0.0218348623853211	108	G5BUK4	25	133	0.04379816513761469	108
Q6P8I4	PF15473	21	169	0.9712550335570468	148	G5C018	22	170	0.9741677852348992	148
Q9JHK5	PF00169	5	100	6.02801041666667	95	G5BA19	6	101	4.368572916666668	95
Q9JHK5	PF00169	245	345	0.6472772277227724	100	G5BA19	246	346	0.6972871287128716	100
Q9JHK5	PF00610	138	218	0.19408641975308646	80	G5BA19	139	219	0.191925925925926	80
P31001	PF00038	105	413	0.13157281553398062	308	G5AKJ3	20	328	0.13592880258899676	308
P31001	PF04732	86	104	0.0	18	G5AKJ3	1	19	0.0	18
Q8BMG8	PF00153	23	108	11.784476744186046	85	G5C0G5	8	93	11.65739534883721	85
Q8BMG8	PF00153	116	211	0.4693125000000001	95	G5C0G5	101	195	0.4904736842105261	94
Q8BMG8	PF00153	221	307	14.379666666666665	86	G5C0G5	205	290	14.552430232558141	85
P41539	PF02202	57	67	1.5560909090909087	10	G5BLD5	140	150	1.4708181818181816	10
Q9ERQ8	PF00194	9	260	5.6163531746031765	251	G5BDH3	13	264	5.689126984126985	251
Q91VL9	PF00651	13	115	7.484631067961163	102	G5BD03	14	116	7.477825242718446	102
Q8K2W3	PF00085	111	205	17.955315789473676	94	G5B4G6	59	152	18.618021276595737	93
Q8K2W3	PF00085	663	740	10.826166666666667	77	G5B4G6	611	687	11.519675324675319	76
P67778	PF01145	28	204	1.2389209039548017	176	G5C4P1	29	220	1.4359114583333337	191
Q1HFZ0	PF01189	169	426	5.1805658914728685	257	G5BJC2	138	395	4.564705426356588	257
P46735	PF00063	110	687	3.800038062283737	577	G5BGK3	193	770	3.52773356401384	577
P46735	PF00612	751	769	4.965368421052632	18	G5BGK3	802	820	5.272999999999999	18
P46735	PF06017	927	1095	3.9504970414201166	168	G5BGK3	1113	1281	5.20466272189349	168
P13634	PF00194	4	259	5.524472656249999	255	G5ATW9	5	258	4.424822834645668	253
Q8BHZ5	PF15325	54	156	3.834126213592233	102	G5BS17	51	157	3.792094339622641	106
Q9D1A0	PF13911	87	195	5.2825596330275255	108	G5BK38	50	158	5.451302752293576	108
Q99MR1	PF02213	478	522	4.024155555555557	44	G5BBZ5	478	522	4.025288888888889	44
Q9D379	PF06441	47	156	0.3736545454545456	109	G5C8W7	48	157	0.2583090909090909	109
Q91V10	PF00046	171	227	3.087894736842105	56	G5BJV5	108	164	3.0675789473684216	56
Q65Z40	PF07814	646	1007	8.582544198895029	361	G5APF8	274	634	8.550498614958451	360
Q9DAI9	PF02493	7	28	0.0	21	G5AJL5	8	29	0.03931818181818182	21
Q9DAI9	PF02493	30	52	0.0	22	G5AJL5	31	53	0.0	22
Q9DAI9	PF02493	56	72	0.0	16	G5AJL5	57	73	0.0	16
P70124	PF00079	6	374	4.691365853658535	368	G5BH00	7	366	4.561707520891363	359
Q9D6N1	PF00194	4	259	5.3727226562500014	255	G5ATX1	5	260	5.342281249999998	255
Q60960	PF00514	114	155	5.413857142857144	41	G5AV80	115	156	5.413880952380953	41
Q60960	PF00514	158	196	1.1971538461538462	38	G5AV80	159	197	1.4316666666666666	38
Q60960	PF00514	201	240	1.6431749999999998	39	G5AV80	202	241	1.5306499999999998	39
Q60960	PF00514	252	282	29.05032258064517	30	G5AV80	253	283	28.82	30
Q60960	PF00514	285	323	0.622	38	G5AV80	286	324	0.6478205128205128	38
Q60960	PF00514	329	366	1.358684210526316	37	G5AV80	330	367	1.358684210526316	37
Q60960	PF00514	369	407	7.325358974358977	38	G5AV80	370	408	7.322769230769234	38
Q60960	PF00514	412	450	3.7833076923076923	38	G5AV80	413	451	2.8540512820512824	38
Q60960	PF01749	9	103	0.0	94	G5AV80	10	104	0.0	94
Q60960	PF16186	465	514	0.08190000000000001	49	G5AV80	466	515	0.08199999999999999	49
P58006	PF04636	47	490	4.149817567567569	443	G5B4I5	106	549	4.1732139639639625	443
Q62504	PF00076	27	68	3.4049523809523814	41	G5BRT7	7	48	3.411809523809524	41
Q62504	PF00076	440	507	0.6198088235294119	67	G5BRT7	351	418	0.5647205882352938	67
Q62504	PF00076	520	583	8.288890624999999	63	G5BRT7	431	494	7.906796875	63
Q62504	PF07744	3479	3641	7.278490797546011	162	G5BRT7	3402	3564	7.349325153374228	162
Q62148	PF00171	45	508	4.2098491379310365	463	G5B126	107	570	4.333124999999999	463
A2AT37	PF02854	380	395	0.0	15	G5B6T5	10	25	0.0	15
A2AT37	PF02854	570	754	1.4286108108108109	184	G5B6T5	201	385	1.3946702702702698	184
A2AT37	PF02854	773	983	13.252890995260653	210	G5B6T5	404	577	12.948862068965516	173
A2AT37	PF04050	1091	1214	0.35233870967741937	123	G5B6T5	686	809	0.3431048387096774	123
Q99MS7	PF00307	1212	1311	10.274149999999997	99	G5B6K1	1039	1138	10.21633	99
Q99MS7	PF10358	12	160	10.313704697986578	148	G5B6K1	13	161	9.63061073825503	148
Q99MS7	PF12130	1557	1690	3.4219253731343287	133	G5B6K1	1374	1507	3.419373134328357	133
Q61069	PF00010	199	253	0.5894727272727273	54	G5BWJ1	197	251	0.5880909090909092	54
Q8CJ19	PF00307	521	623	7.266660194174758	102	G5BWN9	519	621	7.284339805825242	102
Q8CJ19	PF00412	763	818	0.24778571428571425	55	G5BWN9	789	844	0.2238035714285714	55
Q8CJ19	PF01494	86	123	19.67557894736842	37	G5BWN9	87	124	19.73742105263158	37
Q8CJ19	PF12130	1844	1978	1.9893111111111117	134	G5BWN9	1751	1885	1.9974296296296292	134
Q1EG27	PF00063	333	1033	5.453904422253923	700	G5BLW7	104	809	5.194898016997173	705
Q1EG27	PF00069	230	280	0.32464705882352946	50	G5BLW7	1	51	9.083392156862745	50
Q1EG27	PF00612	1076	1095	0.237	19	G5BLW7	852	871	2.94355	19
Q9WV98	PF02953	9	68	0.079	59	G5B436	10	69	0.07975	59
Q8K3F7	PF01370	57	292	2.0466355932203406	235	G5AMG0	62	262	0.9097910447761196	200
Q920I9	PF00400	456	497	8.99002380952381	41	G5APR6	457	498	8.99002380952381	41
Q920I9	PF00400	558	586	4.819	28	G5APR6	559	587	5.0406896551724145	28
Q9WVB0	PF00076	25	86	7.820822580645161	61	G5B4I0	5	66	7.753193548387097	61
Q91YA2	PF00069	97	354	5.766007751937986	257	G5C679	98	355	5.821050387596897	257
Q8R086	PF00173	86	160	12.646733333333335	74	G5BB93	85	159	9.32584	74
Q8R086	PF00174	219	395	0.7013050847457628	176	G5BB93	218	394	0.679581920903955	176
Q8R086	PF03404	419	543	0.2409280000000001	124	G5BB93	418	542	0.13968799999999998	124
Q9D1N9	PF00829	99	178	7.8182125	79	G5BTU7	68	146	7.063544303797468	78
Q8CB96	PF00788	177	259	9.331795180722892	82	G5ATS9	177	259	13.575253012048185	82
Q8CB96	PF16517	275	314	0.023125	39	G5ATS9	275	314	0.05747500000000001	39
Q8BLI0	PF00090	41	54	0.0	13	G5B2K6	859	871	0.0	12
Q8BLI0	PF07679	1171	1240	6.840414285714287	69	G5B2K6	1259	1328	8.442885714285714	69
Q8BLI0	PF07679	1270	1351	0.2033658536585366	81	G5B2K6	1358	1431	5.5343243243243245	73
Q8BLI0	PF07679	1387	1468	0.9318658536585368	81	G5B2K6	1467	1548	0.9430121951219512	81
Q8BLI0	PF08686	1712	1741	0.0	29	G5B2K6	1792	1821	0.0	29
Q8BLI0	PF13927	865	923	0.3093050847457627	58	G5B2K6	1013	1073	1.2411475409836066	60
Q8BLI0	PF19030	300	358	0.0	58	G5B2K6	197	255	0.0	58
Q8BLI0	PF19030	379	436	0.029310344827586213	57	G5B2K6	259	316	0.0	57
Q8BLI0	PF19030	439	486	8.674583333333334	47	G5B2K6	319	366	3.605625	47
Q8BLI0	PF19030	527	582	0.029678571428571426	55	G5B2K6	407	462	3.0469464285714283	55
Q8BLI0	PF19030	610	665	0.8865714285714287	55	G5B2K6	489	544	1.0938392857142858	55
Q8BLI0	PF19030	711	762	0.0	51	G5B2K6	859	910	0.0	51
Q8BLI0	PF19030	766	823	0.8177931034482756	57	G5B2K6	914	971	0.9601724137931034	57
Q8BLI0	PF19030	1531	1589	0.10516949152542374	58	G5B2K6	1611	1669	0.09057627118644067	58
Q8BLI0	PF19030	1592	1648	0.0	56	G5B2K6	1672	1728	0.0	56
Q8BLI0	PF19030	1652	1707	3.6599821428571433	55	G5B2K6	1732	1787	3.660232142857143	55
Q80VR3	PF00685	45	295	7.794414342629485	250	G5CB87	118	407	8.192562068965517	289
Q922P9	PF00855	6	87	0.5482560975609755	81	G5B2M0	7	88	0.5483658536585367	81
Q922P9	PF03446	267	417	5.7744039735099335	150	G5B2M0	269	425	5.633789808917197	156
Q922P9	PF14833	423	543	5.939421487603305	120	G5B2M0	431	551	5.939404958677688	120
Q8CFA2	PF01571	37	289	1.2065335968379438	252	G5BZW4	38	290	2.6230276679841884	252
Q8CFA2	PF08669	317	394	0.9842051282051278	77	G5BZW4	318	395	1.1714487179487174	77
Q9CZP7	PF08565	167	269	11.569417475728152	102	G5B4Y1	169	271	11.568485436893198	102
Q8VDM6	PF00622	264	385	0.12008196721311468	121	G5AZS9	254	375	0.12111475409836067	121
Q8VDM6	PF02037	4	35	0.6786249999999999	31	G5AZS9	5	36	0.0	31
Q8VDM6	PF13671	424	568	0.7974689655172416	144	G5AZS9	414	529	0.7498017241379311	115
Q9DB34	PF03357	16	184	0.019532544378698228	168	G5B3G3	17	185	0.019532544378698228	168
Q6PZD9	PF07716	203	255	0.0	52	G5ASK5	204	256	0.0	52
Q8VEB1	PF00069	186	447	6.133244274809159	261	G5BVX1	393	673	5.684491103202848	280
Q8VEB1	PF00615	113	169	4.115543859649121	56	G5BVX1	320	376	3.9116842105263188	56
Q8VE88	PF05334	77	242	0.5796686746987951	165	G5AY12	78	199	2.993959016393441	121
Q62231	PF00046	129	179	0.0	50	G5C5H8	130	180	0.0	50
Q62231	PF16878	8	118	0.6574144144144142	110	G5C5H8	9	119	0.6574144144144142	110
Q80VJ2	PF07304	79	213	0.932548148148148	134	G5AR65	70	205	0.9320073529411762	135
Q80X95	PF04670	8	234	10.217396475770926	226	G5B2K3	9	235	10.21746255506608	226
